id,start_ver,end_ver,num,days,lambda,total_num,CDF
2,27,105,1534,39,0.075196078,1534,0.001730205
1,27,224,1516,39,0.074313725,3050,0.003440108
4,27,310,1487,39,0.072892157,4537,0.005117302
3,314,473,1406,39,0.068921569,5943,0.006703136
5,27,380,1298,39,0.063627451,7241,0.008167155
0,105,27,1266,39,0.062058824,8507,0.009595082
8,27,582,1160,39,0.056862745,9667,0.010903451
6,27,314,1140,39,0.055882353,10807,0.012189262
7,335,27,1116,39,0.054705882,11923,0.013448004
14,27,16,1083,39,0.053088235,13006,0.014669524
34,230,27,1001,39,0.049068627,14007,0.015798556
20,27,331,990,39,0.048529412,14997,0.016915182
25,27,230,984,39,0.048235294,15981,0.018025039
16,27,335,980,39,0.048039216,16961,0.019130386
24,27,32,966,39,0.047352941,17927,0.020219941
21,27,9,953,39,0.046715686,18880,0.021294834
10,314,27,948,39,0.046470588,19828,0.022364088
15,335,105,871,39,0.042696078,20699,0.023346492
17,314,224,871,39,0.042696078,21570,0.024328897
26,27,655,856,39,0.041960784,22426,0.025294383
94,348,27,821,39,0.040245098,23247,0.026220393
28,77,27,817,39,0.04004902,24064,0.02714189
23,105,380,815,39,0.03995098,24879,0.028061132
18,105,582,805,39,0.039460784,25684,0.028969095
30,314,380,803,39,0.039362745,26487,0.029874803
37,105,224,792,39,0.038823529,27279,0.030768103
92,80,380,788,39,0.038627451,28067,0.031656891
33,27,473,785,39,0.038480392,28852,0.032542296
47,224,27,784,39,0.038431373,29636,0.033426573
13,105,314,780,39,0.038235294,30416,0.034306339
11,473,314,771,39,0.037794118,31187,0.035175953
66,27,367,764,39,0.03745098,31951,0.036037672
27,314,105,755,39,0.037009804,32706,0.03688924
45,27,353,755,39,0.037009804,33461,0.037740808
9,27,80,746,39,0.036568627,34207,0.038582224
29,335,582,719,39,0.035245098,34926,0.039393187
59,27,302,716,39,0.035098039,35642,0.040200767
19,473,582,709,39,0.034754902,36351,0.041000451
58,27,26,700,39,0.034313725,37051,0.041789984
53,27,10,699,39,0.034264706,37750,0.042578389
61,27,558,699,39,0.034264706,38449,0.043366794
62,27,219,695,39,0.034068627,39144,0.044150688
54,27,311,694,39,0.034019608,39838,0.044933454
49,588,473,693,39,0.033970588,40531,0.045715091
55,27,379,686,39,0.033627451,41217,0.046488834
72,27,131,682,39,0.033431373,41899,0.047258065
43,27,334,673,39,0.032990196,42572,0.048017144
35,313,473,669,39,0.032794118,43241,0.048771712
32,335,314,665,39,0.032598039,43906,0.049521769
75,27,397,659,39,0.032303922,44565,0.050265058
76,27,280,658,39,0.032254902,45223,0.051007219
48,335,380,657,39,0.032205882,45880,0.051748252
31,582,473,655,39,0.032107843,46535,0.052487029
64,314,522,650,39,0.031862745,47185,0.053220167
100,27,498,643,39,0.031519608,47828,0.053945409
79,27,443,636,39,0.031176471,48464,0.054662757
70,27,354,634,39,0.031078431,49098,0.055377848
83,27,68,628,39,0.030784314,49726,0.056086172
87,27,33,628,39,0.030784314,50354,0.056794496
139,27,347,621,39,0.030441176,50975,0.057494924
22,27,158,615,39,0.030147059,51590,0.058188586
51,77,224,614,39,0.030098039,52204,0.058881119
101,27,522,611,39,0.02995098,52815,0.059570268
124,80,105,605,39,0.029656863,53420,0.060252651
46,105,16,598,39,0.029313725,54018,0.060927137
42,77,314,592,39,0.029019608,54610,0.061594857
36,311,27,591,39,0.028970588,55201,0.062261448
56,77,380,589,39,0.028872549,55790,0.062925784
40,582,27,586,39,0.02872549,56376,0.063586736
88,314,471,580,39,0.028431373,56956,0.06424092
105,27,95,579,39,0.028382353,57535,0.064893977
60,105,335,573,39,0.028088235,58108,0.065540266
69,314,33,571,39,0.027990196,58679,0.0661843
117,27,31,570,39,0.027941176,59249,0.066827205
82,314,9,569,39,0.027892157,59818,0.067468983
89,27,529,562,39,0.02754902,60380,0.068102865
85,314,302,561,39,0.0275,60941,0.068735619
63,380,27,559,39,0.027401961,61500,0.069366118
67,77,331,552,39,0.027058824,62052,0.069988721
129,27,348,546,39,0.026764706,62598,0.070604557
168,27,204,542,39,0.026568627,63140,0.071215881
57,314,32,541,39,0.026519608,63681,0.071826077
39,77,105,540,39,0.026470588,64221,0.072435145
81,314,10,538,39,0.026372549,64759,0.073041958
12,105,80,536,39,0.02627451,65295,0.073646515
110,236,27,536,39,0.02627451,65831,0.074251072
52,331,27,534,39,0.026176471,66365,0.074853372
78,27,123,533,39,0.026127451,66898,0.075454545
106,335,310,530,39,0.025980392,67428,0.076052335
41,9,27,524,39,0.025686275,67952,0.076643357
95,10,27,523,39,0.025637255,68475,0.077233251
74,314,310,517,39,0.025343137,68992,0.077816377
91,314,16,508,39,0.024901961,69500,0.078389353
104,335,224,506,39,0.024803922,70006,0.078960072
159,27,471,503,39,0.024656863,70509,0.079527408
112,105,310,498,39,0.024411765,71007,0.080089104
71,77,84,497,39,0.024362745,71504,0.080649673
126,335,367,492,39,0.024117647,71996,0.081204602
86,473,27,490,39,0.024019608,72486,0.081757275
99,314,331,487,39,0.023872549,72973,0.082306564
103,105,367,485,39,0.02377451,73458,0.082853598
73,314,335,482,39,0.023627451,73940,0.083397248
68,77,16,480,39,0.023529412,74420,0.083938642
84,105,473,479,39,0.023480392,74899,0.084478908
134,68,27,476,39,0.023333333,75375,0.085015791
96,314,95,474,39,0.023235294,75849,0.085550417
127,314,311,473,39,0.023186275,76322,0.086083916
177,48,473,472,39,0.023137255,76794,0.086616287
111,314,582,471,39,0.023088235,77265,0.08714753
38,32,27,471,39,0.023088235,77736,0.087678773
97,335,331,469,39,0.022990196,78205,0.08820776
138,27,394,462,39,0.022647059,78667,0.088728852
195,27,107,456,39,0.022352941,79123,0.089243176
199,27,48,453,39,0.022205882,79576,0.089754117
80,77,582,452,39,0.022156863,80028,0.09026393
187,27,393,450,39,0.022058824,80478,0.090771487
234,27,50,449,39,0.022009804,80927,0.091277916
120,380,105,448,39,0.021960784,81375,0.091783217
334,535,380,448,39,0.021960784,81823,0.092288518
115,105,302,447,39,0.021911765,82270,0.092792691
160,80,224,446,39,0.021862745,82716,0.093295737
142,27,145,445,39,0.021813725,83161,0.093797654
155,27,170,445,39,0.021813725,83606,0.094299571
301,80,10,443,39,0.021715686,84049,0.094799233
198,68,105,442,39,0.021666667,84491,0.095297767
210,68,32,438,39,0.021470588,84929,0.095791789
77,77,353,437,39,0.021421569,85366,0.096284683
109,105,230,436,39,0.021372549,85802,0.096776449
196,335,379,435,39,0.021323529,86237,0.097267088
125,313,27,430,39,0.021078431,86667,0.097752087
90,280,27,430,39,0.021078431,87097,0.098237085
119,310,27,429,39,0.021029412,87526,0.098720956
249,314,48,428,39,0.020980392,87954,0.0992037
171,314,31,428,39,0.020980392,88382,0.099686443
128,335,16,428,39,0.020980392,88810,0.100169186
162,335,230,427,39,0.020931373,89237,0.100650801
113,107,27,427,39,0.020931373,89664,0.101132416
178,27,25,426,39,0.020882353,90090,0.101612903
179,335,10,425,39,0.020833333,90515,0.102092263
229,27,663,424,39,0.020784314,90939,0.102570494
140,105,331,423,39,0.020735294,91362,0.103047598
144,335,473,422,39,0.020686275,91784,0.103523573
146,314,379,422,39,0.020686275,92206,0.103999549
150,314,68,420,39,0.020588235,92626,0.104473269
228,473,230,420,39,0.020588235,93046,0.104946988
137,335,9,419,39,0.020539216,93465,0.10541958
167,27,586,417,39,0.020441176,93882,0.105889917
185,27,15,417,39,0.020441176,94299,0.106360253
260,27,295,416,39,0.020392157,94715,0.106829461
166,314,367,414,39,0.020294118,95129,0.107296413
107,314,6,412,39,0.020196078,95541,0.10776111
224,27,6,411,39,0.020147059,95952,0.108224679
93,582,105,410,39,0.020098039,96362,0.108687119
389,335,347,407,39,0.01995098,96769,0.109146176
50,335,80,405,39,0.019852941,97174,0.109602978
212,105,33,404,39,0.019803922,97578,0.110058651
158,105,10,403,39,0.019754902,97981,0.110513196
253,130,27,403,39,0.019754902,98384,0.110967742
192,236,380,402,39,0.019705882,98786,0.111421159
98,26,27,401,39,0.019656863,99187,0.111873449
121,353,27,399,39,0.019558824,99586,0.112323483
176,314,475,398,39,0.019509804,99984,0.112772389
257,27,313,395,39,0.019362745,100379,0.113217911
263,314,230,394,39,0.019313725,100773,0.113662305
226,314,97,393,39,0.019264706,101166,0.114105572
223,314,558,389,39,0.019068627,101555,0.114544327
44,314,80,389,39,0.019068627,101944,0.114983081
388,230,582,389,39,0.019068627,102333,0.115421836
219,27,532,388,39,0.019019608,102721,0.115859463
193,311,224,386,39,0.018921569,103107,0.116294834
299,68,310,386,39,0.018921569,103493,0.116730205
352,27,497,384,39,0.018823529,103877,0.117163321
148,105,397,384,39,0.018823529,104261,0.117596436
216,27,596,384,39,0.018823529,104645,0.118029551
215,588,27,384,39,0.018823529,105029,0.118462666
201,331,380,382,39,0.01872549,105411,0.118893526
350,380,10,380,39,0.018627451,105791,0.119322129
230,80,27,376,39,0.018431373,106167,0.119746222
114,9,314,376,39,0.018431373,106543,0.120170314
116,105,354,375,39,0.018382353,106918,0.120593278
220,473,310,375,39,0.018382353,107293,0.121016242
238,27,588,374,39,0.018333333,107667,0.121438078
132,27,77,374,39,0.018333333,108041,0.121859914
246,27,236,374,39,0.018333333,108415,0.122281751
323,27,535,374,39,0.018333333,108789,0.122703587
492,348,473,374,39,0.018333333,109163,0.123125423
131,380,314,373,39,0.018284314,109536,0.123546131
147,77,310,372,39,0.018235294,109908,0.123965712
181,105,219,371,39,0.018186275,110279,0.124384164
322,27,562,370,39,0.018137255,110649,0.124801489
305,27,609,369,39,0.018088235,111018,0.125217686
244,380,224,368,39,0.018039216,111386,0.125632754
157,596,27,368,39,0.018039216,111754,0.126047823
191,77,230,367,39,0.017990196,112121,0.126461764
123,582,380,366,39,0.017941176,112487,0.126874577
188,473,380,365,39,0.017892157,112852,0.127286262
209,335,397,365,39,0.017892157,113217,0.127697947
141,582,224,364,39,0.017843137,113581,0.128108504
149,311,380,364,39,0.017843137,113945,0.128519062
153,473,48,363,39,0.017794118,114308,0.128928491
276,380,379,362,39,0.017745098,114670,0.129336792
151,311,582,362,39,0.017745098,115032,0.129745094
205,68,314,360,39,0.017647059,115392,0.130151139
252,224,380,359,39,0.017598039,115751,0.130556057
294,230,380,356,39,0.01745098,116107,0.130957591
358,479,314,355,39,0.017401961,116462,0.131357997
152,532,27,355,39,0.017401961,116817,0.131758403
384,27,250,353,39,0.017303922,117170,0.132156553
164,105,32,353,39,0.017303922,117523,0.132554703
310,27,11,352,39,0.017254902,117875,0.132951726
170,473,588,352,39,0.017254902,118227,0.133348748
161,473,302,351,39,0.017205882,118578,0.133744642
314,582,471,350,39,0.017156863,118928,0.134139409
130,522,27,350,39,0.017156863,119278,0.134534176
376,27,463,350,39,0.017156863,119628,0.134928942
311,230,473,350,39,0.017156863,119978,0.135323709
197,77,9,350,39,0.017156863,120328,0.135718475
163,313,105,348,39,0.017058824,120676,0.136110986
335,27,674,348,39,0.017058824,121024,0.136503497
293,27,141,348,39,0.017058824,121372,0.136896007
213,335,123,347,39,0.017009804,121719,0.13728739
225,105,9,345,39,0.016911765,122064,0.137676517
295,314,3,345,39,0.016911765,122409,0.138065644
145,105,123,344,39,0.016862745,122753,0.138453643
282,10,380,344,39,0.016862745,123097,0.138841642
380,380,367,344,39,0.016862745,123441,0.139229641
232,27,84,344,39,0.016862745,123785,0.13961764
348,107,380,343,39,0.016813725,124128,0.140004512
222,314,348,343,39,0.016813725,124471,0.140391383
313,230,105,343,39,0.016813725,124814,0.140778254
211,77,394,343,39,0.016813725,125157,0.141165125
194,380,582,342,39,0.016764706,125499,0.141550868
143,77,10,341,39,0.016715686,125840,0.141935484
108,311,314,341,39,0.016715686,126181,0.142320099
189,314,354,340,39,0.016666667,126521,0.142703587
912,80,528,338,39,0.016568627,126859,0.143084818
387,353,655,338,39,0.016568627,127197,0.14346605
203,77,473,337,39,0.016519608,127534,0.143846154
262,27,265,335,39,0.016421569,127869,0.144224002
184,105,353,335,39,0.016421569,128204,0.14460185
136,380,80,334,39,0.016372549,128538,0.14497857
250,479,473,334,39,0.016372549,128872,0.14535529
316,236,105,333,39,0.016323529,129205,0.145730882
235,105,77,333,39,0.016323529,129538,0.146106474
259,558,27,333,39,0.016323529,129871,0.146482066
218,313,582,332,39,0.01627451,130203,0.146856531
363,68,582,331,39,0.01622549,130534,0.147229867
269,105,311,331,39,0.01622549,130865,0.147603203
290,311,473,330,39,0.016176471,131195,0.147975412
277,335,393,329,39,0.016127451,131524,0.148346492
390,27,614,326,39,0.015980392,131850,0.148714189
254,314,295,325,39,0.015931373,132175,0.149080758
355,27,14,325,39,0.015931373,132500,0.149447327
270,314,663,325,39,0.015931373,132825,0.149813896
247,105,68,324,39,0.015882353,133149,0.150179337
173,9,380,324,39,0.015882353,133473,0.150544778
447,3,473,323,39,0.015833333,133796,0.150909091
381,27,689,323,39,0.015833333,134119,0.151273404
1106,80,613,321,39,0.015735294,134440,0.151635461
365,335,353,321,39,0.015735294,134761,0.151997519
240,473,224,321,39,0.015735294,135082,0.152359576
437,473,31,320,39,0.015686275,135402,0.152720505
296,314,219,319,39,0.015637255,135721,0.153080307
377,380,310,319,39,0.015637255,136040,0.153440108
400,588,471,318,39,0.015588235,136358,0.153798782
236,335,302,318,39,0.015588235,136676,0.154157455
328,77,609,318,39,0.015588235,136994,0.154516129
273,473,313,317,39,0.015539216,137311,0.154873675
175,77,397,315,39,0.015441176,137626,0.155228965
133,33,27,314,39,0.015392157,137940,0.155583127
526,48,27,314,39,0.015392157,138254,0.155937289
336,331,310,314,39,0.015392157,138568,0.15629145
264,105,379,313,39,0.015343137,138881,0.156644485
312,314,397,312,39,0.015294118,139193,0.156996391
340,105,131,312,39,0.015294118,139505,0.157348297
342,479,582,312,39,0.015294118,139817,0.157700203
261,582,302,312,39,0.015294118,140129,0.158052109
221,77,367,311,39,0.015245098,140440,0.158402887
425,380,311,309,39,0.015147059,140749,0.15875141
156,105,393,308,39,0.015098039,141057,0.159098804
242,224,314,307,39,0.01504902,141364,0.159445071
339,380,84,306,39,0.015,141670,0.15979021
401,380,331,306,39,0.015,141976,0.160135349
416,27,514,305,39,0.01495098,142281,0.160479359
341,335,522,305,39,0.01495098,142586,0.16082337
186,331,582,305,39,0.01495098,142891,0.161167381
237,105,522,305,39,0.01495098,143196,0.161511392
435,27,97,305,39,0.01495098,143501,0.161855403
208,9,224,305,39,0.01495098,143806,0.162199413
200,77,219,304,39,0.014901961,144110,0.162542296
306,77,379,304,39,0.014901961,144414,0.162885179
154,331,314,303,39,0.014852941,144717,0.163226934
470,27,114,303,39,0.014852941,145020,0.163568689
204,77,335,303,39,0.014852941,145323,0.163910444
506,230,224,302,39,0.014803922,145625,0.164251072
118,522,314,302,39,0.014803922,145927,0.164591699
410,314,463,302,39,0.014803922,146229,0.164932326
233,443,27,302,39,0.014803922,146531,0.165272953
286,314,353,302,39,0.014803922,146833,0.16561358
372,314,347,301,39,0.014754902,147134,0.165953079
241,596,380,299,39,0.014656863,147433,0.166290323
284,313,224,297,39,0.014558824,147730,0.16662531
304,335,219,297,39,0.014558824,148027,0.166960298
433,335,33,297,39,0.014558824,148324,0.167295285
214,473,105,296,39,0.014509804,148620,0.167629145
444,27,723,296,39,0.014509804,148916,0.167963005
268,123,27,296,39,0.014509804,149212,0.168296864
258,77,243,293,39,0.014362745,149505,0.16862734
487,522,473,293,39,0.014362745,149798,0.168957816
281,10,582,293,39,0.014362745,150091,0.169288292
302,84,380,292,39,0.014313725,150383,0.16961764
172,9,582,292,39,0.014313725,150675,0.169946988
330,311,367,292,39,0.014313725,150967,0.170276337
362,77,393,292,39,0.014313725,151259,0.170605685
657,68,230,291,39,0.014264706,151550,0.170933905
256,224,105,291,39,0.014264706,151841,0.171262125
485,27,307,290,39,0.014215686,152131,0.171589217
391,131,27,289,39,0.014166667,152420,0.171915182
274,310,314,289,39,0.014166667,152709,0.172241146
287,313,310,289,39,0.014166667,152998,0.17256711
418,313,302,289,39,0.014166667,153287,0.172893075
245,367,27,288,39,0.014117647,153575,0.173217911
608,27,130,288,39,0.014117647,153863,0.173542748
776,348,32,288,39,0.014117647,154151,0.173867584
338,335,588,288,39,0.014117647,154439,0.17419242
558,27,242,287,39,0.014068627,154726,0.174516129
266,522,582,287,39,0.014068627,155013,0.174839838
337,145,27,287,39,0.014068627,155300,0.175163546
279,77,443,286,39,0.014019608,155586,0.175486127
366,10,224,286,39,0.014019608,155872,0.175808707
265,335,32,286,39,0.014019608,156158,0.176131288
394,27,638,286,39,0.014019608,156444,0.176453869
375,105,313,284,39,0.013921569,156728,0.176774194
429,105,558,284,39,0.013921569,157012,0.177094518
458,27,164,284,39,0.013921569,157296,0.177414843
285,3,27,284,39,0.013921569,157580,0.177735168
298,582,10,284,39,0.013921569,157864,0.178055493
318,77,596,284,39,0.013921569,158148,0.178375818
838,80,609,283,39,0.013872549,158431,0.178695015
541,80,331,283,39,0.013872549,158714,0.179014212
231,313,380,282,39,0.013823529,158996,0.179332281
511,236,397,282,39,0.013823529,159278,0.17965035
508,588,310,281,39,0.01377451,159559,0.179967291
462,582,522,278,39,0.013627451,159837,0.180280848
431,314,196,278,39,0.013627451,160115,0.180594406
430,27,264,278,39,0.013627451,160393,0.180907963
367,105,95,278,39,0.013627451,160671,0.18122152
291,582,16,278,39,0.013627451,160949,0.181535078
278,6,27,278,39,0.013627451,161227,0.181848635
488,380,393,275,39,0.013480392,161502,0.182158809
405,311,16,274,39,0.013431373,161776,0.182467855
409,335,68,274,39,0.013431373,162050,0.182776901
174,9,473,274,39,0.013431373,162324,0.183085946
280,105,588,273,39,0.013382353,162597,0.183393864
708,130,32,273,39,0.013382353,162870,0.183701782
548,68,335,273,39,0.013382353,163143,0.1840097
449,80,582,272,39,0.013333333,163415,0.18431649
407,588,105,272,39,0.013333333,163687,0.18462328
354,77,107,271,39,0.013284314,163958,0.184928942
402,105,236,270,39,0.013235294,164228,0.185233476
457,314,131,269,39,0.013186275,164497,0.185536882
349,105,48,269,39,0.013186275,164766,0.185840289
239,582,335,269,39,0.013186275,165035,0.186143695
300,674,27,269,39,0.013186275,165304,0.186447101
424,380,473,269,39,0.013186275,165573,0.186750508
939,230,68,268,39,0.013137255,165841,0.187052786
663,663,582,268,39,0.013137255,166109,0.187355064
559,27,196,268,39,0.013137255,166377,0.187657343
514,224,10,268,39,0.013137255,166645,0.187959621
315,473,123,267,39,0.013088235,166912,0.188260771
102,32,314,267,39,0.013088235,167179,0.188561922
308,314,689,266,39,0.013039216,167445,0.188861945
307,105,84,266,39,0.013039216,167711,0.189161967
413,588,224,265,39,0.012990196,167976,0.189460862
370,3,314,265,39,0.012990196,168241,0.189759756
725,380,586,265,39,0.012990196,168506,0.190058651
690,48,314,264,39,0.012941176,168770,0.190356418
579,68,473,264,39,0.012941176,169034,0.190654185
395,77,529,263,39,0.012892157,169297,0.190950823
243,582,331,263,39,0.012892157,169560,0.191247462
419,614,27,263,39,0.012892157,169823,0.191544101
572,380,596,262,39,0.012843137,170085,0.191839612
774,380,250,262,39,0.012843137,170347,0.192135123
415,588,380,261,39,0.012794118,170608,0.192429506
426,77,250,261,39,0.012794118,170869,0.192723889
472,84,27,261,39,0.012794118,171130,0.193018272
309,313,9,260,39,0.012745098,171390,0.193311527
827,27,56,259,39,0.012696078,171649,0.193603654
422,32,16,259,39,0.012696078,171908,0.193895782
217,582,310,259,39,0.012696078,172167,0.194187909
600,56,27,258,39,0.012647059,172425,0.194478908
359,311,105,257,39,0.012598039,172682,0.19476878
639,588,33,256,39,0.01254902,172938,0.195057523
427,380,394,256,39,0.01254902,173194,0.195346267
538,10,473,255,39,0.0125,173449,0.195633882
711,236,367,255,39,0.0125,173704,0.195921498
721,335,250,254,39,0.01245098,173958,0.196207986
775,68,16,254,39,0.01245098,174212,0.196494473
453,335,311,254,39,0.01245098,174466,0.196780961
685,230,331,253,39,0.012401961,174719,0.197066321
532,80,314,253,39,0.012401961,174972,0.197351681
440,313,10,253,39,0.012401961,175225,0.19763704
326,473,9,253,39,0.012401961,175478,0.1979224
583,224,310,252,39,0.012352941,175730,0.198206632
406,27,511,251,39,0.012303922,175981,0.198489736
578,335,11,251,39,0.012303922,176232,0.19877284
434,313,16,250,39,0.012254902,176482,0.199054816
1088,348,335,250,39,0.012254902,176732,0.199336792
442,314,145,250,39,0.012254902,176982,0.199618768
385,314,77,250,39,0.012254902,177232,0.199900744
979,48,582,250,39,0.012254902,177482,0.200182721
360,77,498,249,39,0.012205882,177731,0.200463569
411,335,394,249,39,0.012205882,177980,0.200744417
617,236,224,249,39,0.012205882,178229,0.201025265
361,105,498,249,39,0.012205882,178478,0.201306113
603,3,582,249,39,0.012205882,178727,0.201586961
782,224,498,248,39,0.012156863,178975,0.201866682
321,105,394,248,39,0.012156863,179223,0.202146402
347,302,105,248,39,0.012156863,179471,0.202426122
183,9,105,248,39,0.012156863,179719,0.202705843
353,582,314,247,39,0.012107843,179966,0.202984435
343,16,380,247,39,0.012107843,180213,0.203263027
503,3,105,247,39,0.012107843,180460,0.20354162
320,311,331,246,39,0.012058824,180706,0.203819084
368,302,582,246,39,0.012058824,180952,0.204096549
587,123,473,246,39,0.012058824,181198,0.204374013
267,582,9,246,39,0.012058824,181444,0.204651478
763,236,16,246,39,0.012058824,181690,0.204928942
531,310,380,246,39,0.012058824,181936,0.205206406
893,80,311,246,39,0.012058824,182182,0.205483871
494,313,522,246,39,0.012058824,182428,0.205761335
679,230,16,246,39,0.012058824,182674,0.2060388
327,10,314,246,39,0.012058824,182920,0.206316264
452,380,9,245,39,0.012009804,183165,0.206592601
798,68,33,245,39,0.012009804,183410,0.206868938
206,84,80,245,39,0.012009804,183655,0.207145274
649,80,473,244,39,0.011960784,183899,0.207420483
493,335,95,244,39,0.011960784,184143,0.207695691
634,27,274,244,39,0.011960784,184387,0.2079709
421,380,397,243,39,0.011911765,184630,0.208244981
915,313,48,243,39,0.011911765,184873,0.208519062
701,27,385,243,39,0.011911765,185116,0.208793142
491,314,123,243,39,0.011911765,185359,0.209067223
408,314,307,242,39,0.011862745,185601,0.209340176
656,236,331,242,39,0.011862745,185843,0.209613129
696,130,105,242,39,0.011862745,186085,0.209886082
545,380,230,242,39,0.011862745,186327,0.210159035
479,314,15,242,39,0.011862745,186569,0.210431987
636,380,609,241,39,0.011813725,186810,0.210703812
495,123,380,241,39,0.011813725,187051,0.210975637
513,105,250,241,39,0.011813725,187292,0.211247462
471,473,16,241,39,0.011813725,187533,0.211519287
325,522,105,240,39,0.011764706,187773,0.211789984
501,335,498,240,39,0.011764706,188013,0.212060681
842,80,84,240,39,0.011764706,188253,0.212331378
469,77,11,240,39,0.011764706,188493,0.212602075
897,230,33,240,39,0.011764706,188733,0.212872772
560,224,230,240,39,0.011764706,188973,0.213143469
787,27,121,239,39,0.011715686,189212,0.213413039
351,77,522,239,39,0.011715686,189451,0.213682608
417,105,3,238,39,0.011666667,189689,0.213951049
403,105,11,238,39,0.011666667,189927,0.21421949
581,479,27,238,39,0.011666667,190165,0.214487931
490,335,313,238,39,0.011666667,190403,0.214756373
332,379,27,237,39,0.011617647,190640,0.215023686
684,27,34,237,39,0.011617647,190877,0.215290999
728,596,397,237,39,0.011617647,191114,0.215558313
467,532,655,237,39,0.011617647,191351,0.215825626
543,313,311,236,39,0.011568627,191587,0.216091811
624,354,105,236,39,0.011568627,191823,0.216357997
692,236,310,236,39,0.011568627,192059,0.216624182
478,105,107,236,39,0.011568627,192295,0.216890368
255,107,80,236,39,0.011568627,192531,0.217156553
691,335,236,236,39,0.011568627,192767,0.217422739
797,663,224,235,39,0.011519608,193002,0.217687796
727,588,522,234,39,0.011470588,193236,0.217951726
122,331,80,234,39,0.011470588,193470,0.218215655
564,379,380,234,39,0.011470588,193704,0.218479585
202,33,314,234,39,0.011470588,193938,0.218743515
653,219,27,234,39,0.011470588,194172,0.219007444
615,105,243,233,39,0.011421569,194405,0.219270246
519,105,655,233,39,0.011421569,194638,0.219533048
891,68,224,233,39,0.011421569,194871,0.219795849
604,380,353,233,39,0.011421569,195104,0.220058651
613,314,588,232,39,0.011372549,195336,0.220320325
706,224,331,232,39,0.011372549,195568,0.220581999
346,310,582,232,39,0.011372549,195800,0.220843672
439,331,335,232,39,0.011372549,196032,0.221105346
529,314,498,232,39,0.011372549,196264,0.22136702
378,105,443,232,39,0.011372549,196496,0.221628694
716,313,689,231,39,0.011323529,196727,0.22188924
633,335,596,231,39,0.011323529,196958,0.222149786
544,522,310,231,39,0.011323529,197189,0.222410332
753,27,30,230,39,0.01127451,197419,0.22266975
392,77,586,230,39,0.01127451,197649,0.222929168
1066,230,471,229,39,0.01122549,197878,0.223187458
393,582,311,229,39,0.01122549,198107,0.223445748
553,230,335,229,39,0.01122549,198336,0.223704038
1033,80,236,228,39,0.011176471,198564,0.2239612
530,311,9,228,39,0.011176471,198792,0.224218362
451,331,393,228,39,0.011176471,199020,0.224475524
698,335,558,228,39,0.011176471,199248,0.224732687
1047,48,471,227,39,0.011127451,199475,0.224988721
505,331,397,227,39,0.011127451,199702,0.225244755
640,236,394,227,39,0.011127451,199929,0.22550079
542,314,443,226,39,0.011078431,200155,0.225755696
524,473,379,226,39,0.011078431,200381,0.226010602
546,443,353,226,39,0.011078431,200607,0.226265509
989,80,230,226,39,0.011078431,200833,0.226520415
920,354,310,226,39,0.011078431,201059,0.226775321
870,236,498,226,39,0.011078431,201285,0.227030228
668,77,398,225,39,0.011029412,201510,0.227284006
550,311,335,225,39,0.011029412,201735,0.227537785
555,335,50,224,39,0.010980392,201959,0.227790435
694,335,107,224,39,0.010980392,202183,0.228043086
765,250,380,224,39,0.010980392,202407,0.228295737
923,27,427,224,39,0.010980392,202631,0.228548387
1024,80,522,223,39,0.010931373,202854,0.22879991
754,314,11,223,39,0.010931373,203077,0.229051432
712,27,640,223,39,0.010931373,203300,0.229302955
446,77,236,223,39,0.010931373,203523,0.229554478
988,84,331,222,39,0.010882353,203745,0.229804873
609,314,479,222,39,0.010882353,203967,0.230055267
746,353,16,221,39,0.010833333,204188,0.230304534
709,314,313,221,39,0.010833333,204409,0.230553801
628,311,522,220,39,0.010784314,204629,0.23080194
751,588,16,220,39,0.010784314,204849,0.231050079
592,335,471,220,39,0.010784314,205069,0.231298218
461,313,379,220,39,0.010784314,205289,0.231546357
677,335,348,220,39,0.010784314,205509,0.231794496
848,582,48,219,39,0.010735294,205728,0.232041507
964,224,558,219,39,0.010735294,205947,0.232288518
1004,663,16,219,39,0.010735294,206166,0.232535529
568,236,655,219,39,0.010735294,206385,0.23278254
824,107,310,218,39,0.010686275,206603,0.233028423
758,588,230,218,39,0.010686275,206821,0.233274306
742,310,224,218,39,0.010686275,207039,0.233520189
180,473,80,218,39,0.010686275,207257,0.233766073
570,311,397,218,39,0.010686275,207475,0.234011956
432,314,393,218,39,0.010686275,207693,0.234257839
697,479,224,217,39,0.010637255,207910,0.234502594
271,105,334,217,39,0.010637255,208127,0.234747349
303,32,582,217,39,0.010637255,208344,0.234992105
704,224,655,217,39,0.010637255,208561,0.23523686
681,582,68,217,39,0.010637255,208778,0.235481615
843,335,427,217,39,0.010637255,208995,0.23572637
373,77,123,217,39,0.010637255,209212,0.235971126
853,80,310,216,39,0.010588235,209428,0.236214753
1630,348,204,216,39,0.010588235,209644,0.23645838
522,535,27,216,39,0.010588235,209860,0.236702008
456,107,105,216,39,0.010588235,210076,0.236945635
556,367,380,215,39,0.010539216,210291,0.237188134
768,230,302,215,39,0.010539216,210506,0.237430634
779,77,33,215,39,0.010539216,210721,0.237673133
596,331,302,215,39,0.010539216,210936,0.237915633
660,473,471,215,39,0.010539216,211151,0.238158132
935,68,331,214,39,0.010490196,211365,0.238399504
643,16,224,214,39,0.010490196,211579,0.238640875
412,331,16,214,39,0.010490196,211793,0.238882247
752,27,501,214,39,0.010490196,212007,0.239123618
561,473,32,214,39,0.010490196,212221,0.23936499
828,107,609,214,39,0.010490196,212435,0.239606361
483,313,33,214,39,0.010490196,212649,0.239847733
552,582,33,214,39,0.010490196,212863,0.240089104
480,331,230,213,39,0.010441176,213076,0.240329348
655,20,204,213,39,0.010441176,213289,0.240569592
369,582,354,213,39,0.010441176,213502,0.240809835
856,353,529,213,39,0.010441176,213715,0.241050079
839,380,11,213,39,0.010441176,213928,0.241290323
585,224,473,212,39,0.010392157,214140,0.241529438
1053,80,394,212,39,0.010392157,214352,0.241768554
1051,314,121,212,39,0.010392157,214564,0.24200767
190,236,80,212,39,0.010392157,214776,0.242246785
621,314,50,211,39,0.010343137,214987,0.242484773
374,32,473,211,39,0.010343137,215198,0.242722761
1978,535,613,211,39,0.010343137,215409,0.242960749
626,311,10,210,39,0.010294118,215619,0.243197609
333,302,314,210,39,0.010294118,215829,0.243434469
1192,224,522,210,39,0.010294118,216039,0.243671329
1111,535,105,210,39,0.010294118,216249,0.243908189
1141,80,379,210,39,0.010294118,216459,0.244145048
736,588,32,209,39,0.010245098,216668,0.244380781
954,130,310,209,39,0.010245098,216877,0.244616513
616,3,335,209,39,0.010245098,217086,0.244852245
1034,68,723,209,39,0.010245098,217295,0.245087977
808,588,10,209,39,0.010245098,217504,0.245323709
790,236,582,209,39,0.010245098,217713,0.245559441
734,335,31,208,39,0.010196078,217921,0.245794045
862,522,16,208,39,0.010196078,218129,0.246028649
818,107,367,208,39,0.010196078,218337,0.246263253
785,314,107,208,39,0.010196078,218545,0.246497857
724,123,224,208,39,0.010196078,218753,0.246732461
882,68,9,208,39,0.010196078,218961,0.246967065
536,331,367,208,39,0.010196078,219169,0.247201669
1125,80,393,208,39,0.010196078,219377,0.247436273
443,331,224,207,39,0.010147059,219584,0.24766975
549,313,230,206,39,0.010098039,219790,0.247902098
1384,130,10,206,39,0.010098039,219996,0.248134446
786,473,68,205,39,0.01004902,220201,0.248365667
687,313,68,205,39,0.01004902,220406,0.248596887
665,105,663,205,39,0.01004902,220611,0.248828107
987,588,68,205,39,0.01004902,220816,0.249059328
1015,236,353,205,39,0.01004902,221021,0.249290548
807,27,475,205,39,0.01004902,221226,0.249521769
750,354,582,205,39,0.01004902,221431,0.249752989
769,335,443,205,39,0.01004902,221636,0.249984209
809,224,32,204,39,0.01,221840,0.250214302
966,335,354,204,39,0.01,222044,0.250444394
662,105,31,204,39,0.01,222248,0.250674487
465,473,335,204,39,0.01,222452,0.250904579
499,26,243,203,39,0.00995098,222655,0.251133544
1082,522,558,202,39,0.009901961,222857,0.251361381
889,80,9,202,39,0.009901961,223059,0.251589217
800,230,10,201,39,0.009852941,223260,0.251815926
718,380,236,201,39,0.009852941,223461,0.252042635
629,331,311,200,39,0.009803922,223661,0.252268216
795,130,224,200,39,0.009803922,223861,0.252493797
817,107,16,200,39,0.009803922,224061,0.252719377
710,473,6,199,39,0.009754902,224260,0.25294383
1206,27,502,199,39,0.009754902,224459,0.253168283
726,236,280,199,39,0.009754902,224658,0.253392736
1591,348,689,199,39,0.009754902,224857,0.253617189
804,236,514,199,39,0.009754902,225056,0.253841642
476,582,367,199,39,0.009754902,225255,0.254066095
1302,68,295,198,39,0.009705882,225453,0.25428942
2062,535,379,198,39,0.009705882,225651,0.254512745
627,582,95,197,39,0.009656863,225848,0.254734942
1126,588,97,197,39,0.009656863,226045,0.25495714
496,105,6,197,39,0.009656863,226242,0.255179337
580,588,335,197,39,0.009656863,226439,0.255401534
855,353,498,197,39,0.009656863,226636,0.255623731
732,335,655,197,39,0.009656863,226833,0.255845928
569,105,532,196,39,0.009607843,227029,0.256066998
647,105,529,196,39,0.009607843,227225,0.256288067
607,311,393,196,39,0.009607843,227421,0.256509136
642,107,314,196,39,0.009607843,227617,0.256730205
864,27,404,195,39,0.009558824,227812,0.256950147
664,335,131,195,39,0.009558824,228007,0.257170088
1148,27,552,194,39,0.009509804,228201,0.257388901
182,582,80,194,39,0.009509804,228395,0.257607715
638,311,302,194,39,0.009509804,228589,0.257826528
1407,236,131,194,39,0.009509804,228783,0.258045342
1227,68,15,194,39,0.009509804,228977,0.258264155
802,443,655,193,39,0.009460784,229170,0.258481841
924,302,230,192,39,0.009411765,229362,0.258698398
777,280,529,192,39,0.009411765,229554,0.258914956
983,27,439,192,39,0.009411765,229746,0.259131514
551,532,26,192,39,0.009411765,229938,0.259348071
512,313,331,192,39,0.009411765,230130,0.259564629
700,105,609,192,39,0.009411765,230322,0.259781187
520,10,105,192,39,0.009411765,230514,0.259997744
646,105,586,192,39,0.009411765,230706,0.260214302
525,32,310,192,39,0.009411765,230898,0.260430859
796,473,33,191,39,0.009362745,231089,0.260646289
1046,535,582,191,39,0.009362745,231280,0.260861719
324,6,314,191,39,0.009362745,231471,0.261077149
1040,236,335,191,39,0.009362745,231662,0.261292578
719,123,582,191,39,0.009362745,231853,0.261508008
371,582,379,191,39,0.009362745,232044,0.261723438
1743,348,15,191,39,0.009362745,232235,0.261938868
500,105,596,191,39,0.009362745,232426,0.262154297
832,522,230,191,39,0.009362745,232617,0.262369727
441,9,354,190,39,0.009313725,232807,0.262584029
420,367,105,190,39,0.009313725,232997,0.262798331
567,582,393,190,39,0.009313725,233187,0.263012633
319,10,80,190,39,0.009313725,233377,0.263226934
1117,224,131,190,39,0.009313725,233567,0.263441236
1390,335,689,189,39,0.009264706,233756,0.26365441
699,313,475,189,39,0.009264706,233945,0.263867584
793,588,9,189,39,0.009264706,234134,0.264080758
880,473,522,189,39,0.009264706,234323,0.264293932
1580,348,310,189,39,0.009264706,234512,0.264507106
863,250,27,189,39,0.009264706,234701,0.26472028
1107,68,311,188,39,0.009215686,234889,0.264932326
1394,68,131,188,39,0.009215686,235077,0.265144372
537,77,532,188,39,0.009215686,235265,0.265356418
1016,522,32,187,39,0.009166667,235452,0.265567336
1131,3,310,187,39,0.009166667,235639,0.265778254
1169,335,15,187,39,0.009166667,235826,0.265989172
379,302,473,187,39,0.009166667,236013,0.26620009
673,311,230,186,39,0.009117647,236199,0.26640988
767,314,535,186,39,0.009117647,236385,0.266619671
1245,230,367,186,39,0.009117647,236571,0.266829461
705,331,84,186,39,0.009117647,236757,0.267039251
1198,335,243,186,39,0.009117647,236943,0.267249041
477,32,224,185,39,0.009068627,237128,0.267457704
576,32,131,185,39,0.009068627,237313,0.267666366
1491,535,331,184,39,0.009019608,237497,0.2678739
611,313,123,184,39,0.009019608,237681,0.268081435
904,27,543,184,39,0.009019608,237865,0.268288969
748,26,16,184,39,0.009019608,238049,0.268496503
1085,314,609,183,39,0.008970588,238232,0.26870291
772,10,32,183,39,0.008970588,238415,0.268909316
971,77,6,183,39,0.008970588,238598,0.269115723
1246,27,544,183,39,0.008970588,238781,0.269322129
1990,348,68,182,39,0.008921569,238963,0.269527408
509,9,331,182,39,0.008921569,239145,0.269732687
1702,48,230,181,39,0.008872549,239326,0.269936837
1449,68,95,181,39,0.008872549,239507,0.270140988
614,6,473,181,39,0.008872549,239688,0.270345139
1032,314,114,181,39,0.008872549,239869,0.270549289
940,77,313,180,39,0.008823529,240049,0.270752312
859,9,522,180,39,0.008823529,240229,0.270955335
463,16,105,180,39,0.008823529,240409,0.271158358
1031,130,380,179,39,0.00877451,240588,0.271360253
1646,230,347,179,39,0.00877451,240767,0.271562148
973,588,302,179,39,0.00877451,240946,0.271764042
906,236,84,178,39,0.00872549,241124,0.271964809
1538,328,380,178,39,0.00872549,241302,0.272165576
1423,479,31,177,39,0.008676471,241479,0.272365215
667,331,394,177,39,0.008676471,241656,0.272564855
590,582,475,177,39,0.008676471,241833,0.272764494
517,501,27,177,39,0.008676471,242010,0.272964133
879,107,335,177,39,0.008676471,242187,0.273163772
715,123,314,176,39,0.008627451,242363,0.273362283
619,6,105,176,39,0.008627451,242539,0.273560794
1376,230,393,176,39,0.008627451,242715,0.273759305
1009,311,313,176,39,0.008627451,242891,0.273957816
982,236,393,176,39,0.008627451,243067,0.274156328
1289,80,11,175,39,0.008578431,243242,0.274353711
737,105,26,175,39,0.008578431,243417,0.274551094
602,224,379,175,39,0.008578431,243592,0.274748477
831,105,398,175,39,0.008578431,243767,0.274945861
892,314,427,174,39,0.008529412,243941,0.275142116
874,107,224,174,39,0.008529412,244115,0.275338371
317,582,123,174,39,0.008529412,244289,0.275534627
852,77,558,174,39,0.008529412,244463,0.275730882
1311,68,302,174,39,0.008529412,244637,0.275927137
766,20,708,174,39,0.008529412,244811,0.276123393
1359,380,498,173,39,0.008480392,244984,0.27631852
364,16,314,173,39,0.008480392,245157,0.276513648
937,280,16,173,39,0.008480392,245330,0.276708775
1214,522,219,172,39,0.008431373,245502,0.276902775
1027,380,243,172,39,0.008431373,245674,0.277096774
1028,663,380,172,39,0.008431373,245846,0.277290774
1255,158,224,171,39,0.008382353,246017,0.277483645
169,522,80,171,39,0.008382353,246188,0.277676517
1401,335,196,171,39,0.008382353,246359,0.277869389
1508,68,367,171,39,0.008382353,246530,0.27806226
1043,314,640,171,39,0.008382353,246701,0.278255132
1044,9,48,171,39,0.008382353,246872,0.278448004
1213,230,95,170,39,0.008333333,247042,0.278639747
1021,582,131,170,39,0.008333333,247212,0.278831491
1242,107,311,170,39,0.008333333,247382,0.279023235
528,295,27,170,39,0.008333333,247552,0.279214979
1445,379,310,169,39,0.008284314,247721,0.279405594
801,280,243,168,39,0.008235294,247889,0.279595082
1144,224,219,168,39,0.008235294,248057,0.27978457
1059,311,107,168,39,0.008235294,248225,0.279974058
620,314,394,167,39,0.008186275,248392,0.280162418
999,380,302,166,39,0.008137255,248558,0.28034965
1291,463,224,166,39,0.008137255,248724,0.280536882
992,236,379,165,39,0.008088235,248889,0.280722987
1271,335,398,165,39,0.008088235,249054,0.280909091
650,311,32,165,39,0.008088235,249219,0.281095195
1444,663,230,165,39,0.008088235,249384,0.281281299
1112,230,588,165,39,0.008088235,249549,0.281467404
1240,48,380,165,39,0.008088235,249714,0.281653508
1135,219,224,164,39,0.008039216,249878,0.281838484
1637,224,31,164,39,0.008039216,250042,0.28202346
1456,663,32,164,39,0.008039216,250206,0.282208437
1008,331,11,164,39,0.008039216,250370,0.282393413
1708,596,609,163,39,0.007990196,250533,0.282577261
1578,130,33,163,39,0.007990196,250696,0.28276111
2759,80,544,163,39,0.007990196,250859,0.282944958
998,107,77,163,39,0.007990196,251022,0.283128807
1404,68,219,163,39,0.007990196,251185,0.283312655
3084,471,31,163,39,0.007990196,251348,0.283496503
1424,314,632,163,39,0.007990196,251511,0.283680352
957,11,380,163,39,0.007990196,251674,0.2838642
1530,230,689,162,39,0.007941176,251836,0.284046921
1017,582,313,162,39,0.007941176,251998,0.284229641
1200,331,107,162,39,0.007941176,252160,0.284412362
1417,479,230,162,39,0.007941176,252322,0.284595082
1513,230,170,161,39,0.007892157,252483,0.284776675
1237,84,16,161,39,0.007892157,252644,0.284958268
1123,314,529,161,39,0.007892157,252805,0.28513986
1130,236,26,161,39,0.007892157,252966,0.285321453
1641,348,6,161,39,0.007892157,253127,0.285503045
1052,311,379,160,39,0.007843137,253287,0.28568351
1090,367,311,160,39,0.007843137,253447,0.285863975
1186,314,250,160,39,0.007843137,253607,0.286044439
1566,68,31,160,39,0.007843137,253767,0.286224904
1532,348,105,160,39,0.007843137,253927,0.286405369
961,302,310,160,39,0.007843137,254087,0.286585834
454,9,32,160,39,0.007843137,254247,0.286766298
1139,588,379,159,39,0.007794118,254406,0.286945635
895,331,379,159,39,0.007794118,254565,0.287124972
1509,596,107,159,39,0.007794118,254724,0.287304309
1238,311,131,159,39,0.007794118,254883,0.287483645
990,335,586,159,39,0.007794118,255042,0.287662982
1875,588,48,159,39,0.007794118,255201,0.287842319
956,77,68,159,39,0.007794118,255360,0.288021656
1161,354,9,158,39,0.007745098,255518,0.288199865
928,596,331,158,39,0.007745098,255676,0.288378074
875,353,25,157,39,0.007696078,255833,0.288555155
770,302,380,157,39,0.007696078,255990,0.288732236
993,77,131,157,39,0.007696078,256147,0.288909316
841,77,48,156,39,0.007647059,256303,0.28908527
1549,582,347,156,39,0.007647059,256459,0.289261223
1019,16,230,156,39,0.007647059,256615,0.289437176
1145,535,224,156,39,0.007647059,256771,0.289613129
1156,105,427,156,39,0.007647059,256927,0.289789082
1397,348,380,156,39,0.007647059,257083,0.289965035
720,302,224,156,39,0.007647059,257239,0.290140988
1276,335,54,156,39,0.007647059,257395,0.290316941
1078,3,16,154,39,0.00754902,257549,0.290490638
622,20,348,154,39,0.00754902,257703,0.290664336
1249,473,689,153,39,0.0075,257856,0.290836905
1375,331,250,153,39,0.0075,258009,0.291009474
688,314,655,153,39,0.0075,258162,0.291182044
612,522,379,153,39,0.0075,258315,0.291354613
1349,663,9,153,39,0.0075,258468,0.291527182
945,331,236,153,39,0.0075,258621,0.291699752
946,558,224,153,39,0.0075,258774,0.291872321
803,20,31,152,39,0.00745098,258926,0.292043763
1510,80,243,152,39,0.00745098,259078,0.292215204
735,68,80,152,39,0.00745098,259230,0.292386646
1165,224,68,151,39,0.007401961,259381,0.292556959
1364,380,68,151,39,0.007401961,259532,0.292727273
1225,6,31,151,39,0.007401961,259683,0.292897586
2179,535,77,151,39,0.007401961,259834,0.2930679
1437,27,414,150,39,0.007352941,259984,0.293237085
1072,16,353,150,39,0.007352941,260134,0.293406271
1526,522,131,150,39,0.007352941,260284,0.293575457
1781,68,689,150,39,0.007352941,260434,0.293744642
1429,663,473,150,39,0.007352941,260584,0.293913828
1680,48,9,150,39,0.007352941,260734,0.294083014
1315,582,479,149,39,0.007303922,260883,0.294251072
1439,663,310,149,39,0.007303922,261032,0.294419129
1357,311,48,149,39,0.007303922,261181,0.294587187
977,522,335,149,39,0.007303922,261330,0.294755245
805,529,353,148,39,0.007254902,261478,0.294922175
1054,280,224,148,39,0.007254902,261626,0.295089104
601,3,80,147,39,0.007205882,261773,0.295254906
693,393,105,147,39,0.007205882,261920,0.295420708
1012,398,27,147,39,0.007205882,262067,0.29558651
1190,443,16,147,39,0.007205882,262214,0.295752312
1138,313,219,146,39,0.007156863,262360,0.295916986
1514,236,230,146,39,0.007156863,262506,0.29608166
917,9,313,145,39,0.007107843,262651,0.296245206
1624,80,655,145,39,0.007107843,262796,0.296408753
1868,224,663,144,39,0.007058824,262940,0.296571171
1935,354,367,144,39,0.007058824,263084,0.296733589
2176,230,250,143,39,0.007009804,263227,0.296894879
1025,582,3,143,39,0.007009804,263370,0.29705617
1233,582,588,143,39,0.007009804,263513,0.29721746
1023,522,331,143,39,0.007009804,263656,0.29737875
1334,313,50,143,39,0.007009804,263799,0.297540041
1436,353,219,142,39,0.006960784,263941,0.297700203
1175,314,243,142,39,0.006960784,264083,0.297860365
1822,123,302,142,39,0.006960784,264225,0.298020528
498,6,20,142,39,0.006960784,264367,0.29818069
1504,224,529,141,39,0.006911765,264508,0.298339725
731,522,123,141,39,0.006911765,264649,0.298498759
903,473,354,141,39,0.006911765,264790,0.298657794
1020,80,353,141,39,0.006911765,264931,0.298816828
2162,80,131,140,39,0.006862745,265071,0.298974735
844,609,380,140,39,0.006862745,265211,0.299132642
1209,84,529,140,39,0.006862745,265351,0.299290548
1048,331,443,139,39,0.006813725,265490,0.299447327
2417,314,528,139,39,0.006813725,265629,0.299604106
1979,27,328,139,39,0.006813725,265768,0.299760884
2168,123,48,139,39,0.006813725,265907,0.299917663
714,397,380,138,39,0.006764706,266045,0.300073314
1461,27,156,138,39,0.006764706,266183,0.300228965
1451,393,379,138,39,0.006764706,266321,0.300384615
1517,105,242,138,39,0.006764706,266459,0.300540266
1484,26,280,138,39,0.006764706,266597,0.300695917
1616,27,682,138,39,0.006764706,266735,0.300851568
845,522,9,137,39,0.006715686,266872,0.301006091
1320,310,331,137,39,0.006715686,267009,0.301160614
1282,314,141,137,39,0.006715686,267146,0.301315136
1115,84,77,136,39,0.006666667,267282,0.301468531
1440,596,224,136,39,0.006666667,267418,0.301621926
2029,48,475,136,39,0.006666667,267554,0.301775321
2217,663,379,136,39,0.006666667,267690,0.301928716
2106,473,663,135,39,0.006617647,267825,0.302080984
1604,310,367,134,39,0.006568627,267959,0.302232123
1627,443,529,134,39,0.006568627,268093,0.302383262
1919,84,609,134,39,0.006568627,268227,0.302534401
1279,56,105,133,39,0.006519608,268360,0.302684412
944,331,10,133,39,0.006519608,268493,0.302834424
1118,532,529,132,39,0.006470588,268625,0.302983307
1744,236,219,132,39,0.006470588,268757,0.30313219
1403,236,311,130,39,0.006372549,268887,0.303278818
1670,331,398,130,39,0.006372549,269017,0.303425446
901,77,32,130,39,0.006372549,269147,0.303572073
2364,663,331,130,39,0.006372549,269277,0.303718701
1029,479,105,130,39,0.006372549,269407,0.303865328
3718,463,95,129,39,0.006323529,269536,0.304010828
2524,68,498,129,39,0.006323529,269665,0.304156328
659,9,367,128,39,0.00627451,269793,0.304300699
760,582,397,128,39,0.00627451,269921,0.304445071
1479,498,16,128,39,0.00627451,270049,0.304589443
1062,393,331,127,39,0.00622549,270176,0.304732687
1771,230,443,127,39,0.00622549,270303,0.304875931
1080,9,68,127,39,0.00622549,270430,0.305019174
1806,380,85,127,39,0.00622549,270557,0.305162418
1493,10,311,126,39,0.006176471,270683,0.305304534
1681,77,514,126,39,0.006176471,270809,0.30544665
1567,311,498,126,39,0.006176471,270935,0.305588766
1470,131,314,126,39,0.006176471,271061,0.305730882
1813,224,497,126,39,0.006176471,271187,0.305872998
1638,80,302,125,39,0.006127451,271312,0.306013986
2017,353,131,125,39,0.006127451,271437,0.306154974
2099,535,310,125,39,0.006127451,271562,0.306295962
1886,84,379,125,39,0.006127451,271687,0.30643695
1351,367,393,125,39,0.006127451,271812,0.306577938
1790,236,250,124,39,0.006078431,271936,0.306717798
1988,380,398,124,39,0.006078431,272060,0.306857658
3027,348,522,124,39,0.006078431,272184,0.306997519
2207,582,463,124,39,0.006078431,272308,0.307137379
594,16,158,124,39,0.006078431,272432,0.307277239
1975,230,498,123,39,0.006029412,272555,0.307415971
2563,68,708,123,39,0.006029412,272678,0.307554703
953,20,15,122,39,0.005980392,272800,0.307692308
1155,9,663,121,39,0.005931373,272921,0.307828784
1796,131,105,119,39,0.005833333,273040,0.307963005
1441,632,27,119,39,0.005833333,273159,0.308097225
2054,236,473,119,39,0.005833333,273278,0.308231446
2262,353,514,119,39,0.005833333,273397,0.308365667
1767,473,475,119,39,0.005833333,273516,0.308499887
1369,84,314,119,39,0.005833333,273635,0.308634108
2431,48,10,118,39,0.005784314,273753,0.308767201
2073,558,68,118,39,0.005784314,273871,0.308900293
2304,107,522,118,39,0.005784314,273989,0.309033386
1928,107,443,118,39,0.005784314,274107,0.309166479
356,353,80,118,39,0.005784314,274225,0.309299571
1615,588,3,117,39,0.005735294,274342,0.309431536
2484,380,114,117,39,0.005735294,274459,0.309563501
1515,311,558,115,39,0.005637255,274574,0.30969321
1377,311,95,115,39,0.005637255,274689,0.309822919
1176,367,335,114,39,0.005588235,274803,0.3099515
1154,367,331,113,39,0.005539216,274916,0.310078953
1502,3,354,112,39,0.005490196,275028,0.310205279
1995,48,16,111,39,0.005441176,275139,0.310330476
2457,473,498,111,39,0.005441176,275250,0.310455673
1996,77,613,111,39,0.005441176,275361,0.310580871
1267,586,380,111,39,0.005441176,275472,0.310706068
1218,380,334,111,39,0.005441176,275583,0.310831266
2597,3,475,110,39,0.005392157,275693,0.310955335
1972,314,543,110,39,0.005392157,275803,0.311079404
3026,224,204,110,39,0.005392157,275913,0.311203474
3274,588,107,110,39,0.005392157,276023,0.311327543
1188,463,314,109,39,0.005343137,276132,0.311450485
2119,10,558,109,39,0.005343137,276241,0.311573427
2216,68,50,107,39,0.005245098,276348,0.311694112
1339,32,353,107,39,0.005245098,276455,0.311814798
1903,130,379,106,39,0.005196078,276561,0.311934356
2767,380,347,104,39,0.005098039,276665,0.312051658
1942,311,280,103,39,0.00504902,276768,0.312167832
2341,335,264,103,39,0.00504902,276871,0.312284006
3687,543,473,100,39,0.004901961,276971,0.312396797
4544,471,32,100,39,0.004901961,277071,0.312509587
2745,302,3,96,39,0.004705882,277167,0.312617866
1976,6,708,90,39,0.004411765,277257,0.312719377
4463,105,652,89,39,0.004362745,277346,0.312819761
833,674,80,87,39,0.004264706,277433,0.312917889
5102,48,14,86,39,0.004215686,277519,0.313014888
5284,10,661,84,39,0.004117647,277603,0.313109632
2568,354,68,83,39,0.004068627,277686,0.313203248
8940,544,242,63,39,0.003088235,277749,0.313274306
207,27,243,438,38,0.021470588,278187,0.313768328
135,16,27,388,38,0.019019608,278575,0.314205955
251,663,27,336,38,0.016470588,278911,0.314584931
383,230,314,326,38,0.015980392,279237,0.314952628
329,27,3,323,38,0.015833333,279560,0.315316941
292,380,16,323,38,0.015833333,279883,0.315681254
272,224,582,284,38,0.013921569,280167,0.316001579
227,32,68,282,38,0.013823529,280449,0.316319648
582,68,380,280,38,0.01372549,280729,0.316635461
414,335,3,280,38,0.01372549,281009,0.316951275
475,354,27,280,38,0.01372549,281289,0.317267088
584,27,398,274,38,0.013431373,281563,0.317576134
382,562,27,261,38,0.012794118,281824,0.317870517
460,77,302,260,38,0.012745098,282084,0.318163772
345,77,311,250,38,0.012254902,282334,0.318445748
283,302,27,247,38,0.012107843,282581,0.31872434
811,473,347,246,38,0.012058824,282827,0.319001805
386,522,380,246,38,0.012058824,283073,0.319279269
482,380,335,245,38,0.012009804,283318,0.319555606
484,77,280,243,38,0.011911765,283561,0.319829686
981,68,204,242,38,0.011862745,283803,0.320102639
566,80,16,241,38,0.011813725,284044,0.320374464
288,26,353,241,38,0.011813725,284285,0.320646289
850,27,167,240,38,0.011764706,284525,0.320916986
1035,27,54,240,38,0.011764706,284765,0.321187683
593,473,95,239,38,0.011715686,285004,0.321457252
816,588,95,233,38,0.011421569,285237,0.321720054
661,473,348,227,38,0.011127451,285464,0.321976088
464,335,48,227,38,0.011127451,285691,0.322232123
557,311,354,226,38,0.011078431,285917,0.322487029
678,27,708,225,38,0.011029412,286142,0.322740808
473,236,529,224,38,0.010980392,286366,0.322993458
459,314,334,224,38,0.010980392,286590,0.323246109
399,331,105,223,38,0.010931373,286813,0.323497631
812,314,586,222,38,0.010882353,287035,0.323748026
468,353,380,222,38,0.010882353,287257,0.323998421
666,131,224,222,38,0.010882353,287479,0.324248816
575,498,27,221,38,0.010833333,287700,0.324498083
554,77,655,217,38,0.010637255,287917,0.324742838
858,27,479,217,38,0.010637255,288134,0.324987593
829,27,508,216,38,0.010588235,288350,0.32523122
873,34,27,214,38,0.010490196,288564,0.325472592
675,535,314,213,38,0.010441176,288777,0.325712836
815,230,379,213,38,0.010441176,288990,0.325953079
599,105,50,213,38,0.010441176,289203,0.326193323
877,471,582,213,38,0.010441176,289416,0.326433566
586,353,26,213,38,0.010441176,289629,0.32667381
428,313,335,212,38,0.010392157,289841,0.326912926
497,105,471,211,38,0.010343137,290052,0.327150914
933,314,14,211,38,0.010343137,290263,0.327388901
445,313,32,211,38,0.010343137,290474,0.327626889
789,314,236,210,38,0.010294118,290684,0.327863749
527,663,314,209,38,0.010245098,290893,0.328099481
331,582,32,209,38,0.010245098,291102,0.328335213
481,77,354,207,38,0.010147059,291309,0.328568689
689,3,380,207,38,0.010147059,291516,0.328802166
1113,230,9,205,38,0.01004902,291721,0.329033386
1074,27,632,205,38,0.01004902,291926,0.329264606
644,335,6,203,38,0.00995098,292129,0.329493571
749,588,331,202,38,0.009901961,292331,0.329721408
1587,348,224,201,38,0.009852941,292532,0.329948116
1001,588,582,200,38,0.009803922,292732,0.330173697
676,9,588,200,38,0.009803922,292932,0.330399278
669,473,3,200,38,0.009803922,293132,0.330624859
837,84,353,200,38,0.009803922,293332,0.33085044
652,473,331,199,38,0.009754902,293531,0.331074893
784,310,105,198,38,0.009705882,293729,0.331298218
597,335,84,195,38,0.009558824,293924,0.331518159
1623,348,33,195,38,0.009558824,294119,0.331738101
792,353,443,195,38,0.009558824,294314,0.331958042
730,532,443,194,38,0.009509804,294508,0.332176855
1013,335,609,194,38,0.009509804,294702,0.332395669
980,3,224,192,38,0.009411765,294894,0.332612226
743,77,588,192,38,0.009411765,295086,0.332828784
1734,535,10,192,38,0.009411765,295278,0.333045342
436,9,16,190,38,0.009313725,295468,0.333259644
902,335,663,190,38,0.009313725,295658,0.333473945
1079,380,107,190,38,0.009313725,295848,0.333688247
574,9,302,190,38,0.009313725,296038,0.333902549
1142,335,328,188,38,0.009215686,296226,0.334114595
486,314,638,188,38,0.009215686,296414,0.334326641
729,77,471,186,38,0.009117647,296600,0.334536431
794,314,596,186,38,0.009117647,296786,0.334746222
605,473,10,185,38,0.009068627,296971,0.334954884
950,473,15,185,38,0.009068627,297156,0.335163546
1380,3,471,185,38,0.009068627,297341,0.335372208
771,84,105,185,38,0.009068627,297526,0.335580871
589,586,27,185,38,0.009068627,297711,0.335789533
755,313,95,184,38,0.009019608,297895,0.335997067
165,224,80,184,38,0.009019608,298079,0.336204602
275,313,80,183,38,0.008970588,298262,0.336411008
1007,582,230,183,38,0.008970588,298445,0.336617415
929,314,723,183,38,0.008970588,298628,0.336823821
1042,50,27,183,38,0.008970588,298811,0.337030228
1055,130,68,183,38,0.008970588,298994,0.337236634
860,107,397,182,38,0.008921569,299176,0.337441913
1133,68,379,182,38,0.008921569,299358,0.337647192
1172,224,243,182,38,0.008921569,299540,0.33785247
1832,348,475,181,38,0.008872549,299721,0.338056621
1296,130,335,181,38,0.008872549,299902,0.338260771
357,32,105,180,38,0.008823529,300082,0.338463794
764,105,280,180,38,0.008823529,300262,0.338666817
595,77,26,179,38,0.00877451,300441,0.338868712
1564,68,10,179,38,0.00877451,300620,0.339070607
773,380,354,179,38,0.00877451,300799,0.339272502
404,529,27,179,38,0.00877451,300978,0.339474397
821,105,307,179,38,0.00877451,301157,0.339676291
1387,68,353,178,38,0.00872549,301335,0.339877058
907,532,498,178,38,0.00872549,301513,0.340077825
1219,236,354,178,38,0.00872549,301691,0.340278592
1099,596,393,178,38,0.00872549,301869,0.340479359
1336,414,380,177,38,0.008676471,302046,0.340678998
1093,588,367,176,38,0.008627451,302222,0.34087751
540,380,123,176,38,0.008627451,302398,0.341076021
521,77,334,176,38,0.008627451,302574,0.341274532
502,9,335,175,38,0.008578431,302749,0.341471915
854,77,404,173,38,0.008480392,302922,0.341667043
783,224,9,173,38,0.008480392,303095,0.34186217
1432,348,314,173,38,0.008480392,303268,0.342057298
423,397,27,172,38,0.008431373,303440,0.342251297
952,26,498,171,38,0.008382353,303611,0.342444169
822,314,84,171,38,0.008382353,303782,0.34263704
1197,230,522,171,38,0.008382353,303953,0.342829912
861,663,105,171,38,0.008382353,304124,0.343022784
1006,68,123,171,38,0.008382353,304295,0.343215655
756,558,314,170,38,0.008333333,304465,0.343407399
733,236,314,170,38,0.008333333,304635,0.343599143
834,331,68,170,38,0.008333333,304805,0.343790887
1208,380,404,170,38,0.008333333,304975,0.34398263
813,16,310,170,38,0.008333333,305145,0.344174374
1202,68,354,170,38,0.008333333,305315,0.344366118
1220,328,27,170,38,0.008333333,305485,0.344557861
996,353,224,169,38,0.008284314,305654,0.344748477
1160,562,310,169,38,0.008284314,305823,0.344939093
1098,335,535,169,38,0.008284314,305992,0.345129709
967,84,443,169,38,0.008284314,306161,0.345320325
820,443,380,168,38,0.008235294,306329,0.345509813
780,313,314,168,38,0.008235294,306497,0.345699301
1636,348,16,168,38,0.008235294,306665,0.345888789
970,313,97,168,38,0.008235294,306833,0.346078277
1174,471,314,167,38,0.008186275,307000,0.346266637
1045,105,497,167,38,0.008186275,307167,0.346454997
1721,224,443,167,38,0.008186275,307334,0.346643357
851,314,204,167,38,0.008186275,307501,0.346831717
1392,130,353,166,38,0.008137255,307667,0.347018949
1405,107,596,166,38,0.008137255,307833,0.347206181
963,314,280,165,38,0.008088235,307998,0.347392285
1100,331,609,165,38,0.008088235,308163,0.347578389
1764,80,471,164,38,0.008039216,308327,0.347763366
1649,230,313,164,38,0.008039216,308491,0.347948342
2195,348,708,164,38,0.008039216,308655,0.348133318
1109,3,9,164,38,0.008039216,308819,0.348318295
1210,473,367,164,38,0.008039216,308983,0.348503271
547,331,473,164,38,0.008039216,309147,0.348688247
1353,380,48,164,38,0.008039216,309311,0.348873224
722,473,311,164,38,0.008039216,309475,0.3490582
516,33,473,164,38,0.008039216,309639,0.349243176
1178,250,397,164,38,0.008039216,309803,0.349428152
890,311,310,163,38,0.007990196,309966,0.349612001
958,107,394,163,38,0.007990196,310129,0.349795849
1290,310,230,163,38,0.007990196,310292,0.349979698
1260,353,280,163,38,0.007990196,310455,0.350163546
868,335,280,162,38,0.007941176,310617,0.350346267
565,311,123,162,38,0.007941176,310779,0.350528987
968,380,443,162,38,0.007941176,310941,0.350711708
1036,105,404,162,38,0.007941176,311103,0.350894428
1294,479,33,161,38,0.007892157,311264,0.351076021
1293,314,5,161,38,0.007892157,311425,0.351257613
2090,48,95,161,38,0.007892157,311586,0.351439206
1137,26,443,160,38,0.007843137,311746,0.351619671
1030,582,558,160,38,0.007843137,311906,0.351800135
872,354,314,160,38,0.007843137,312066,0.3519806
1011,314,34,160,38,0.007843137,312226,0.352161065
1402,48,310,160,38,0.007843137,312386,0.352341529
1345,27,605,160,38,0.007843137,312546,0.352521994
1631,130,230,160,38,0.007843137,312706,0.352702459
598,105,638,160,38,0.007843137,312866,0.352882924
1292,105,463,159,38,0.007794118,313025,0.35306226
1690,105,528,158,38,0.007745098,313183,0.353240469
1073,335,295,158,38,0.007745098,313341,0.353418678
1872,473,5,157,38,0.007696078,313498,0.353595759
840,331,353,157,38,0.007696078,313655,0.35377284
1022,314,26,156,38,0.007647059,313811,0.353948793
1095,130,314,156,38,0.007647059,313967,0.354124746
759,313,367,156,38,0.007647059,314123,0.354300699
857,33,224,156,38,0.007647059,314279,0.354476652
563,33,105,156,38,0.007647059,314435,0.354652605
2003,663,558,155,38,0.007598039,314590,0.354827431
573,514,243,155,38,0.007598039,314745,0.355002256
1163,80,443,155,38,0.007598039,314900,0.355177081
2310,80,77,155,38,0.007598039,315055,0.355351906
1464,354,331,155,38,0.007598039,315210,0.355526731
1541,250,609,155,38,0.007598039,315365,0.355701557
1603,230,397,155,38,0.007598039,315520,0.355876382
1677,236,10,154,38,0.00754902,315674,0.356050079
1070,10,331,154,38,0.00754902,315828,0.356223776
248,311,80,154,38,0.00754902,315982,0.356397473
658,367,314,154,38,0.00754902,316136,0.356571171
1648,68,397,154,38,0.00754902,316290,0.356744868
810,313,3,154,38,0.00754902,316444,0.356918565
1067,15,27,153,38,0.0075,316597,0.357091135
1269,33,31,152,38,0.00745098,316749,0.357262576
943,77,3,152,38,0.00745098,316901,0.357434018
645,582,6,152,38,0.00745098,317053,0.357605459
1330,130,9,152,38,0.00745098,317205,0.357776901
1490,68,558,152,38,0.00745098,317357,0.357948342
1892,348,558,152,38,0.00745098,317509,0.358119783
761,123,105,152,38,0.00745098,317661,0.358291225
618,394,27,151,38,0.007401961,317812,0.358461538
994,310,302,151,38,0.007401961,317963,0.358631852
1327,10,302,150,38,0.007352941,318113,0.358801038
1077,105,141,150,38,0.007352941,318263,0.358970223
1596,558,473,150,38,0.007352941,318413,0.359139409
707,6,582,150,38,0.007352941,318563,0.359308595
1236,80,367,149,38,0.007303922,318712,0.359476652
1647,131,582,149,38,0.007303922,318861,0.35964471
2097,348,95,149,38,0.007303922,319010,0.359812768
1341,107,473,149,38,0.007303922,319159,0.359980826
938,596,353,148,38,0.007254902,319307,0.360147755
948,9,471,148,38,0.007254902,319455,0.360314685
1618,68,14,148,38,0.007254902,319603,0.360481615
1091,123,33,148,38,0.007254902,319751,0.360648545
985,588,123,148,38,0.007254902,319899,0.360815475
535,588,80,147,38,0.007205882,320046,0.360981277
683,313,354,147,38,0.007205882,320193,0.361147079
588,596,105,147,38,0.007205882,320340,0.361312881
1728,224,280,147,38,0.007205882,320487,0.361478683
1143,314,532,147,38,0.007205882,320634,0.361644485
1457,84,367,147,38,0.007205882,320781,0.361810286
1300,130,582,147,38,0.007205882,320928,0.361976088
2014,348,230,147,38,0.007205882,321075,0.36214189
1114,588,311,147,38,0.007205882,321222,0.362307692
1622,588,348,146,38,0.007156863,321368,0.362472366
959,582,219,146,38,0.007156863,321514,0.36263704
1153,224,335,146,38,0.007156863,321660,0.362801714
1671,130,331,146,38,0.007156863,321806,0.362966388
1738,335,404,145,38,0.007107843,321951,0.363129935
1597,10,68,145,38,0.007107843,322096,0.363293481
976,32,219,145,38,0.007107843,322241,0.363457027
1819,236,32,145,38,0.007107843,322386,0.363620573
2046,230,48,145,38,0.007107843,322531,0.363784119
1328,10,33,144,38,0.007058824,322675,0.363946537
2714,348,471,144,38,0.007058824,322819,0.364108956
1410,473,558,144,38,0.007058824,322963,0.364271374
2185,48,522,144,38,0.007058824,323107,0.364433792
1108,582,663,144,38,0.007058824,323251,0.36459621
1698,236,443,143,38,0.007009804,323394,0.364757501
878,123,16,143,38,0.007009804,323537,0.364918791
1207,105,674,143,38,0.007009804,323680,0.365080081
1696,130,16,142,38,0.006960784,323822,0.365240244
1268,314,2,142,38,0.006960784,323964,0.365400406
1748,107,236,142,38,0.006960784,324106,0.365560568
2076,80,107,142,38,0.006960784,324248,0.365720731
1383,588,31,142,38,0.006960784,324390,0.365880893
1314,479,380,142,38,0.006960784,324532,0.366041056
1853,353,10,142,38,0.006960784,324674,0.366201218
2267,130,397,141,38,0.006911765,324815,0.366360253
1323,236,9,141,38,0.006911765,324956,0.366519287
2107,230,131,141,38,0.006911765,325097,0.366678322
1724,158,16,141,38,0.006911765,325238,0.366837356
1063,33,16,141,38,0.006911765,325379,0.366996391
986,522,77,141,38,0.006911765,325520,0.367155425
1092,3,331,141,38,0.006911765,325661,0.36731446
1741,313,463,141,38,0.006911765,325802,0.367473494
1071,379,224,140,38,0.006862745,325942,0.367631401
1525,224,95,140,38,0.006862745,326082,0.367789307
1791,596,529,139,38,0.006813725,326221,0.367946086
997,335,479,139,38,0.006813725,326360,0.368102865
682,353,105,139,38,0.006813725,326499,0.368259644
1195,532,353,139,38,0.006813725,326638,0.368416422
1124,224,311,139,38,0.006813725,326777,0.368573201
1849,663,302,139,38,0.006813725,326916,0.36872998
1211,9,10,138,38,0.006764706,327054,0.36888563
1553,80,219,138,38,0.006764706,327192,0.369041281
654,313,6,138,38,0.006764706,327330,0.369196932
2362,348,131,137,38,0.006715686,327467,0.369351455
1612,107,586,137,38,0.006715686,327604,0.369505978
1193,497,27,137,38,0.006715686,327741,0.369660501
1469,84,107,136,38,0.006666667,327877,0.369813896
1187,582,348,136,38,0.006666667,328013,0.369967291
1286,16,655,136,38,0.006666667,328149,0.370120686
1894,3,48,135,38,0.006617647,328284,0.370272953
1337,77,348,135,38,0.006617647,328419,0.37042522
1223,26,25,135,38,0.006617647,328554,0.370577487
1535,230,311,135,38,0.006617647,328689,0.370729754
510,397,105,134,38,0.006568627,328823,0.370880893
1427,56,582,134,38,0.006568627,328957,0.371032032
1355,331,33,134,38,0.006568627,329091,0.371183172
1633,475,27,134,38,0.006568627,329225,0.371334311
1324,335,532,134,38,0.006568627,329359,0.37148545
1458,380,280,133,38,0.006519608,329492,0.371635461
1608,114,27,133,38,0.006519608,329625,0.371785473
1804,479,32,133,38,0.006519608,329758,0.371935484
1657,123,522,131,38,0.006421569,329889,0.372083239
2446,596,404,131,38,0.006421569,330020,0.372230995
1574,596,367,130,38,0.006372549,330150,0.372377622
2226,609,250,130,38,0.006372549,330280,0.37252425
1989,354,397,130,38,0.006372549,330410,0.372670878
1676,310,10,129,38,0.006323529,330539,0.372816377
1194,295,473,129,38,0.006323529,330668,0.372961877
2955,522,347,129,38,0.006323529,330797,0.373107376
1906,596,250,129,38,0.006323529,330926,0.373252876
739,20,196,129,38,0.006323529,331055,0.373398376
1342,582,97,128,38,0.00627451,331183,0.373542748
1418,77,385,128,38,0.00627451,331311,0.373687119
1879,380,558,128,38,0.00627451,331439,0.373831491
571,224,123,128,38,0.00627451,331567,0.373975863
1913,313,347,128,38,0.00627451,331695,0.374120235
1183,582,689,127,38,0.00622549,331822,0.374263478
1495,353,397,127,38,0.00622549,331949,0.374406722
606,295,314,127,38,0.00622549,332076,0.374549966
1720,335,414,127,38,0.00622549,332203,0.37469321
1489,123,219,127,38,0.00622549,332330,0.374836454
2869,48,97,126,38,0.006176471,332456,0.37497857
2140,354,10,126,38,0.006176471,332582,0.375120686
1362,311,3,126,38,0.006176471,332708,0.375262802
1221,331,522,126,38,0.006176471,332834,0.375404918
1589,314,130,126,38,0.006176471,332960,0.375547034
2414,663,131,126,38,0.006176471,333086,0.37568915
1056,9,311,125,38,0.006127451,333211,0.375830138
1204,543,27,124,38,0.006078431,333335,0.375969998
2128,479,68,124,38,0.006078431,333459,0.376109858
1884,311,31,124,38,0.006078431,333583,0.376249718
1121,123,335,124,38,0.006078431,333707,0.376389578
1409,105,723,124,38,0.006078431,333831,0.376529438
507,32,302,123,38,0.006029412,333954,0.376668171
1310,311,394,123,38,0.006029412,334077,0.376806903
2376,131,33,123,38,0.006029412,334200,0.376945635
1420,280,498,123,38,0.006029412,334323,0.377084367
911,26,105,122,38,0.005980392,334445,0.377221972
1664,473,295,122,38,0.005980392,334567,0.377359576
1224,313,348,122,38,0.005980392,334689,0.37749718
2260,353,367,122,38,0.005980392,334811,0.377634785
1476,311,11,121,38,0.005931373,334932,0.377771261
1281,33,479,121,38,0.005931373,335053,0.377907737
1146,32,6,120,38,0.005882353,335173,0.378043086
637,9,397,120,38,0.005882353,335293,0.378178434
1914,335,385,120,38,0.005882353,335413,0.378313783
869,9,33,120,38,0.005882353,335533,0.378449132
1425,498,224,120,38,0.005882353,335653,0.37858448
2348,68,394,120,38,0.005882353,335773,0.378719829
1726,77,114,119,38,0.005833333,335892,0.378854049
1652,107,379,119,38,0.005833333,336011,0.37898827
962,582,498,119,38,0.005833333,336130,0.37912249
1537,502,27,119,38,0.005833333,336249,0.379256711
2384,663,31,119,38,0.005833333,336368,0.379390932
1529,443,397,118,38,0.005784314,336486,0.379524024
1181,10,123,118,38,0.005784314,336604,0.379657117
918,9,95,118,38,0.005784314,336722,0.37979021
1498,32,204,118,38,0.005784314,336840,0.379923303
1887,582,609,117,38,0.005735294,336957,0.380055267
1140,280,219,117,38,0.005735294,337074,0.380187232
2150,236,107,117,38,0.005735294,337191,0.380319197
2634,158,655,117,38,0.005735294,337308,0.380451162
1606,596,310,117,38,0.005735294,337425,0.380583127
2313,588,131,117,38,0.005735294,337542,0.380715091
931,331,334,117,38,0.005735294,337659,0.380847056
1717,313,663,116,38,0.005686275,337775,0.380977893
2626,68,307,116,38,0.005686275,337891,0.38110873
1952,56,380,115,38,0.005637255,338006,0.381238439
910,16,9,115,38,0.005637255,338121,0.381368148
723,331,123,115,38,0.005637255,338236,0.381497857
1716,310,379,114,38,0.005588235,338350,0.381626438
1956,331,243,114,38,0.005588235,338464,0.381755019
1712,331,3,114,38,0.005588235,338578,0.3818836
1251,26,532,114,38,0.005588235,338692,0.382012181
1579,558,32,113,38,0.005539216,338805,0.382139635
1184,107,9,113,38,0.005539216,338918,0.382267088
1651,105,130,113,38,0.005539216,339031,0.382394541
2465,131,219,113,38,0.005539216,339144,0.382521994
1936,310,313,112,38,0.005490196,339256,0.382648319
2237,479,471,112,38,0.005490196,339368,0.382774645
2504,105,517,112,38,0.005490196,339480,0.38290097
1285,77,497,111,38,0.005441176,339591,0.383026167
2690,130,31,111,38,0.005441176,339702,0.383151365
1985,443,367,111,38,0.005441176,339813,0.383276562
2104,562,131,110,38,0.005392157,339923,0.383400632
1929,16,498,110,38,0.005392157,340033,0.383524701
1634,663,335,110,38,0.005392157,340143,0.383648771
941,33,123,110,38,0.005392157,340253,0.38377284
672,11,80,110,38,0.005392157,340363,0.38389691
2340,230,3,110,38,0.005392157,340473,0.384020979
1422,6,380,110,38,0.005392157,340583,0.384145048
2410,335,14,109,38,0.005343137,340692,0.38426799
2392,354,32,109,38,0.005343137,340801,0.384390932
1801,532,131,108,38,0.005294118,340909,0.384512745
1772,397,596,107,38,0.005245098,341016,0.384633431
1820,311,689,107,38,0.005245098,341123,0.384754117
2212,224,394,107,38,0.005245098,341230,0.384874803
1725,674,10,107,38,0.005245098,341337,0.384995488
2976,130,535,106,38,0.005196078,341443,0.385115046
1382,674,105,106,38,0.005196078,341549,0.385234604
2784,6,5,106,38,0.005196078,341655,0.385354162
1953,379,9,105,38,0.005147059,341760,0.385472592
3506,479,131,105,38,0.005147059,341865,0.385591022
1611,311,596,105,38,0.005147059,341970,0.385709452
2254,280,131,104,38,0.005098039,342074,0.385826754
2152,335,640,104,38,0.005098039,342178,0.385944056
2909,68,236,103,38,0.00504902,342281,0.38606023
3237,230,141,103,38,0.00504902,342384,0.386176404
2625,479,295,103,38,0.00504902,342487,0.386292578
3944,663,243,103,38,0.00504902,342590,0.386408753
2899,131,9,102,38,0.005,342692,0.386523799
3554,80,682,102,38,0.005,342794,0.386638845
1907,663,123,102,38,0.005,342896,0.386753891
2023,588,219,101,38,0.00495098,342997,0.38686781
1485,379,16,101,38,0.00495098,343098,0.386981728
2445,230,348,101,38,0.00495098,343199,0.387095646
3892,471,347,100,38,0.004901961,343299,0.387208437
1411,32,379,100,38,0.004901961,343399,0.387321227
2741,48,123,99,38,0.004852941,343498,0.38743289
1841,123,230,99,38,0.004852941,343597,0.387544552
2726,348,331,99,38,0.004852941,343696,0.387656215
2706,26,596,99,38,0.004852941,343795,0.387767877
1878,582,107,98,38,0.004803922,343893,0.387878412
1297,313,394,98,38,0.004803922,343991,0.387988947
2655,105,34,97,38,0.004754902,344088,0.388098353
3411,11,10,97,38,0.004754902,344185,0.38820776
2272,15,68,97,38,0.004754902,344282,0.388317167
2403,48,379,97,38,0.004754902,344379,0.388426573
2019,331,280,97,38,0.004754902,344476,0.38853598
1848,20,30,95,38,0.004656863,344571,0.388643131
3401,473,517,95,38,0.004656863,344666,0.388750282
2900,130,219,94,38,0.004607843,344760,0.388856305
1842,3,479,94,38,0.004607843,344854,0.388962328
515,397,80,93,38,0.004558824,344947,0.389067223
2711,130,354,92,38,0.004509804,345039,0.38917099
1814,33,588,90,38,0.004411765,345129,0.389272502
1347,16,77,89,38,0.004362745,345218,0.389372885
3484,230,609,89,38,0.004362745,345307,0.389473269
3306,230,307,88,38,0.004313725,345395,0.389572524
1301,9,638,88,38,0.004313725,345483,0.38967178
2732,314,117,86,38,0.004215686,345569,0.38976878
3159,398,367,86,38,0.004215686,345655,0.389865779
2375,614,380,85,38,0.004166667,345740,0.389961651
4080,9,364,81,38,0.003970588,345821,0.390053012
2750,501,655,80,38,0.003921569,345901,0.390143244
2459,9,107,79,38,0.003872549,345980,0.390232348
4031,130,14,75,38,0.003676471,346055,0.390316941
4931,12,379,69,38,0.003382353,346124,0.390394767
466,313,471,297,37,0.014558824,346421,0.390729754
489,204,27,269,37,0.013186275,346690,0.39103316
745,354,380,241,37,0.011813725,346931,0.391304985
539,10,16,222,37,0.010882353,347153,0.39155538
788,32,347,213,37,0.010441176,347366,0.391795624
806,105,347,208,37,0.010196078,347574,0.392030228
1389,250,367,207,37,0.010147059,347781,0.392263704
836,27,64,200,37,0.009803922,347981,0.392489285
908,10,310,199,37,0.009754902,348180,0.392713738
591,280,353,199,37,0.009754902,348379,0.392938191
1002,230,32,193,37,0.009460784,348572,0.393155876
455,473,479,191,37,0.009362745,348763,0.393371306
925,588,475,191,37,0.009362745,348954,0.393586736
703,105,295,190,37,0.009313725,349144,0.393801038
778,535,80,190,37,0.009313725,349334,0.394015339
899,84,397,189,37,0.009264706,349523,0.394228513
747,25,27,189,37,0.009264706,349712,0.394441687
671,314,674,188,37,0.009215686,349900,0.394653733
1049,224,302,184,37,0.009019608,350084,0.394861268
913,522,224,183,37,0.008970588,350267,0.395067674
974,311,219,183,37,0.008970588,350450,0.395274081
1284,27,560,182,37,0.008921569,350632,0.395479359
823,588,314,181,37,0.008872549,350813,0.39568351
1159,68,334,178,37,0.00872549,350991,0.395884277
738,107,582,177,37,0.008676471,351168,0.396083916
888,107,393,177,37,0.008676471,351345,0.396283555
448,33,582,174,37,0.008529412,351519,0.396479811
927,335,114,174,37,0.008529412,351693,0.396676066
1068,10,230,173,37,0.008480392,351866,0.396871193
1120,230,354,173,37,0.008480392,352039,0.397066321
632,335,77,173,37,0.008480392,352212,0.397261448
523,230,80,171,37,0.008382353,352383,0.39745432
1288,224,33,171,37,0.008382353,352554,0.397647192
717,310,473,170,37,0.008333333,352724,0.397838935
1102,243,27,170,37,0.008333333,352894,0.398030679
1559,171,27,168,37,0.008235294,353062,0.398220167
930,27,20,167,37,0.008186275,353229,0.398408527
1552,236,596,166,37,0.008137255,353395,0.398595759
1065,380,522,165,37,0.008088235,353560,0.398781863
651,379,314,165,37,0.008088235,353725,0.398967968
1773,522,33,165,37,0.008088235,353890,0.399154072
1452,27,117,165,37,0.008088235,354055,0.399340176
1119,463,27,163,37,0.007990196,354218,0.399524024
1257,479,302,163,37,0.007990196,354381,0.399707873
1000,80,397,161,37,0.007892157,354542,0.399889465
2298,348,31,159,37,0.007794118,354701,0.400068802
1270,479,310,158,37,0.007745098,354859,0.400247011
896,105,348,154,37,0.00754902,355013,0.400420708
534,655,27,154,37,0.00754902,355167,0.400594406
849,32,558,154,37,0.00754902,355321,0.400768103
1821,224,16,153,37,0.0075,355474,0.400940672
1086,588,354,153,37,0.0075,355627,0.401113242
1038,77,663,152,37,0.00745098,355779,0.401284683
1167,77,265,152,37,0.00745098,355931,0.401456125
2233,230,107,151,37,0.007401961,356082,0.401626438
1319,552,27,151,37,0.007401961,356233,0.401796752
921,77,95,151,37,0.007401961,356384,0.401967065
886,123,331,151,37,0.007401961,356535,0.402137379
960,313,31,151,37,0.007401961,356686,0.402307692
846,673,27,150,37,0.007352941,356836,0.402476878
1825,353,164,150,37,0.007352941,356986,0.402646064
847,33,310,150,37,0.007352941,357136,0.402815249
1727,80,529,150,37,0.007352941,357286,0.402984435
1565,230,353,149,37,0.007303922,357435,0.403152493
713,367,582,148,37,0.007254902,357583,0.403319423
1443,10,9,148,37,0.007254902,357731,0.403486352
2088,68,347,148,37,0.007254902,357879,0.403653282
2282,348,14,147,37,0.007205882,358026,0.403819084
1944,236,522,147,37,0.007205882,358173,0.403984886
2580,348,295,146,37,0.007156863,358319,0.40414956
1497,230,310,146,37,0.007156863,358465,0.404314234
1399,105,385,146,37,0.007156863,358611,0.404478908
1500,335,674,145,37,0.007107843,358756,0.404642454
942,311,33,145,37,0.007107843,358901,0.404806
1298,84,224,144,37,0.007058824,359045,0.404968419
1523,6,16,144,37,0.007058824,359189,0.405130837
1433,107,331,143,37,0.007009804,359332,0.405292127
504,582,353,143,37,0.007009804,359475,0.405453418
972,532,380,142,37,0.006960784,359617,0.40561358
984,156,27,142,37,0.006960784,359759,0.405773742
1475,3,123,142,37,0.006960784,359901,0.405933905
1824,27,364,142,37,0.006960784,360043,0.406094067
1693,230,219,141,37,0.006911765,360184,0.406253102
1350,380,131,141,37,0.006911765,360325,0.406412136
2133,224,463,141,37,0.006911765,360466,0.406571171
1687,68,145,141,37,0.006911765,360607,0.406730205
1583,3,10,141,37,0.006911765,360748,0.40688924
1438,84,393,140,37,0.006862745,360888,0.407047146
1061,77,80,140,37,0.006862745,361028,0.407205053
1992,68,663,140,37,0.006862745,361168,0.40736296
1253,105,689,140,37,0.006862745,361308,0.407520866
1103,310,16,140,37,0.006862745,361448,0.407678773
1937,473,463,140,37,0.006862745,361588,0.407836679
1005,588,6,139,37,0.006813725,361727,0.407993458
883,331,354,139,37,0.006813725,361866,0.408150237
2190,236,558,139,37,0.006813725,362005,0.408307016
1058,311,588,139,37,0.006813725,362144,0.408463794
1332,158,27,138,37,0.006764706,362282,0.408619445
1522,230,123,138,37,0.006764706,362420,0.408775096
905,335,26,138,37,0.006764706,362558,0.408930747
1863,84,243,136,37,0.006666667,362694,0.409084142
1116,280,443,136,37,0.006666667,362830,0.409237537
2174,131,16,136,37,0.006666667,362966,0.409390932
1831,522,68,136,37,0.006666667,363102,0.409544327
1250,6,204,135,37,0.006617647,363237,0.409696594
1473,314,30,135,37,0.006617647,363372,0.409848861
1713,10,95,135,37,0.006617647,363507,0.410001128
978,522,311,135,37,0.006617647,363642,0.410153395
1299,532,16,135,37,0.006617647,363777,0.410305662
1164,274,27,134,37,0.006568627,363911,0.410456801
1560,3,230,134,37,0.006568627,364045,0.41060794
2292,479,558,134,37,0.006568627,364179,0.41075908
1482,219,380,134,37,0.006568627,364313,0.410910219
1478,33,302,134,37,0.006568627,364447,0.411061358
1625,596,68,133,37,0.006519608,364580,0.411211369
2146,596,398,133,37,0.006519608,364713,0.411361381
1964,230,655,133,37,0.006519608,364846,0.411511392
1105,380,219,132,37,0.006470588,364978,0.411660275
1101,313,393,131,37,0.006421569,365109,0.411808031
1379,48,105,131,37,0.006421569,365240,0.411955786
1516,479,9,131,37,0.006421569,365371,0.412103542
814,77,141,131,37,0.006421569,365502,0.412251297
1287,614,224,131,37,0.006421569,365633,0.412399053
2366,596,243,131,37,0.006421569,365764,0.412546808
1761,588,558,130,37,0.006372549,365894,0.412693436
1880,379,367,130,37,0.006372549,366024,0.412840063
1557,380,471,130,37,0.006372549,366154,0.412986691
2480,130,204,130,37,0.006372549,366284,0.413133318
2193,347,27,130,37,0.006372549,366414,0.413279946
969,514,27,130,37,0.006372549,366544,0.413426573
2132,219,353,130,37,0.006372549,366674,0.413573201
1776,84,250,129,37,0.006323529,366803,0.413718701
1256,532,224,129,37,0.006323529,366932,0.4138642
1963,34,224,129,37,0.006323529,367061,0.4140097
1789,68,471,129,37,0.006323529,367190,0.4141552
1901,68,522,129,37,0.006323529,367319,0.414300699
2120,27,126,129,37,0.006323529,367448,0.414446199
1295,77,463,128,37,0.00627451,367576,0.414590571
1768,473,204,128,37,0.00627451,367704,0.414734942
1081,10,353,128,37,0.00627451,367832,0.414879314
2266,328,397,127,37,0.00622549,367959,0.415022558
2016,80,586,127,37,0.00622549,368086,0.415165802
1212,77,535,127,37,0.00622549,368213,0.415309046
825,353,314,127,37,0.00622549,368340,0.41545229
474,532,80,126,37,0.006176471,368466,0.415594406
1463,532,219,126,37,0.006176471,368592,0.415736522
1617,588,663,126,37,0.006176471,368718,0.415878637
1230,32,31,125,37,0.006127451,368843,0.416019626
1941,313,558,125,37,0.006127451,368968,0.416160614
2420,27,1,125,37,0.006127451,369093,0.416301602
1014,20,14,125,37,0.006127451,369218,0.41644259
1714,335,475,125,37,0.006127451,369343,0.416583578
1203,331,32,125,37,0.006127451,369468,0.416724566
2201,479,522,124,37,0.006078431,369592,0.416864426
1326,77,295,124,37,0.006078431,369716,0.417004286
1151,26,224,123,37,0.006029412,369839,0.417143018
1595,107,230,123,37,0.006029412,369962,0.417281751
1854,224,11,123,37,0.006029412,370085,0.417420483
1809,335,97,123,37,0.006029412,370208,0.417559215
1908,674,224,123,37,0.006029412,370331,0.417697947
2318,314,404,123,37,0.006029412,370454,0.417836679
1635,105,439,122,37,0.005980392,370576,0.417974284
1447,314,64,122,37,0.005980392,370698,0.418111888
2356,68,596,122,37,0.005980392,370820,0.418249492
1797,77,347,122,37,0.005980392,370942,0.418387097
1877,397,250,121,37,0.005931373,371063,0.418523573
1096,532,280,121,37,0.005931373,371184,0.41866005
1550,77,50,121,37,0.005931373,371305,0.418796526
1243,105,535,121,37,0.005931373,371426,0.418933002
2018,655,16,121,37,0.005931373,371547,0.419069479
2053,479,48,121,37,0.005931373,371668,0.419205955
1283,95,582,121,37,0.005931373,371789,0.419342432
1577,335,497,120,37,0.005882353,371909,0.41947778
2204,80,48,120,37,0.005882353,372029,0.419613129
2663,348,219,120,37,0.005882353,372149,0.419748477
1889,582,30,120,37,0.005882353,372269,0.419883826
1173,236,77,119,37,0.005833333,372388,0.420018046
2213,224,367,119,37,0.005833333,372507,0.420152267
835,582,31,119,37,0.005833333,372626,0.420286488
1665,107,280,119,37,0.005833333,372745,0.420420708
1277,9,131,118,37,0.005784314,372863,0.420553801
1947,473,97,118,37,0.005784314,372981,0.420686894
1528,48,224,118,37,0.005784314,373099,0.420819986
1430,310,397,118,37,0.005784314,373217,0.420953079
1216,32,33,118,37,0.005784314,373335,0.421086172
1400,311,471,118,37,0.005784314,373453,0.421219265
1934,335,614,117,37,0.005735294,373570,0.421351229
1370,596,394,117,37,0.005735294,373687,0.421483194
1414,331,313,117,37,0.005735294,373804,0.421615159
2380,558,33,117,37,0.005735294,373921,0.421747124
1749,16,68,117,37,0.005735294,374038,0.421879089
2074,394,367,117,37,0.005735294,374155,0.422011053
2905,348,302,117,37,0.005735294,374272,0.422143018
1731,314,708,117,37,0.005735294,374389,0.422274983
2124,335,141,117,37,0.005735294,374506,0.422406948
1511,596,16,116,37,0.005686275,374622,0.422537785
2439,236,586,116,37,0.005686275,374738,0.422668622
1900,302,522,116,37,0.005686275,374854,0.422799459
1757,367,16,116,37,0.005686275,374970,0.422930296
1668,443,224,116,37,0.005686275,375086,0.423061132
2092,596,655,116,37,0.005686275,375202,0.423191969
1984,393,397,116,37,0.005686275,375318,0.423322806
1487,353,394,116,37,0.005686275,375434,0.423453643
1883,6,33,116,37,0.005686275,375550,0.42358448
2015,34,473,116,37,0.005686275,375666,0.423715317
2482,80,404,115,37,0.005637255,375781,0.423845026
1957,16,131,115,37,0.005637255,375896,0.423974735
635,310,80,115,37,0.005637255,376011,0.424104444
2982,348,353,115,37,0.005637255,376126,0.424234153
1486,367,310,115,37,0.005637255,376241,0.424363862
1331,397,394,115,37,0.005637255,376356,0.424493571
1442,105,475,115,37,0.005637255,376471,0.42462328
3265,348,640,115,37,0.005637255,376586,0.424752989
1419,9,310,115,37,0.005637255,376701,0.424882698
949,313,353,115,37,0.005637255,376816,0.425012407
881,32,230,115,37,0.005637255,376931,0.425142116
1960,27,714,114,37,0.005588235,377045,0.425270697
2202,3,95,114,37,0.005588235,377159,0.425399278
2385,535,522,114,37,0.005588235,377273,0.425527859
2957,224,347,114,37,0.005588235,377387,0.42565644
1656,230,31,114,37,0.005588235,377501,0.425785021
2087,80,596,113,37,0.005539216,377614,0.425912475
951,393,27,113,37,0.005539216,377727,0.426039928
1846,10,397,113,37,0.005539216,377840,0.426167381
1481,331,48,112,37,0.005490196,377952,0.426293706
1816,596,11,112,37,0.005490196,378064,0.426420032
1572,32,663,112,37,0.005490196,378176,0.426546357
2024,27,517,112,37,0.005490196,378288,0.426672682
2993,348,10,112,37,0.005490196,378400,0.426799007
2142,15,473,112,37,0.005490196,378512,0.426925333
1650,380,529,112,37,0.005490196,378624,0.427051658
2346,224,15,112,37,0.005490196,378736,0.427177983
936,9,379,112,37,0.005490196,378848,0.427304309
1069,30,27,112,37,0.005490196,378960,0.427430634
2121,331,307,111,37,0.005441176,379071,0.427555831
1962,10,313,111,37,0.005441176,379182,0.427681029
2687,10,97,111,37,0.005441176,379293,0.427806226
2874,535,11,111,37,0.005441176,379404,0.427931423
1428,310,335,111,37,0.005441176,379515,0.428056621
1534,311,663,110,37,0.005392157,379625,0.42818069
1609,26,529,110,37,0.005392157,379735,0.42830476
1792,10,443,110,37,0.005392157,379845,0.428428829
1512,123,354,110,37,0.005392157,379955,0.428552899
2117,33,522,110,37,0.005392157,380065,0.428676968
2157,105,514,110,37,0.005392157,380175,0.428801038
3886,348,367,110,37,0.005392157,380285,0.428925107
2096,10,471,110,37,0.005392157,380395,0.429049177
1839,10,588,110,37,0.005392157,380505,0.429173246
1571,105,614,110,37,0.005392157,380615,0.429297316
1543,367,397,110,37,0.005392157,380725,0.429421385
1037,250,80,110,37,0.005392157,380835,0.429545455
3244,348,97,110,37,0.005392157,380945,0.429669524
2885,68,443,109,37,0.005343137,381054,0.429792466
1168,9,219,109,37,0.005343137,381163,0.429915407
1468,397,335,108,37,0.005294118,381271,0.430037221
2034,193,708,108,37,0.005294118,381379,0.430159035
625,32,9,108,37,0.005294118,381487,0.430280848
438,9,353,108,37,0.005294118,381595,0.430402662
2495,56,310,108,37,0.005294118,381703,0.430524476
3121,10,130,108,37,0.005294118,381811,0.430646289
2235,614,582,108,37,0.005294118,381919,0.430768103
1548,673,314,107,37,0.005245098,382026,0.430888789
2929,68,535,107,37,0.005245098,382133,0.431009474
1779,393,367,106,37,0.005196078,382239,0.431129032
2126,48,302,106,37,0.005196078,382345,0.43124859
2464,522,95,106,37,0.005196078,382451,0.431368148
3068,354,6,105,37,0.005147059,382556,0.431486578
2205,105,54,105,37,0.005147059,382661,0.431605008
1039,353,84,105,37,0.005147059,382766,0.431723438
3104,68,348,105,37,0.005147059,382871,0.431841868
799,582,443,105,37,0.005147059,382976,0.431960298
1520,379,397,105,37,0.005147059,383081,0.432078728
2086,544,224,105,37,0.005147059,383186,0.432197158
1575,311,50,105,37,0.005147059,383291,0.432315588
1897,479,95,104,37,0.005098039,383395,0.43243289
2116,16,280,104,37,0.005098039,383499,0.432550192
2113,354,123,104,37,0.005098039,383603,0.432667494
2071,84,10,104,37,0.005098039,383707,0.432784796
1922,582,250,104,37,0.005098039,383811,0.432902098
2520,582,121,104,37,0.005098039,383915,0.4330194
1413,97,314,104,37,0.005098039,384019,0.433136702
1966,331,558,104,37,0.005098039,384123,0.433254004
3005,230,586,103,37,0.00504902,384226,0.433370178
1466,302,335,103,37,0.00504902,384329,0.433486352
2183,479,6,103,37,0.00504902,384432,0.433602527
1446,331,588,103,37,0.00504902,384535,0.433718701
2008,80,498,102,37,0.005,384637,0.433833747
4288,517,311,102,37,0.005,384739,0.433948793
1503,311,443,102,37,0.005,384841,0.434063839
1621,473,77,102,37,0.005,384943,0.434178886
2058,84,404,102,37,0.005,385045,0.434293932
1711,20,27,101,37,0.00495098,385146,0.43440785
2935,353,243,101,37,0.00495098,385247,0.434521769
3685,348,532,101,37,0.00495098,385348,0.434635687
2030,313,131,101,37,0.00495098,385449,0.434749605
3259,131,522,101,37,0.00495098,385550,0.434863524
2511,27,171,101,37,0.00495098,385651,0.434977442
2530,27,507,101,37,0.00495098,385752,0.43509136
3463,265,280,101,37,0.00495098,385853,0.435205279
1412,32,14,100,37,0.004901961,385953,0.435318069
2309,663,354,99,37,0.004852941,386052,0.435429732
1477,9,3,99,37,0.004852941,386151,0.435541394
2001,236,123,99,37,0.004852941,386250,0.435653057
2917,130,655,99,37,0.004852941,386349,0.435764719
2545,9,347,98,37,0.004803922,386447,0.435875254
1307,10,354,98,37,0.004803922,386545,0.435985788
3080,130,15,98,37,0.004803922,386643,0.436096323
2206,354,230,98,37,0.004803922,386741,0.436206858
3337,663,522,98,37,0.004803922,386839,0.436317392
3231,105,661,98,37,0.004803922,386937,0.436427927
2211,311,427,98,37,0.004803922,387035,0.436538462
2942,311,439,98,37,0.004803922,387133,0.436648996
2411,84,596,98,37,0.004803922,387231,0.436759531
2391,558,310,98,37,0.004803922,387329,0.436870065
2986,314,587,97,37,0.004754902,387426,0.436979472
3076,314,364,97,37,0.004754902,387523,0.437088879
2171,230,77,97,37,0.004754902,387620,0.437198286
1381,107,123,97,37,0.004754902,387717,0.437307692
1329,558,105,97,37,0.004754902,387814,0.437417099
2066,335,723,97,37,0.004754902,387911,0.437526506
2297,6,131,97,37,0.004754902,388008,0.437635912
2684,131,473,96,37,0.004705882,388104,0.437744191
1629,280,532,96,37,0.004705882,388200,0.43785247
1866,6,230,96,37,0.004705882,388296,0.437960749
2404,335,121,95,37,0.004656863,388391,0.4380679
2973,353,522,95,37,0.004656863,388486,0.438175051
4432,471,68,94,37,0.004607843,388580,0.438281074
2219,77,117,94,37,0.004607843,388674,0.438387097
2485,11,331,94,37,0.004607843,388768,0.43849312
2638,6,367,94,37,0.004607843,388862,0.438599143
1818,379,105,93,37,0.004558824,388955,0.438704038
1499,11,105,93,37,0.004558824,389048,0.438808933
2337,302,558,92,37,0.004509804,389140,0.4389127
3206,105,714,92,37,0.004509804,389232,0.439016467
1828,443,331,92,37,0.004509804,389324,0.439120235
2475,243,380,91,37,0.004460784,389415,0.439222874
1601,582,638,91,37,0.004460784,389506,0.439325513
2740,10,31,90,37,0.004411765,389596,0.439427025
2834,27,587,90,37,0.004411765,389686,0.439528536
2061,394,331,90,37,0.004411765,389776,0.439630047
1689,673,582,90,37,0.004411765,389866,0.439731559
3344,348,123,89,37,0.004362745,389955,0.439831942
2928,535,302,88,37,0.004313725,390043,0.439931198
2855,443,131,88,37,0.004313725,390131,0.440030453
2359,314,56,88,37,0.004313725,390219,0.440129709
2011,498,380,87,37,0.004264706,390306,0.440227837
2324,674,131,87,37,0.004264706,390393,0.440325964
3599,68,674,87,37,0.004264706,390480,0.440424092
3917,348,397,86,37,0.004215686,390566,0.440521092
2717,224,145,86,37,0.004215686,390652,0.440618092
4725,328,107,86,37,0.004215686,390738,0.440715091
2642,26,310,86,37,0.004215686,390824,0.440812091
2170,219,582,85,37,0.004166667,390909,0.440907963
4168,230,614,85,37,0.004166667,390994,0.441003835
3247,535,353,84,37,0.004117647,391078,0.441098579
4320,314,618,84,37,0.004117647,391162,0.441193323
2491,522,463,84,37,0.004117647,391246,0.441288067
3612,130,498,83,37,0.004068627,391329,0.441381683
2757,558,15,83,37,0.004068627,391412,0.441475299
2257,77,689,82,37,0.004019608,391494,0.441567787
1686,9,497,81,37,0.003970588,391575,0.441659147
2827,230,84,81,37,0.003970588,391656,0.441750508
2343,335,130,81,37,0.003970588,391737,0.441841868
3347,354,522,80,37,0.003921569,391817,0.4419321
3567,367,385,80,37,0.003921569,391897,0.442022333
3707,219,311,79,37,0.003872549,391976,0.442111437
3042,26,131,78,37,0.003823529,392054,0.442199413
1626,674,582,77,37,0.00377451,392131,0.442286262
5403,543,307,77,37,0.00377451,392208,0.442373111
4406,385,609,77,37,0.00377451,392285,0.442459959
3828,6,663,73,37,0.003578431,392358,0.442542296
4404,632,295,72,37,0.003529412,392430,0.442623506
1465,640,314,71,37,0.003480392,392501,0.442703587
2720,50,314,70,37,0.003431373,392571,0.44278254
2125,4,335,69,37,0.003382353,392640,0.442860365
2816,114,314,68,37,0.003333333,392708,0.442937063
3807,26,609,67,37,0.003284314,392775,0.443012633
5415,663,30,60,37,0.002941176,392835,0.443080307
926,224,353,179,36,0.00877451,393014,0.443282202
670,6,32,175,36,0.008578431,393189,0.443479585
1619,335,463,165,36,0.008088235,393354,0.443665689
630,331,9,163,36,0.007990196,393517,0.443849538
1248,105,97,162,36,0.007941176,393679,0.444032258
866,77,614,161,36,0.007892157,393840,0.444213851
1097,11,27,157,36,0.007696078,393997,0.444390932
1547,33,347,154,36,0.00754902,394151,0.444564629
894,311,353,154,36,0.00754902,394305,0.444738326
1408,16,558,152,36,0.00745098,394457,0.444909768
1132,6,310,150,36,0.007352941,394607,0.445078953
1732,348,582,150,36,0.007352941,394757,0.445248139
1895,80,250,150,36,0.007352941,394907,0.445417325
1089,105,145,148,36,0.007254902,395055,0.445584254
1385,3,311,147,36,0.007205882,395202,0.445750056
744,16,582,146,36,0.007156863,395348,0.44591473
2290,663,313,145,36,0.007107843,395493,0.446078277
2255,535,9,143,36,0.007009804,395636,0.446239567
865,32,348,142,36,0.006960784,395778,0.446399729
1179,105,15,142,36,0.006960784,395920,0.446559892
686,640,27,142,36,0.006960784,396062,0.446720054
1859,243,655,140,36,0.006862745,396202,0.446877961
1673,10,367,140,36,0.006862745,396342,0.447035867
1356,522,302,139,36,0.006813725,396481,0.447192646
1762,77,414,139,36,0.006813725,396620,0.447349425
1450,588,295,139,36,0.006813725,396759,0.447506203
1317,77,31,137,36,0.006715686,396896,0.447660726
1729,353,310,137,36,0.006715686,397033,0.447815249
741,331,77,137,36,0.006715686,397170,0.447969772
1758,68,313,136,36,0.006666667,397306,0.448123167
1786,314,328,135,36,0.006617647,397441,0.448275434
1672,80,335,135,36,0.006617647,397576,0.448427701
1309,582,295,135,36,0.006617647,397711,0.448579968
1569,331,596,133,36,0.006519608,397844,0.44872998
1352,380,588,133,36,0.006519608,397977,0.448879991
1275,473,131,132,36,0.006470588,398109,0.449028874
1679,131,32,131,36,0.006421569,398240,0.44917663
1306,558,16,131,36,0.006421569,398371,0.449324385
1602,10,131,130,36,0.006372549,398501,0.449471013
2244,328,393,130,36,0.006372549,398631,0.44961764
1050,33,230,130,36,0.006372549,398761,0.449764268
1322,236,334,129,36,0.006323529,398890,0.449909768
1864,663,68,129,36,0.006323529,399019,0.450055267
1970,354,224,128,36,0.00627451,399147,0.450199639
1958,473,427,127,36,0.00622549,399274,0.450342883
1755,158,219,127,36,0.00622549,399401,0.450486127
297,16,80,127,36,0.00622549,399528,0.450629371
1391,313,295,127,36,0.00622549,399655,0.450772614
2178,236,398,126,36,0.006176471,399781,0.45091473
826,105,158,126,36,0.006176471,399907,0.451056846
1845,27,528,125,36,0.006127451,400032,0.451197834
1162,32,145,125,36,0.006127451,400157,0.451338822
1994,535,473,124,36,0.006078431,400281,0.451478683
2109,107,243,123,36,0.006029412,400404,0.451617415
1715,380,33,122,36,0.005980392,400526,0.451755019
1472,335,158,121,36,0.005931373,400647,0.451891496
2850,348,638,121,36,0.005931373,400768,0.452027972
1562,274,353,120,36,0.005882353,400888,0.452163321
3055,348,663,120,36,0.005882353,401008,0.452298669
1365,331,131,120,36,0.005882353,401128,0.452434018
1505,105,414,120,36,0.005882353,401248,0.452569366
1519,582,50,120,36,0.005882353,401368,0.452704715
934,394,380,120,36,0.005882353,401488,0.452840063
1798,145,32,120,36,0.005882353,401608,0.452975412
1416,105,196,119,36,0.005833333,401727,0.453109632
2543,130,367,119,36,0.005833333,401846,0.453243853
1241,107,84,119,36,0.005833333,401965,0.453378074
2551,663,33,118,36,0.005784314,402083,0.453511166
1234,314,158,118,36,0.005784314,402201,0.453644259
1372,6,14,118,36,0.005784314,402319,0.453777352
680,609,80,118,36,0.005784314,402437,0.453910444
1706,473,50,118,36,0.005784314,402555,0.454043537
1739,313,307,118,36,0.005784314,402673,0.45417663
1628,498,655,118,36,0.005784314,402791,0.454309723
610,32,123,117,36,0.005735294,402908,0.454441687
1605,105,4,117,36,0.005735294,403025,0.454573652
1735,16,32,116,36,0.005686275,403141,0.454704489
2339,1,27,116,36,0.005686275,403257,0.454835326
1783,380,313,115,36,0.005637255,403372,0.454965035
1815,105,14,115,36,0.005637255,403487,0.455094744
1876,131,380,115,36,0.005637255,403602,0.455224453
2129,479,97,115,36,0.005637255,403717,0.455354162
2072,558,131,115,36,0.005637255,403832,0.455483871
2085,230,562,114,36,0.005588235,403946,0.455612452
1888,479,123,114,36,0.005588235,404060,0.455741033
2372,224,471,114,36,0.005588235,404174,0.455869614
2135,380,532,114,36,0.005588235,404288,0.455998195
1182,107,353,114,36,0.005588235,404402,0.456126776
2110,354,473,113,36,0.005539216,404515,0.45625423
2281,230,236,113,36,0.005539216,404628,0.456381683
2274,130,302,113,36,0.005539216,404741,0.456509136
1273,655,353,113,36,0.005539216,404854,0.456636589
2496,130,443,113,36,0.005539216,404967,0.456764042
2540,328,331,112,36,0.005490196,405079,0.456890368
1909,12,380,112,36,0.005490196,405191,0.457016693
1507,522,10,112,36,0.005490196,405303,0.457143018
2924,131,10,112,36,0.005490196,405415,0.457269344
2336,543,224,112,36,0.005490196,405527,0.457395669
2994,230,663,111,36,0.005441176,405638,0.457520866
2077,596,443,111,36,0.005441176,405749,0.457646064
1890,328,582,111,36,0.005441176,405860,0.457771261
1232,33,9,111,36,0.005441176,405971,0.457896458
2200,328,335,111,36,0.005441176,406082,0.458021656
1951,84,398,111,36,0.005441176,406193,0.458146853
1916,107,10,111,36,0.005441176,406304,0.458272051
2139,588,393,111,36,0.005441176,406415,0.458397248
1531,77,242,110,36,0.005392157,406525,0.458521317
2890,131,230,110,36,0.005392157,406635,0.458645387
2083,475,473,110,36,0.005392157,406745,0.458769456
1545,379,331,110,36,0.005392157,406855,0.458893526
1261,307,27,109,36,0.005343137,406964,0.459016467
2156,588,347,109,36,0.005343137,407073,0.459139409
1354,674,219,109,36,0.005343137,407182,0.459262351
2081,105,682,108,36,0.005294118,407290,0.459384164
1544,582,236,108,36,0.005294118,407398,0.459505978
1460,33,32,108,36,0.005294118,407506,0.459627792
1778,353,230,108,36,0.005294118,407614,0.459749605
2091,314,54,107,36,0.005245098,407721,0.459870291
2516,84,473,107,36,0.005245098,407828,0.459990977
1683,331,498,107,36,0.005245098,407935,0.460111663
1954,311,307,106,36,0.005196078,408041,0.46023122
2453,130,473,106,36,0.005196078,408147,0.460350778
2804,558,230,106,36,0.005196078,408253,0.460470336
2891,68,196,106,36,0.005196078,408359,0.460589894
1719,588,50,106,36,0.005196078,408465,0.460709452
2748,588,463,106,36,0.005196078,408571,0.46082901
1703,311,250,106,36,0.005196078,408677,0.460948568
1373,367,379,106,36,0.005196078,408783,0.461068125
2825,48,6,105,36,0.005147059,408888,0.461186555
2467,473,236,105,36,0.005147059,408993,0.461304985
2094,674,16,105,36,0.005147059,409098,0.461423415
1694,56,314,105,36,0.005147059,409203,0.461541845
2130,33,131,104,36,0.005098039,409307,0.461659147
1997,84,11,104,36,0.005098039,409411,0.461776449
1244,196,27,104,36,0.005098039,409515,0.461893751
2591,77,528,104,36,0.005098039,409619,0.462011053
1653,398,380,104,36,0.005098039,409723,0.462128356
2151,224,26,103,36,0.00504902,409826,0.46224453
1316,307,314,103,36,0.00504902,409929,0.462360704
2939,224,295,103,36,0.00504902,410032,0.462476878
2037,473,14,103,36,0.00504902,410135,0.462593052
1807,380,32,103,36,0.00504902,410238,0.462709226
3054,68,640,103,36,0.00504902,410341,0.4628254
1700,331,219,102,36,0.005,410443,0.462940447
1793,33,6,102,36,0.005,410545,0.463055493
3371,131,68,102,36,0.005,410647,0.463170539
1925,532,397,102,36,0.005,410749,0.463285585
2526,354,353,102,36,0.005,410851,0.463400632
1599,674,310,102,36,0.005,410953,0.463515678
2436,353,242,102,36,0.005,411055,0.463630724
1393,32,311,102,36,0.005,411157,0.46374577
2209,107,302,102,36,0.005,411259,0.463860817
1722,313,77,102,36,0.005,411361,0.463975863
1128,280,380,101,36,0.00495098,411462,0.464089781
2175,353,497,101,36,0.00495098,411563,0.4642037
2301,33,48,101,36,0.00495098,411664,0.464317618
2258,123,50,101,36,0.00495098,411765,0.464431536
1667,26,219,101,36,0.00495098,411866,0.464545455
1926,250,331,100,36,0.004901961,411966,0.464658245
1386,582,334,100,36,0.004901961,412066,0.464771035
2479,56,397,100,36,0.004901961,412166,0.464883826
2981,331,347,100,36,0.004901961,412266,0.464996616
2560,379,219,100,36,0.004901961,412366,0.465109407
1737,105,501,100,36,0.004901961,412466,0.465222197
2737,588,394,99,36,0.004852941,412565,0.46533386
1910,77,307,99,36,0.004852941,412664,0.465445522
1699,311,236,99,36,0.004852941,412763,0.465557185
2637,230,11,99,36,0.004852941,412862,0.465668847
1730,224,48,99,36,0.004852941,412961,0.46578051
2765,224,586,98,36,0.004803922,413059,0.465891044
2269,107,131,98,36,0.004803922,413157,0.466001579
2851,354,379,98,36,0.004803922,413255,0.466112114
2771,131,353,98,36,0.004803922,413353,0.466222648
2198,335,170,98,36,0.004803922,413451,0.466333183
2437,224,6,98,36,0.004803922,413549,0.466443718
3455,33,517,98,36,0.004803922,413647,0.466554252
2224,3,33,98,36,0.004803922,413745,0.466664787
2166,280,514,98,36,0.004803922,413843,0.466775321
2412,84,230,98,36,0.004803922,413941,0.466885856
2940,130,95,97,36,0.004754902,414038,0.466995263
2363,596,236,97,36,0.004754902,414135,0.46710467
1395,310,32,97,36,0.004754902,414232,0.467214076
3272,33,34,97,36,0.004754902,414329,0.467323483
3030,588,640,97,36,0.004754902,414426,0.46743289
2302,224,397,96,36,0.004705882,414522,0.467541169
2028,379,335,96,36,0.004705882,414618,0.467649447
1709,77,479,96,36,0.004705882,414714,0.467757726
2579,130,558,96,36,0.004705882,414810,0.467866005
2259,25,655,96,36,0.004705882,414906,0.467974284
2261,473,30,96,36,0.004705882,415002,0.468082563
2051,393,9,96,36,0.004705882,415098,0.468190841
2773,1,31,96,36,0.004705882,415194,0.46829912
2354,107,529,95,36,0.004656863,415289,0.468406271
2554,105,170,94,36,0.004607843,415383,0.468512294
2423,68,6,94,36,0.004607843,415477,0.468618317
2565,95,310,94,36,0.004607843,415571,0.46872434
1946,84,236,94,36,0.004607843,415665,0.468830363
1812,311,532,94,36,0.004607843,415759,0.468936386
1765,224,588,94,36,0.004607843,415853,0.469042409
2500,310,471,93,36,0.004558824,415946,0.469147304
1912,6,29,93,36,0.004558824,416039,0.469252199
2368,397,11,93,36,0.004558824,416132,0.469357095
2633,243,224,93,36,0.004558824,416225,0.46946199
1915,77,15,92,36,0.004509804,416317,0.469565757
3737,552,16,92,36,0.004509804,416409,0.469669524
1991,674,379,92,36,0.004509804,416501,0.469773291
2027,31,473,92,36,0.004509804,416593,0.469877058
3440,107,250,92,36,0.004509804,416685,0.469980826
2803,535,123,92,36,0.004509804,416777,0.470084593
3792,130,347,92,36,0.004509804,416869,0.47018836
2122,501,16,92,36,0.004509804,416961,0.470292127
2894,130,522,92,36,0.004509804,417053,0.470395894
2172,11,224,92,36,0.004509804,417145,0.470499662
1398,32,95,91,36,0.004460784,417236,0.470602301
1494,640,68,91,36,0.004460784,417327,0.47070494
1201,443,84,91,36,0.004460784,417418,0.47080758
2492,313,11,91,36,0.004460784,417509,0.470910219
2400,522,638,91,36,0.004460784,417600,0.471012858
1568,77,158,91,36,0.004460784,417691,0.471115497
2063,558,582,91,36,0.004460784,417782,0.471218137
3474,307,558,91,36,0.004460784,417873,0.471320776
2141,311,479,90,36,0.004411765,417963,0.471422287
3640,224,640,90,36,0.004411765,418053,0.471523799
3361,68,30,90,36,0.004411765,418143,0.47162531
2546,535,335,90,36,0.004411765,418233,0.471726822
2743,84,498,90,36,0.004411765,418323,0.471828333
3018,471,380,90,36,0.004411765,418413,0.471929844
2005,311,586,90,36,0.004411765,418503,0.472031356
1180,367,9,90,36,0.004411765,418593,0.472132867
2112,33,348,90,36,0.004411765,418683,0.472234379
1939,532,265,90,36,0.004411765,418773,0.47233589
3496,27,503,89,36,0.004362745,418862,0.472436273
2753,588,196,89,36,0.004362745,418951,0.472536657
3276,130,236,89,36,0.004362745,419040,0.47263704
2287,10,243,89,36,0.004362745,419129,0.472737424
1546,529,26,89,36,0.004362745,419218,0.472837807
1262,674,314,89,36,0.004362745,419307,0.472938191
4083,348,196,89,36,0.004362745,419396,0.473038574
1280,302,331,89,36,0.004362745,419485,0.473138958
2386,26,236,89,36,0.004362745,419574,0.473239341
2440,367,302,88,36,0.004313725,419662,0.473338597
2694,236,532,88,36,0.004313725,419750,0.473437852
702,302,80,88,36,0.004313725,419838,0.473537108
2578,367,107,88,36,0.004313725,419926,0.473636364
2800,114,380,88,36,0.004313725,420014,0.473735619
3132,479,348,88,36,0.004313725,420102,0.473834875
2812,558,522,87,36,0.004264706,420189,0.473933002
2300,588,334,87,36,0.004264706,420276,0.47403113
4053,130,689,87,36,0.004264706,420363,0.474129258
2025,95,105,86,36,0.004215686,420449,0.474226258
4074,80,463,86,36,0.004215686,420535,0.474323257
1338,313,397,86,36,0.004215686,420621,0.474420257
1431,532,314,85,36,0.004166667,420706,0.474516129
3990,204,708,85,36,0.004166667,420791,0.474612001
2558,27,683,85,36,0.004166667,420876,0.474707873
2566,10,280,85,36,0.004166667,420961,0.474803745
2111,353,586,85,36,0.004166667,421046,0.474899617
3700,130,6,85,36,0.004166667,421131,0.474995488
2208,544,27,84,36,0.004117647,421215,0.475090232
2592,10,393,84,36,0.004117647,421299,0.475184976
3482,130,708,84,36,0.004117647,421383,0.47527972
2735,123,31,84,36,0.004117647,421467,0.475374464
1539,26,84,83,36,0.004068627,421550,0.47546808
3626,354,107,83,36,0.004068627,421633,0.475561696
4801,479,5,83,36,0.004068627,421716,0.475655312
2508,331,26,82,36,0.004019608,421798,0.475747801
2055,414,27,82,36,0.004019608,421880,0.475840289
3445,479,347,82,36,0.004019608,421962,0.475932777
2837,522,479,82,36,0.004019608,422044,0.476025265
3099,236,164,82,36,0.004019608,422126,0.476117753
2863,331,348,81,36,0.003970588,422207,0.476209113
3755,13,27,81,36,0.003970588,422288,0.476300474
2238,443,379,81,36,0.003970588,422369,0.476391834
1754,302,9,80,36,0.003921569,422449,0.476482066
1610,596,335,80,36,0.003921569,422529,0.476572299
2912,16,31,80,36,0.003921569,422609,0.476662531
1959,9,50,80,36,0.003921569,422689,0.476752763
2882,95,380,79,36,0.003872549,422768,0.476841868
3545,543,32,79,36,0.003872549,422847,0.476930972
2826,3,32,79,36,0.003872549,422926,0.477020077
2654,311,15,78,36,0.003823529,423004,0.477108053
3387,596,498,78,36,0.003823529,423082,0.47719603
3286,313,121,78,36,0.003823529,423160,0.477284006
2473,353,354,78,36,0.003823529,423238,0.477371983
3498,123,479,77,36,0.00377451,423315,0.477458831
3297,105,560,76,36,0.00372549,423391,0.477544552
2515,274,16,76,36,0.00372549,423467,0.477630273
2518,498,443,75,36,0.003676471,423542,0.477714866
1691,498,314,75,36,0.003676471,423617,0.477799459
1987,295,68,74,36,0.003627451,423691,0.477882924
1704,31,314,74,36,0.003627451,423765,0.477966388
2534,32,708,74,36,0.003627451,423839,0.478049853
3124,674,522,73,36,0.003578431,423912,0.47813219
4427,380,605,73,36,0.003578431,423985,0.478214527
3714,80,514,72,36,0.003529412,424057,0.478295737
5972,328,528,71,36,0.003480392,424128,0.478375818
2321,9,141,71,36,0.003480392,424199,0.478455899
4796,558,632,70,36,0.003431373,424269,0.478534852
5135,131,295,70,36,0.003431373,424339,0.478613806
3006,230,479,70,36,0.003431373,424409,0.478692759
3884,367,609,70,36,0.003431373,424479,0.478771712
3701,313,640,69,36,0.003382353,424548,0.478849538
3526,107,31,69,36,0.003382353,424617,0.478927363
2679,380,50,68,36,0.003333333,424685,0.47900406
4445,80,295,68,36,0.003333333,424753,0.479080758
4576,479,397,68,36,0.003333333,424821,0.479157455
830,443,80,67,36,0.003284314,424888,0.479233025
4085,354,596,67,36,0.003284314,424955,0.479308595
2387,311,609,67,36,0.003284314,425022,0.479384164
4072,353,250,67,36,0.003284314,425089,0.479459734
7034,471,97,66,36,0.003235294,425155,0.479534176
4150,224,274,64,36,0.003137255,425219,0.479606361
1971,397,582,63,36,0.003088235,425282,0.479677419
4195,347,380,63,36,0.003088235,425345,0.479748477
3433,12,331,62,36,0.003039216,425407,0.479818407
4271,380,682,61,36,0.002990196,425468,0.47988721
6157,48,204,60,36,0.002941176,425528,0.479954884
6290,543,313,50,36,0.00245098,425578,0.480011279
1434,443,498,147,35,0.007205882,425725,0.480177081
909,10,335,147,35,0.007205882,425872,0.480342883
1057,311,68,143,35,0.007009804,426015,0.480504173
1333,26,655,142,35,0.006960784,426157,0.480664336
791,393,380,141,35,0.006911765,426298,0.48082337
1136,3,313,137,35,0.006715686,426435,0.480977893
1396,314,614,135,35,0.006617647,426570,0.48113016
2148,193,204,134,35,0.006568627,426704,0.481281299
1215,314,497,133,35,0.006519608,426837,0.481431311
1157,10,379,133,35,0.006519608,426970,0.481581322
781,32,335,133,35,0.006519608,427103,0.481731333
641,25,353,132,35,0.006470588,427235,0.481880217
1265,522,588,132,35,0.006470588,427367,0.4820291
2180,471,27,132,35,0.006470588,427499,0.482177983
1360,84,582,132,35,0.006470588,427631,0.482326867
1607,10,219,130,35,0.006372549,427761,0.482473494
289,596,80,130,35,0.006372549,427891,0.482620122
884,20,6,127,35,0.00622549,428018,0.482763366
1911,204,68,127,35,0.00622549,428145,0.48290661
1199,77,264,127,35,0.00622549,428272,0.483049853
1662,479,475,125,35,0.006127451,428397,0.483190841
1967,230,558,125,35,0.006127451,428522,0.483331829
2657,230,15,124,35,0.006078431,428646,0.48347169
1844,473,84,124,35,0.006078431,428770,0.48361155
1084,609,27,123,35,0.006029412,428893,0.483750282
3060,130,348,123,35,0.006029412,429016,0.483889014
1222,265,27,122,35,0.005980392,429138,0.484026619
1811,32,463,122,35,0.005980392,429260,0.484164223
1026,397,331,121,35,0.005931373,429381,0.484300699
871,379,582,121,35,0.005931373,429502,0.484437176
1158,224,158,119,35,0.005833333,429621,0.484571396
2799,443,514,118,35,0.005784314,429739,0.484704489
762,274,158,118,35,0.005784314,429857,0.484837582
2040,3,367,118,35,0.005784314,429975,0.484970674
1239,582,307,118,35,0.005784314,430093,0.485103767
867,26,380,118,35,0.005784314,430211,0.48523686
1561,3,302,117,35,0.005735294,430328,0.485368825
1312,498,353,117,35,0.005735294,430445,0.48550079
1272,582,674,116,35,0.005686275,430561,0.485631626
1918,522,48,115,35,0.005637255,430676,0.485761335
1770,473,196,114,35,0.005588235,430790,0.485889917
344,9,80,114,35,0.005588235,430904,0.486018498
2584,354,16,114,35,0.005588235,431018,0.486147079
1506,443,26,114,35,0.005588235,431132,0.48627566
1873,280,655,114,35,0.005588235,431246,0.486404241
1881,105,56,114,35,0.005588235,431360,0.486532822
398,280,158,114,35,0.005588235,431474,0.486661403
1321,331,586,113,35,0.005539216,431587,0.486788856
1590,123,310,113,35,0.005539216,431700,0.486916309
1325,353,331,112,35,0.005490196,431812,0.487042635
1586,443,532,112,35,0.005490196,431924,0.48716896
965,354,80,111,35,0.005441176,432035,0.487294157
1882,84,9,111,35,0.005441176,432146,0.487419355
1518,522,313,110,35,0.005392157,432256,0.487543424
3571,236,347,110,35,0.005392157,432366,0.487667494
2394,130,311,110,35,0.005392157,432476,0.487791563
1252,16,10,110,35,0.005392157,432586,0.487915633
2242,353,596,110,35,0.005392157,432696,0.488039702
2807,558,31,109,35,0.005343137,432805,0.488162644
1794,335,638,109,35,0.005343137,432914,0.488285585
1955,314,544,109,35,0.005343137,433023,0.488408527
2101,68,64,108,35,0.005294118,433131,0.488530341
1666,335,529,108,35,0.005294118,433239,0.488652154
2031,68,84,108,35,0.005294118,433347,0.488773968
1660,295,16,108,35,0.005294118,433455,0.488895782
2114,6,224,108,35,0.005294118,433563,0.489017595
2184,354,393,107,35,0.005245098,433670,0.489138281
1682,280,26,107,35,0.005245098,433777,0.489258967
2252,33,558,106,35,0.005196078,433883,0.489378525
1367,353,582,106,35,0.005196078,433989,0.489498083
2774,130,26,106,35,0.005196078,434095,0.48961764
1655,311,84,106,35,0.005196078,434201,0.489737198
1943,380,655,105,35,0.005147059,434306,0.489855628
2105,230,394,105,35,0.005147059,434411,0.489974058
1835,313,596,105,35,0.005147059,434516,0.490092488
1632,532,84,105,35,0.005147059,434621,0.490210918
2666,224,348,104,35,0.005098039,434725,0.49032822
1558,393,335,104,35,0.005098039,434829,0.490445522
2181,498,529,104,35,0.005098039,434933,0.490562824
1705,473,219,103,35,0.00504902,435036,0.490678998
3157,68,532,103,35,0.00504902,435139,0.490795173
2277,380,141,103,35,0.00504902,435242,0.490911347
1189,529,243,103,35,0.00504902,435345,0.491027521
1661,33,68,103,35,0.00504902,435448,0.491143695
2452,224,236,103,35,0.00504902,435551,0.491259869
3086,230,497,103,35,0.00504902,435654,0.491376043
1313,16,473,102,35,0.005,435756,0.49149109
1358,16,331,102,35,0.005,435858,0.491606136
947,443,105,102,35,0.005,435960,0.491721182
1834,582,11,102,35,0.005,436062,0.491836228
1533,16,311,102,35,0.005,436164,0.491951275
4008,663,34,102,35,0.005,436266,0.492066321
2707,354,311,101,35,0.00495098,436367,0.492180239
2712,348,9,101,35,0.00495098,436468,0.492294157
3669,27,661,101,35,0.00495098,436569,0.492408076
3249,354,302,101,35,0.00495098,436670,0.492521994
2809,130,532,101,35,0.00495098,436771,0.492635912
1663,302,33,101,35,0.00495098,436872,0.492749831
4125,348,5,101,35,0.00495098,436973,0.492863749
3508,204,347,100,35,0.004901961,437073,0.49297654
1865,380,26,100,35,0.004901961,437173,0.49308933
3158,68,114,100,35,0.004901961,437273,0.49320212
3204,27,155,100,35,0.004901961,437373,0.493314911
3569,663,347,99,35,0.004852941,437472,0.493426573
2161,414,331,99,35,0.004852941,437571,0.493538236
1104,532,105,99,35,0.004852941,437670,0.493649898
1540,250,105,99,35,0.004852941,437769,0.493761561
1802,582,196,99,35,0.004852941,437868,0.493873224
1363,33,313,99,35,0.004852941,437967,0.493984886
1501,562,224,99,35,0.004852941,438066,0.494096549
2604,311,614,99,35,0.004852941,438165,0.494208211
2840,230,596,99,35,0.004852941,438264,0.494319874
2367,230,6,99,35,0.004852941,438363,0.494431536
2517,3,522,99,35,0.004852941,438462,0.494543199
1435,9,307,98,35,0.004803922,438560,0.494653733
885,475,314,98,35,0.004803922,438658,0.494764268
2322,3,68,98,35,0.004803922,438756,0.494874803
3954,348,2,98,35,0.004803922,438854,0.494985337
2474,84,310,98,35,0.004803922,438952,0.495095872
2818,354,588,98,35,0.004803922,439050,0.495206406
2042,335,56,98,35,0.004803922,439148,0.495316941
3598,48,689,98,35,0.004803922,439246,0.495427476
2716,347,473,97,35,0.004754902,439343,0.495536882
2223,77,130,97,35,0.004754902,439440,0.495646289
2866,331,528,97,35,0.004754902,439537,0.495755696
2103,582,427,97,35,0.004754902,439634,0.495865103
2232,77,638,97,35,0.004754902,439731,0.495974509
1870,558,380,97,35,0.004754902,439828,0.496083916
1898,224,313,97,35,0.004754902,439925,0.496193323
1421,302,379,97,35,0.004754902,440022,0.49630273
2164,1,473,97,35,0.004754902,440119,0.496412136
1855,95,473,96,35,0.004705882,440215,0.496520415
1642,582,723,96,35,0.004705882,440311,0.496628694
3202,588,479,96,35,0.004705882,440407,0.496736973
2918,130,11,96,35,0.004705882,440503,0.496845252
2189,353,11,96,35,0.004705882,440599,0.49695353
2521,638,230,96,35,0.004705882,440695,0.497061809
2756,596,473,95,35,0.004656863,440790,0.49716896
1094,663,80,95,35,0.004656863,440885,0.497276111
2537,123,68,95,35,0.004656863,440980,0.497383262
1263,123,353,95,35,0.004656863,441075,0.497490413
3837,224,97,95,35,0.004656863,441170,0.497597564
3960,68,614,95,35,0.004656863,441265,0.497704715
2815,243,529,94,35,0.004607843,441359,0.497810738
3103,48,367,94,35,0.004607843,441453,0.497916761
3221,158,131,94,35,0.004607843,441547,0.498022784
2293,314,385,94,35,0.004607843,441641,0.498128807
1076,32,354,94,35,0.004607843,441735,0.49823483
1933,25,26,93,35,0.004558824,441828,0.498339725
2115,224,354,93,35,0.004558824,441921,0.49844462
1488,16,335,93,35,0.004558824,442014,0.498549515
2512,463,582,93,35,0.004558824,442107,0.49865441
2513,335,117,93,35,0.004558824,442200,0.498759305
1965,498,582,93,35,0.004558824,442293,0.4988642
1833,532,310,93,35,0.004558824,442386,0.498969095
2075,397,393,93,35,0.004558824,442479,0.499073991
2317,380,31,93,35,0.004558824,442572,0.499178886
2781,56,335,93,35,0.004558824,442665,0.499283781
1782,331,532,93,35,0.004558824,442758,0.499388676
2249,558,219,92,35,0.004509804,442850,0.499492443
2489,353,107,92,35,0.004509804,442942,0.49959621
3829,230,50,92,35,0.004509804,443034,0.499699977
2846,34,582,92,35,0.004509804,443126,0.499803745
3521,393,596,92,35,0.004509804,443218,0.499907512
2668,105,164,91,35,0.004460784,443309,0.500010151
3634,347,224,91,35,0.004460784,443400,0.50011279
2664,250,77,91,35,0.004460784,443491,0.50021543
2724,10,11,91,35,0.004460784,443582,0.500318069
1924,532,242,91,35,0.004460784,443673,0.500420708
1733,32,10,91,35,0.004460784,443764,0.500523348
2721,27,618,91,35,0.004460784,443855,0.500625987
3542,250,224,91,35,0.004460784,443946,0.500728626
3163,1,68,90,35,0.004411765,444036,0.500830138
2629,347,314,90,35,0.004411765,444126,0.500931649
2332,331,663,90,35,0.004411765,444216,0.50103316
2628,6,347,90,35,0.004411765,444306,0.501134672
2065,77,97,90,35,0.004411765,444396,0.501236183
1229,95,314,90,35,0.004411765,444486,0.501337695
2022,10,77,90,35,0.004411765,444576,0.501439206
3312,463,302,89,35,0.004362745,444665,0.501539589
1613,443,314,89,35,0.004362745,444754,0.501639973
2357,123,367,89,35,0.004362745,444843,0.501740356
2045,77,475,89,35,0.004362745,444932,0.50184074
1858,77,501,89,35,0.004362745,445021,0.501941123
3075,522,596,89,35,0.004362745,445110,0.502041507
2635,224,307,89,35,0.004362745,445199,0.50214189
3182,348,379,89,35,0.004362745,445288,0.502242274
1799,310,353,88,35,0.004313725,445376,0.502341529
1247,302,32,88,35,0.004313725,445464,0.502440785
1917,310,588,88,35,0.004313725,445552,0.502540041
1129,9,394,88,35,0.004313725,445640,0.502639296
3263,224,723,88,35,0.004313725,445728,0.502738552
4843,663,552,88,35,0.004313725,445816,0.502837807
3495,348,354,88,35,0.004313725,445904,0.502937063
2188,20,347,88,35,0.004313725,445992,0.503036319
4086,663,471,87,35,0.004264706,446079,0.503134446
3299,588,313,87,35,0.004264706,446166,0.503232574
3025,334,27,87,35,0.004264706,446253,0.503330702
2369,311,243,87,35,0.004264706,446340,0.503428829
2710,479,3,87,35,0.004264706,446427,0.503526957
3049,236,609,87,35,0.004264706,446514,0.503625085
1852,379,473,87,35,0.004264706,446601,0.503723212
3532,131,397,87,35,0.004264706,446688,0.50382134
1760,331,471,86,35,0.004215686,446774,0.50391834
2734,10,663,86,35,0.004215686,446860,0.504015339
2814,473,640,86,35,0.004215686,446946,0.504112339
1817,107,334,86,35,0.004215686,447032,0.504209339
2572,105,562,86,35,0.004215686,447118,0.504306339
1759,473,638,86,35,0.004215686,447204,0.504403339
2598,14,27,85,35,0.004166667,447289,0.50449921
2095,219,314,85,35,0.004166667,447374,0.504595082
1669,596,582,85,35,0.004166667,447459,0.504690954
3657,347,313,85,35,0.004166667,447544,0.504786826
1718,9,243,85,35,0.004166667,447629,0.504882698
2472,6,15,85,35,0.004166667,447714,0.50497857
3739,224,427,85,35,0.004166667,447799,0.505074442
2379,398,331,85,35,0.004166667,447884,0.505170314
2329,393,310,84,35,0.004117647,447968,0.505265058
2612,479,367,84,35,0.004117647,448052,0.505359801
3071,230,532,84,35,0.004117647,448136,0.505454545
2476,367,68,84,35,0.004117647,448220,0.505549289
2010,295,224,84,35,0.004117647,448304,0.505644033
2582,280,367,83,35,0.004068627,448387,0.505737649
3444,471,588,83,35,0.004068627,448470,0.505831266
4758,663,708,83,35,0.004068627,448553,0.505924882
1134,196,314,83,35,0.004068627,448636,0.506018498
3605,236,535,82,35,0.004019608,448718,0.506110986
3045,243,394,82,35,0.004019608,448800,0.506203474
3317,145,473,82,35,0.004019608,448882,0.506295962
3596,48,32,82,35,0.004019608,448964,0.50638845
2525,26,586,82,35,0.004019608,449046,0.506480938
2699,107,26,81,35,0.003970588,449127,0.506572299
4041,131,498,81,35,0.003970588,449208,0.506663659
1784,379,230,81,35,0.003970588,449289,0.506755019
1950,586,394,81,35,0.003970588,449370,0.506846379
2043,313,84,81,35,0.003970588,449451,0.50693774
3863,68,393,81,35,0.003970588,449532,0.5070291
2305,331,655,81,35,0.003970588,449613,0.50712046
4010,380,514,80,35,0.003921569,449693,0.507210693
2428,3,334,80,35,0.003921569,449773,0.507300925
2288,314,1,80,35,0.003921569,449853,0.507391157
2747,596,32,79,35,0.003872549,449932,0.507480262
2374,331,50,79,35,0.003872549,450011,0.507569366
2167,310,131,79,35,0.003872549,450090,0.507658471
2160,156,224,79,35,0.003872549,450169,0.507747575
2886,48,33,79,35,0.003872549,450248,0.507836679
2358,68,479,79,35,0.003872549,450327,0.507925784
3134,10,529,79,35,0.003872549,450406,0.508014888
3122,219,310,79,35,0.003872549,450485,0.508103993
2320,196,473,78,35,0.003823529,450563,0.508191969
1620,32,471,78,35,0.003823529,450641,0.508279946
2231,131,158,78,35,0.003823529,450719,0.508367922
1127,582,394,78,35,0.003823529,450797,0.508455899
1064,123,80,78,35,0.003823529,450875,0.508543875
2456,311,347,78,35,0.003823529,450953,0.508631852
3279,588,250,78,35,0.003823529,451031,0.508719829
3335,27,29,78,35,0.003823529,451109,0.508807805
5015,354,328,78,35,0.003823529,451187,0.508895782
2971,307,16,77,35,0.00377451,451264,0.50898263
3000,105,364,77,35,0.00377451,451341,0.509069479
2271,394,353,77,35,0.00377451,451418,0.509156328
3866,479,427,76,35,0.00372549,451494,0.509242048
1584,32,313,76,35,0.00372549,451570,0.509327769
2845,84,311,76,35,0.00372549,451646,0.50941349
2704,353,379,76,35,0.00372549,451722,0.50949921
1938,529,655,76,35,0.00372549,451798,0.509584931
3812,473,609,75,35,0.003676471,451873,0.509669524
3611,331,689,75,35,0.003676471,451948,0.509754117
2989,95,16,75,35,0.003676471,452023,0.50983871
2823,16,397,75,35,0.003676471,452098,0.509923303
3538,354,95,75,35,0.003676471,452173,0.510007895
4366,68,97,75,35,0.003676471,452248,0.510092488
2689,105,274,74,35,0.003627451,452322,0.510175953
1905,638,224,74,35,0.003627451,452396,0.510259418
4584,535,558,74,35,0.003627451,452470,0.510342883
3346,331,463,74,35,0.003627451,452544,0.510426348
1810,582,596,74,35,0.003627451,452618,0.510509813
5064,131,463,73,35,0.003578431,452691,0.51059215
2078,9,97,73,35,0.003578431,452764,0.510674487
2145,314,562,73,35,0.003578431,452837,0.510756824
3826,80,31,73,35,0.003578431,452910,0.510839161
2674,97,27,73,35,0.003578431,452983,0.510921498
3291,68,158,72,35,0.003529412,453055,0.511002707
4901,34,522,72,35,0.003529412,453127,0.511083916
4622,9,528,72,35,0.003529412,453199,0.511165125
1368,398,80,72,35,0.003529412,453271,0.511246334
1893,280,331,72,35,0.003529412,453343,0.511327543
2049,6,379,72,35,0.003529412,453415,0.511408753
6047,348,674,71,35,0.003480392,453486,0.511488834
3333,674,655,71,35,0.003480392,453557,0.511568915
2539,10,48,71,35,0.003480392,453628,0.511648996
1857,6,302,70,35,0.003431373,453698,0.511727949
3001,674,473,70,35,0.003431373,453768,0.511806903
2680,6,30,70,35,0.003431373,453838,0.511885856
3066,443,586,70,35,0.003431373,453908,0.511964809
4310,131,3,70,35,0.003431373,453978,0.512043763
4915,348,313,69,35,0.003382353,454047,0.512121588
2673,295,558,69,35,0.003382353,454116,0.512199413
3331,379,33,69,35,0.003382353,454185,0.512277239
3171,107,48,69,35,0.003382353,454254,0.512355064
4040,328,473,68,35,0.003333333,454322,0.512431762
3502,295,15,68,35,0.003333333,454390,0.512508459
1701,673,473,68,35,0.003333333,454458,0.512585157
2275,1,314,68,35,0.003333333,454526,0.512661854
2795,311,535,68,35,0.003333333,454594,0.512738552
5831,80,439,68,35,0.003333333,454662,0.512815249
2595,16,529,68,35,0.003333333,454730,0.512891947
1843,280,582,67,35,0.003284314,454797,0.512967516
3512,522,535,67,35,0.003284314,454864,0.513043086
2564,25,498,67,35,0.003284314,454931,0.513118656
3443,473,586,67,35,0.003284314,454998,0.513194225
3994,16,347,67,35,0.003284314,455065,0.513269795
3252,640,348,66,35,0.003235294,455131,0.513344236
4280,30,16,66,35,0.003235294,455197,0.513418678
4298,34,31,66,35,0.003235294,455263,0.51349312
3399,10,348,66,35,0.003235294,455329,0.513567561
5179,131,367,65,35,0.003186275,455394,0.513640875
5612,107,392,61,35,0.002990196,455455,0.513709677
3166,398,582,60,35,0.002941176,455515,0.513777352
7154,354,708,58,35,0.002843137,455573,0.51384277
5759,404,224,58,35,0.002843137,455631,0.513908189
6324,193,618,57,35,0.002794118,455688,0.513972479
5151,56,10,57,35,0.002794118,455745,0.51403677
3794,398,16,54,35,0.002647059,455799,0.514097677
4059,367,398,54,35,0.002647059,455853,0.514158583
7323,13,689,53,35,0.002598039,455906,0.514218362
955,105,479,148,34,0.007254902,456054,0.514385292
1166,95,27,132,34,0.006470588,456186,0.514534176
2245,535,230,128,34,0.00627451,456314,0.514678547
1191,397,367,126,34,0.006176471,456440,0.514820663
1563,353,264,123,34,0.006029412,456563,0.514959395
1747,473,34,122,34,0.005980392,456685,0.515097
3146,230,243,118,34,0.005784314,456803,0.515230092
1274,596,354,118,34,0.005784314,456921,0.515363185
1185,9,230,118,34,0.005784314,457039,0.515496278
1122,582,77,117,34,0.005735294,457156,0.515628243
2082,479,588,117,34,0.005735294,457273,0.515760208
1977,473,708,116,34,0.005686275,457389,0.515891044
1254,310,354,116,34,0.005686275,457505,0.516021881
2050,588,307,113,34,0.005539216,457618,0.516149335
1904,68,588,113,34,0.005539216,457731,0.516276788
1171,6,335,112,34,0.005490196,457843,0.516403113
2265,314,517,111,34,0.005441176,457954,0.51652831
1149,280,105,110,34,0.005392157,458064,0.51665238
2210,313,588,110,34,0.005392157,458174,0.516776449
1707,3,379,109,34,0.005343137,458283,0.516899391
2856,131,310,107,34,0.005245098,458390,0.517020077
2009,310,33,107,34,0.005245098,458497,0.517140762
1573,9,295,107,34,0.005245098,458604,0.517261448
2575,68,475,106,34,0.005196078,458710,0.517381006
2102,84,586,106,34,0.005196078,458816,0.517500564
396,26,158,106,34,0.005196078,458922,0.517620122
2215,367,11,104,34,0.005098039,459026,0.517737424
1344,302,123,104,34,0.005098039,459130,0.517854726
1593,107,354,103,34,0.00504902,459233,0.5179709
1644,414,105,103,34,0.00504902,459336,0.518087074
2541,663,10,103,34,0.00504902,459439,0.518203248
2556,34,32,103,34,0.00504902,459542,0.518319423
1775,250,394,103,34,0.00504902,459645,0.518435597
2881,224,514,103,34,0.00504902,459748,0.518551771
2401,313,427,102,34,0.005,459850,0.518666817
2429,80,33,102,34,0.005,459952,0.518781863
4340,535,528,102,34,0.005,460054,0.51889691
1774,397,84,101,34,0.00495098,460155,0.519010828
3205,34,558,101,34,0.00495098,460256,0.519124746
1083,596,314,100,34,0.004901961,460356,0.519237537
1974,522,243,100,34,0.004901961,460456,0.519350327
1588,302,10,100,34,0.004901961,460556,0.519463118
3294,354,11,100,34,0.004901961,460656,0.519575908
2532,522,367,100,34,0.004901961,460756,0.519688698
3505,522,663,99,34,0.004852941,460855,0.519800361
2425,609,107,99,34,0.004852941,460954,0.519912023
1856,443,280,99,34,0.004852941,461053,0.520023686
1455,335,307,99,34,0.004852941,461152,0.520135349
2529,522,498,98,34,0.004803922,461250,0.520245883
1640,367,334,98,34,0.004803922,461348,0.520356418
3483,427,473,97,34,0.004754902,461445,0.520465824
2829,310,219,97,34,0.004754902,461542,0.520575231
1304,6,123,97,34,0.004754902,461639,0.520684638
3087,335,4,96,34,0.004705882,461735,0.520792917
2811,130,295,96,34,0.004705882,461831,0.520901196
2447,314,170,96,34,0.004705882,461927,0.521009474
900,532,158,96,34,0.004705882,462023,0.521117753
2285,310,48,96,34,0.004705882,462119,0.521226032
2406,380,414,96,34,0.004705882,462215,0.521334311
2859,107,68,95,34,0.004656863,462310,0.521441462
2828,230,295,95,34,0.004656863,462405,0.521548613
1110,532,25,95,34,0.004656863,462500,0.521655764
2012,314,398,95,34,0.004656863,462595,0.521762915
1826,20,632,95,34,0.004656863,462690,0.521870065
3408,10,347,95,34,0.004656863,462785,0.521977216
1003,32,380,95,34,0.004656863,462880,0.522084367
2984,380,385,95,34,0.004656863,462975,0.522191518
2715,27,2,95,34,0.004656863,463070,0.522298669
1266,32,522,94,34,0.004607843,463164,0.522404692
2068,105,265,94,34,0.004607843,463258,0.522510715
3116,219,10,93,34,0.004558824,463351,0.52261561
3341,107,414,93,34,0.004558824,463444,0.522720505
2779,224,107,93,34,0.004558824,463537,0.5228254
2173,532,32,93,34,0.004558824,463630,0.522930296
2616,380,663,93,34,0.004558824,463723,0.523035191
2925,517,314,92,34,0.004509804,463815,0.523138958
2821,68,638,92,34,0.004509804,463907,0.523242725
3410,535,68,92,34,0.004509804,463999,0.523346492
2441,517,27,92,34,0.004509804,464091,0.523450259
1923,532,264,92,34,0.004509804,464183,0.523554027
2705,77,196,92,34,0.004509804,464275,0.523657794
2510,107,655,92,34,0.004509804,464367,0.523761561
3485,130,723,92,34,0.004509804,464459,0.523865328
2159,204,32,92,34,0.004509804,464551,0.523969095
1335,475,582,92,34,0.004509804,464643,0.524072863
1259,9,31,92,34,0.004509804,464735,0.52417663
3581,236,385,92,34,0.004509804,464827,0.524280397
1777,80,123,91,34,0.004460784,464918,0.524383036
3008,25,532,91,34,0.004460784,465009,0.524485676
3289,204,31,91,34,0.004460784,465100,0.524588315
2416,6,353,91,34,0.004460784,465191,0.524690954
2432,535,16,91,34,0.004460784,465282,0.524793594
2718,16,367,91,34,0.004460784,465373,0.524896233
1697,145,314,91,34,0.004460784,465464,0.524998872
2250,353,265,91,34,0.004460784,465555,0.525101511
3101,609,367,90,34,0.004411765,465645,0.525203023
2056,522,353,90,34,0.004411765,465735,0.525304534
2670,224,170,90,34,0.004411765,465825,0.525406046
2945,43,582,90,34,0.004411765,465915,0.525507557
2585,224,535,89,34,0.004362745,466004,0.52560794
2574,514,353,89,34,0.004362745,466093,0.525708324
2970,397,243,89,34,0.004362745,466182,0.525808707
2418,230,334,89,34,0.004362745,466271,0.525909091
2567,335,204,89,34,0.004362745,466360,0.526009474
2893,236,264,89,34,0.004362745,466449,0.526109858
2289,56,331,89,34,0.004362745,466538,0.526210241
3811,609,596,89,34,0.004362745,466627,0.526310625
2701,123,588,89,34,0.004362745,466716,0.526411008
3619,243,443,89,34,0.004362745,466805,0.526511392
2182,596,311,88,34,0.004313725,466893,0.526610647
2719,84,242,88,34,0.004313725,466981,0.526709903
1874,250,582,88,34,0.004313725,467069,0.526809159
2280,32,15,88,34,0.004313725,467157,0.526908414
4600,348,463,88,34,0.004313725,467245,0.52700767
3392,243,280,88,34,0.004313725,467333,0.527106925
3092,105,632,88,34,0.004313725,467421,0.527206181
2335,3,588,88,34,0.004313725,467509,0.527305436
3362,354,33,88,34,0.004313725,467597,0.527404692
1871,123,3,87,34,0.004264706,467684,0.52750282
2084,10,498,87,34,0.004264706,467771,0.527600947
3575,596,586,87,34,0.004264706,467858,0.527699075
2936,588,397,87,34,0.004264706,467945,0.527797203
2038,107,588,87,34,0.004264706,468032,0.52789533
2138,219,105,87,34,0.004264706,468119,0.527993458
2044,314,439,87,34,0.004264706,468206,0.528091586
1896,532,586,87,34,0.004264706,468293,0.528189714
2647,353,236,87,34,0.004264706,468380,0.528287841
916,26,314,87,34,0.004264706,468467,0.528385969
2196,33,471,87,34,0.004264706,468554,0.528484097
2350,311,463,87,34,0.004264706,468641,0.528582224
2450,479,331,87,34,0.004264706,468728,0.528680352
2611,10,236,86,34,0.004215686,468814,0.528777352
2531,310,95,86,34,0.004215686,468900,0.528874351
1940,33,10,86,34,0.004215686,468986,0.528971351
2345,27,22,86,34,0.004215686,469072,0.529068351
2643,12,397,85,34,0.004166667,469157,0.529164223
3035,427,314,85,34,0.004166667,469242,0.529260095
2240,107,219,85,34,0.004166667,469327,0.529355967
3349,219,16,85,34,0.004166667,469412,0.529451838
2776,522,31,85,34,0.004166667,469497,0.52954771
3548,130,394,85,34,0.004166667,469582,0.529643582
2904,80,334,85,34,0.004166667,469667,0.529739454
1374,33,380,84,34,0.004117647,469751,0.529834198
2951,311,141,84,34,0.004117647,469835,0.529928942
2371,328,105,84,34,0.004117647,469919,0.530023686
562,367,80,84,34,0.004117647,470003,0.53011843
3254,663,367,84,34,0.004117647,470087,0.530213174
2498,443,310,84,34,0.004117647,470171,0.530307918
1075,15,20,84,34,0.004117647,470255,0.530402662
3201,107,398,84,34,0.004117647,470339,0.530497406
1847,11,379,84,34,0.004117647,470423,0.53059215
1570,68,20,83,34,0.004068627,470506,0.530685766
4091,663,15,83,34,0.004068627,470589,0.530779382
4502,27,646,83,34,0.004068627,470672,0.530872998
2824,33,204,83,34,0.004068627,470755,0.530966614
1745,596,379,83,34,0.004068627,470838,0.53106023
2880,84,280,83,34,0.004068627,470921,0.531153846
2433,16,302,83,34,0.004068627,471004,0.531247462
3906,588,674,83,34,0.004068627,471087,0.531341078
3876,224,130,83,34,0.004068627,471170,0.531434694
2519,473,393,82,34,0.004019608,471252,0.531527182
4486,117,609,82,34,0.004019608,471334,0.531619671
2630,10,394,82,34,0.004019608,471416,0.531712159
4034,131,95,82,34,0.004019608,471498,0.531804647
1453,9,558,82,34,0.004019608,471580,0.531897135
4554,517,230,82,34,0.004019608,471662,0.531989623
3323,663,498,82,34,0.004019608,471744,0.532082111
1688,586,353,82,34,0.004019608,471826,0.5321746
2952,250,335,82,34,0.004019608,471908,0.532267088
2007,582,15,82,34,0.004019608,471990,0.532359576
3017,236,25,81,34,0.003970588,472071,0.532450936
2977,443,25,81,34,0.003970588,472152,0.532542296
2454,596,9,81,34,0.003970588,472233,0.532633657
3123,131,558,81,34,0.003970588,472314,0.532725017
3673,535,219,81,34,0.003970588,472395,0.532816377
2552,84,655,81,34,0.003970588,472476,0.532907737
1867,605,27,81,34,0.003970588,472557,0.532999098
3169,310,11,81,34,0.003970588,472638,0.533090458
3228,80,535,81,34,0.003970588,472719,0.533181818
4602,131,26,81,34,0.003970588,472800,0.533273178
2222,274,224,81,34,0.003970588,472881,0.533364539
3850,535,84,80,34,0.003921569,472961,0.533454771
2442,10,84,80,34,0.003921569,473041,0.533545003
1639,398,105,80,34,0.003921569,473121,0.533635236
3139,295,145,80,34,0.003921569,473201,0.533725468
648,394,80,79,34,0.003872549,473280,0.533814573
2651,25,443,79,34,0.003872549,473359,0.533903677
5216,117,380,79,34,0.003872549,473438,0.533992781
2794,379,68,79,34,0.003872549,473517,0.534081886
1551,219,80,79,34,0.003872549,473596,0.53417099
3834,10,114,79,34,0.003872549,473675,0.534260095
4026,348,588,79,34,0.003872549,473754,0.534349199
4515,3,243,78,34,0.003823529,473832,0.534437176
3417,552,314,78,34,0.003823529,473910,0.534525152
2312,479,379,78,34,0.003823529,473988,0.534613129
4054,243,219,78,34,0.003823529,474066,0.534701105
3547,314,126,78,34,0.003823529,474144,0.534789082
3519,314,514,78,34,0.003823529,474222,0.534877058
3256,158,558,78,34,0.003823529,474300,0.534965035
3222,84,514,78,34,0.003823529,474378,0.535053012
2862,473,121,78,34,0.003823529,474456,0.535140988
2295,295,131,77,34,0.00377451,474533,0.535227837
1862,26,394,77,34,0.00377451,474610,0.535314685
3072,230,475,77,34,0.00377451,474687,0.535401534
2990,596,10,77,34,0.00377451,474764,0.535488383
2187,9,14,77,34,0.00377451,474841,0.535575231
4524,107,463,77,34,0.00377451,474918,0.53566208
4068,596,514,76,34,0.00372549,474994,0.535747801
3872,224,609,76,34,0.00372549,475070,0.535833521
2927,335,242,76,34,0.00372549,475146,0.535919242
3466,3,236,76,34,0.00372549,475222,0.536004963
3757,663,95,76,34,0.00372549,475298,0.536090684
2377,311,348,76,34,0.00372549,475374,0.536176404
1675,9,280,76,34,0.00372549,475450,0.536262125
2458,397,310,76,34,0.00372549,475526,0.536347846
2426,310,393,75,34,0.003676471,475601,0.536432439
2671,105,708,75,34,0.003676471,475676,0.536517031
4255,68,463,75,34,0.003676471,475751,0.536601624
5316,107,605,75,34,0.003676471,475826,0.536686217
3999,582,517,74,34,0.003627451,475900,0.536769682
3368,443,609,74,34,0.003627451,475974,0.536853147
4451,16,427,74,34,0.003627451,476048,0.536936612
2722,302,479,74,34,0.003627451,476122,0.537020077
914,6,80,74,34,0.003627451,476196,0.537103542
3415,463,16,74,34,0.003627451,476270,0.537187007
3797,224,164,74,34,0.003627451,476344,0.537270471
2620,582,114,73,34,0.003578431,476417,0.537352808
3875,107,558,73,34,0.003578431,476490,0.537435145
3452,335,683,73,34,0.003578431,476563,0.537517483
2349,302,638,73,34,0.003578431,476636,0.53759982
3544,68,77,73,34,0.003578431,476709,0.537682157
1366,295,582,73,34,0.003578431,476782,0.537764494
2177,379,302,72,34,0.003529412,476854,0.537845703
2944,219,558,72,34,0.003529412,476926,0.537926912
1678,393,314,72,34,0.003529412,476998,0.538008121
6243,348,439,72,34,0.003529412,477070,0.53808933
4219,80,674,72,34,0.003529412,477142,0.538170539
2727,335,30,72,34,0.003529412,477214,0.538251748
3010,314,25,71,34,0.003480392,477285,0.538331829
3456,123,475,71,34,0.003480392,477356,0.538411911
2220,77,674,71,34,0.003480392,477427,0.538491992
3779,33,463,71,34,0.003480392,477498,0.538572073
5753,552,473,71,34,0.003480392,477569,0.538652154
4147,15,14,71,34,0.003480392,477640,0.538732236
3725,558,347,70,34,0.003431373,477710,0.538811189
2299,501,105,70,34,0.003431373,477780,0.538890142
3195,280,10,70,34,0.003431373,477850,0.538969095
2434,331,6,70,34,0.003431373,477920,0.539048049
2528,498,243,70,34,0.003431373,477990,0.539127002
3968,335,364,70,34,0.003431373,478060,0.539205955
4082,689,348,70,34,0.003431373,478130,0.539284909
3896,663,348,70,34,0.003431373,478200,0.539363862
2870,674,311,70,34,0.003431373,478270,0.539442815
3097,230,638,69,34,0.003382353,478339,0.539520641
2609,348,20,69,34,0.003382353,478408,0.539598466
3653,77,364,69,34,0.003382353,478477,0.539676291
1723,97,582,69,34,0.003382353,478546,0.539754117
3083,310,236,69,34,0.003382353,478615,0.539831942
2960,529,280,69,34,0.003382353,478684,0.539909768
4331,708,204,68,34,0.003333333,478752,0.539986465
5296,473,439,68,34,0.003333333,478820,0.540063163
3397,393,224,68,34,0.003333333,478888,0.54013986
2486,335,562,68,34,0.003333333,478956,0.540216558
2502,105,640,68,34,0.003333333,479024,0.540293255
3934,331,328,67,34,0.003284314,479091,0.540368825
3992,265,16,67,34,0.003284314,479158,0.540444394
4390,427,582,67,34,0.003284314,479225,0.540519964
4060,354,84,67,34,0.003284314,479292,0.540595533
4696,193,632,67,34,0.003284314,479359,0.540671103
3559,588,609,66,34,0.003235294,479425,0.540745545
3830,471,105,66,34,0.003235294,479491,0.540819986
2775,9,250,66,34,0.003235294,479557,0.540894428
4196,77,560,66,34,0.003235294,479623,0.54096887
3284,582,34,66,34,0.003235294,479689,0.541043312
2221,522,334,66,34,0.003235294,479755,0.541117753
2906,11,353,66,34,0.003235294,479821,0.541192195
4110,663,145,66,34,0.003235294,479887,0.541266637
3318,532,11,65,34,0.003186275,479952,0.54133995
5559,414,596,65,34,0.003186275,480017,0.541413264
876,4,105,64,34,0.003137255,480081,0.54148545
2002,529,394,63,34,0.003088235,480144,0.541556508
3295,95,9,62,34,0.003039216,480206,0.541626438
3945,353,347,62,34,0.003039216,480268,0.541696368
3090,10,6,61,34,0.002990196,480329,0.54176517
2421,673,380,61,34,0.002990196,480390,0.541833972
5054,236,11,61,34,0.002990196,480451,0.541902775
5732,265,236,60,34,0.002941176,480511,0.541970449
3441,10,638,60,34,0.002941176,480571,0.542038123
3151,105,543,59,34,0.002892157,480630,0.54210467
5086,224,121,59,34,0.002892157,480689,0.542171216
2294,532,582,58,34,0.002843137,480747,0.542236634
3428,95,335,58,34,0.002843137,480805,0.542302053
1524,689,314,58,34,0.002843137,480863,0.542367471
5603,48,236,58,34,0.002843137,480921,0.54243289
1041,32,20,57,34,0.002794118,480978,0.54249718
4454,313,130,53,34,0.002598039,481031,0.542556959
5642,673,479,53,34,0.002598039,481084,0.542616738
7189,117,224,52,34,0.00254902,481136,0.542675389
3988,311,640,52,34,0.00254902,481188,0.54273404
2576,586,224,51,34,0.0025,481239,0.542791563
6953,145,348,50,34,0.00245098,481289,0.542847958
4927,207,314,49,34,0.002401961,481338,0.542903226
577,562,158,123,33,0.006029412,481461,0.543041958
2118,562,16,118,33,0.005784314,481579,0.543175051
1542,310,68,112,33,0.005490196,481691,0.543301376
1235,380,77,111,33,0.005441176,481802,0.543426573
919,33,335,109,33,0.005343137,481911,0.543549515
2270,130,334,108,33,0.005294118,482019,0.543671329
2123,380,3,106,33,0.005196078,482125,0.543790887
2963,80,141,106,33,0.005196078,482231,0.543910444
2013,10,522,103,33,0.00504902,482334,0.544026619
1264,311,77,102,33,0.005,482436,0.544141665
1780,479,335,102,33,0.005,482538,0.544256711
3044,535,367,102,33,0.005,482640,0.544371757
2331,130,123,101,33,0.00495098,482741,0.544485676
2032,105,328,101,33,0.00495098,482842,0.544599594
1805,105,204,99,33,0.004852941,482941,0.544711256
2603,314,682,99,33,0.004852941,483040,0.544822919
1968,145,224,99,33,0.004852941,483139,0.544934582
2248,473,145,98,33,0.004803922,483237,0.545045116
2098,479,16,98,33,0.004803922,483335,0.545155651
1930,33,15,98,33,0.004803922,483433,0.545266185
3315,130,586,97,33,0.004754902,483530,0.545375592
4444,471,48,97,33,0.004754902,483627,0.545484999
1340,16,379,97,33,0.004754902,483724,0.545594406
2203,123,471,96,33,0.004705882,483820,0.545702684
1582,310,123,95,33,0.004656863,483915,0.545809835
2308,280,310,95,33,0.004656863,484010,0.545916986
2033,367,354,95,33,0.004656863,484105,0.546024137
1348,638,27,95,33,0.004656863,484200,0.546131288
1785,31,27,95,33,0.004656863,484295,0.546238439
2600,80,588,95,33,0.004656863,484390,0.54634559
2283,522,471,94,33,0.004607843,484484,0.546451613
2571,16,219,94,33,0.004607843,484578,0.546557636
2514,313,145,94,33,0.004607843,484672,0.546663659
1645,48,80,94,33,0.004607843,484766,0.546769682
2413,11,16,93,33,0.004558824,484859,0.546874577
2228,522,354,93,33,0.004558824,484952,0.546979472
2443,33,196,93,33,0.004558824,485045,0.547084367
1454,311,6,93,33,0.004558824,485138,0.547189262
2614,314,265,93,33,0.004558824,485231,0.547294157
2685,236,68,93,33,0.004558824,485324,0.547399053
2430,473,723,92,33,0.004509804,485416,0.54750282
2949,230,26,92,33,0.004509804,485508,0.547606587
2462,313,2,92,33,0.004509804,485600,0.547710354
3019,596,265,92,33,0.004509804,485692,0.547814121
2553,68,3,91,33,0.004460784,485783,0.547916761
3447,328,354,91,33,0.004460784,485874,0.5480194
2692,314,242,90,33,0.004411765,485964,0.548120911
2247,663,311,90,33,0.004411765,486054,0.548222423
2570,443,219,90,33,0.004411765,486144,0.548323934
3007,243,26,90,33,0.004411765,486234,0.548425446
3332,80,313,89,33,0.004362745,486323,0.548525829
2980,11,393,89,33,0.004362745,486412,0.548626212
2218,302,588,89,33,0.004362745,486501,0.548726596
3980,348,145,89,33,0.004362745,486590,0.548826979
1217,394,105,89,33,0.004362745,486679,0.548927363
2487,380,535,88,33,0.004313725,486767,0.549026619
3527,10,107,88,33,0.004313725,486855,0.549125874
1885,311,404,88,33,0.004313725,486943,0.54922513
2006,123,32,88,33,0.004313725,487031,0.549324385
2286,562,219,88,33,0.004313725,487119,0.549423641
2931,16,609,87,33,0.004264706,487206,0.549521769
2632,236,265,87,33,0.004264706,487293,0.549619896
4048,130,663,87,33,0.004264706,487380,0.549718024
3330,20,618,86,33,0.004215686,487466,0.549815024
1850,20,68,86,33,0.004215686,487552,0.549912023
3039,398,596,86,33,0.004215686,487638,0.550009023
2251,311,655,86,33,0.004215686,487724,0.550106023
3186,224,596,86,33,0.004215686,487810,0.550203023
2615,80,280,85,33,0.004166667,487895,0.550298895
2606,219,655,85,33,0.004166667,487980,0.550394767
3518,43,314,85,33,0.004166667,488065,0.550490638
2610,479,311,85,33,0.004166667,488150,0.55058651
3390,243,498,85,33,0.004166667,488235,0.550682382
4416,348,236,85,33,0.004166667,488320,0.550778254
4174,10,242,85,33,0.004166667,488405,0.550874126
2761,674,558,85,33,0.004166667,488490,0.550969998
1659,313,15,84,33,0.004117647,488574,0.551064742
1920,6,354,84,33,0.004117647,488658,0.551159486
3522,193,14,84,33,0.004117647,488742,0.55125423
2836,68,48,84,33,0.004117647,488826,0.551348974
1891,26,264,84,33,0.004117647,488910,0.551443718
2729,11,310,84,33,0.004117647,488994,0.551538462
2766,473,64,83,33,0.004068627,489077,0.551632078
1763,498,105,83,33,0.004068627,489160,0.551725694
1982,204,20,83,33,0.004068627,489243,0.55181931
1576,479,10,83,33,0.004068627,489326,0.551912926
4095,131,443,83,33,0.004068627,489409,0.552006542
1226,479,80,83,33,0.004068627,489492,0.552100158
3805,354,219,83,33,0.004068627,489575,0.552193774
2419,224,334,83,33,0.004068627,489658,0.55228739
3164,475,347,83,33,0.004068627,489741,0.552381006
1556,393,582,82,33,0.004019608,489823,0.552473494
5155,535,114,82,33,0.004019608,489905,0.552565982
3108,6,348,82,33,0.004019608,489987,0.552658471
2035,313,196,82,33,0.004019608,490069,0.552750959
3437,354,394,82,33,0.004019608,490151,0.552843447
3854,2,347,82,33,0.004019608,490233,0.552935935
2948,532,164,82,33,0.004019608,490315,0.553028423
2409,311,398,82,33,0.004019608,490397,0.553120911
1750,353,9,82,33,0.004019608,490479,0.5532134
1837,331,529,82,33,0.004019608,490561,0.553305888
2751,30,32,82,33,0.004019608,490643,0.553398376
2652,331,414,81,33,0.003970588,490724,0.553489736
4096,117,27,81,33,0.003970588,490805,0.553581096
2954,77,605,81,33,0.003970588,490886,0.553672457
1753,9,475,81,33,0.003970588,490967,0.553763817
2645,314,29,81,33,0.003970588,491048,0.553855177
1932,9,11,81,33,0.003970588,491129,0.553946537
1060,130,80,81,33,0.003970588,491210,0.554037898
2325,33,379,80,33,0.003921569,491290,0.55412813
991,614,80,80,33,0.003921569,491370,0.554218362
1927,582,145,80,33,0.003921569,491450,0.554308595
3724,663,295,80,33,0.003921569,491530,0.554398827
2665,84,265,80,33,0.003921569,491610,0.554489059
1415,77,25,80,33,0.003921569,491690,0.554579292
3250,68,11,80,33,0.003921569,491770,0.554669524
4359,663,97,80,33,0.003921569,491850,0.554759756
2131,532,9,79,33,0.003872549,491929,0.554848861
1581,379,80,79,33,0.003872549,492008,0.554937965
2621,80,354,79,33,0.003872549,492087,0.55502707
1827,674,380,79,33,0.003872549,492166,0.555116174
3262,582,2,79,33,0.003872549,492245,0.555205279
3412,380,121,78,33,0.003823529,492323,0.555293255
2926,77,328,78,33,0.003823529,492401,0.555381232
4511,313,517,78,33,0.003823529,492479,0.555469208
3094,335,274,78,33,0.003823529,492557,0.555557185
2883,313,204,78,33,0.003823529,492635,0.555645161
2872,219,9,78,33,0.003823529,492713,0.555733138
3736,522,15,78,33,0.003823529,492791,0.555821114
2731,6,95,78,33,0.003823529,492869,0.555909091
2378,314,501,78,33,0.003823529,492947,0.555997067
3643,314,207,78,33,0.003823529,493025,0.556085044
3469,335,517,77,33,0.00377451,493102,0.556171893
3748,68,586,77,33,0.00377451,493179,0.556258741
3806,12,609,77,33,0.00377451,493256,0.55634559
3327,236,33,77,33,0.00377451,493333,0.556432439
2199,26,331,77,33,0.00377451,493410,0.556519287
1921,367,230,77,33,0.00377451,493487,0.556606136
3105,295,31,77,33,0.00377451,493564,0.556692984
2284,313,107,77,33,0.00377451,493641,0.556779833
1308,9,84,77,33,0.00377451,493718,0.556866682
2581,640,16,77,33,0.00377451,493795,0.55695353
2934,529,16,76,33,0.00372549,493871,0.557039251
3021,596,26,76,33,0.00372549,493947,0.557124972
3795,230,535,76,33,0.00372549,494023,0.557210693
4062,11,596,76,33,0.00372549,494099,0.557296413
2819,27,163,76,33,0.00372549,494175,0.557382134
2641,80,532,76,33,0.00372549,494251,0.557467855
2659,6,331,76,33,0.00372549,494327,0.557553575
5122,354,250,75,33,0.003676471,494402,0.557638168
3225,640,347,75,33,0.003676471,494477,0.557722761
4120,68,439,75,33,0.003676471,494552,0.557807354
3623,107,471,75,33,0.003676471,494627,0.557891947
3377,224,393,75,33,0.003676471,494702,0.55797654
1695,20,32,75,33,0.003676471,494777,0.558061132
2477,84,354,75,33,0.003676471,494852,0.558145725
3356,204,348,75,33,0.003676471,494927,0.558230318
4081,224,14,75,33,0.003676471,495002,0.558314911
3449,596,280,75,33,0.003676471,495077,0.558399504
2555,394,16,75,33,0.003676471,495152,0.558484097
3507,10,463,75,33,0.003676471,495227,0.558568689
2448,367,353,74,33,0.003627451,495301,0.558652154
3470,335,501,74,33,0.003627451,495375,0.558735619
3742,48,31,74,33,0.003627451,495449,0.558819084
5684,230,517,73,33,0.003578431,495522,0.558901421
3479,335,34,73,33,0.003578431,495595,0.558983758
1838,9,674,73,33,0.003578431,495668,0.559066095
1803,582,535,73,33,0.003578431,495741,0.559148432
2956,80,32,73,33,0.003578431,495814,0.559230769
5301,354,427,73,33,0.003578431,495887,0.559313106
3378,236,48,73,33,0.003578431,495960,0.559395443
4443,663,723,73,33,0.003578431,496033,0.55947778
2831,95,224,73,33,0.003578431,496106,0.559560117
2858,558,302,73,33,0.003578431,496179,0.559642454
4090,640,95,73,33,0.003578431,496252,0.559724791
4413,230,640,73,33,0.003578431,496325,0.559807128
3776,131,123,73,33,0.003578431,496398,0.559889465
3783,558,14,72,33,0.003529412,496470,0.559970674
4027,107,514,72,33,0.003529412,496542,0.560051884
3178,473,243,72,33,0.003529412,496614,0.560133093
2649,236,302,72,33,0.003529412,496686,0.560214302
2920,498,25,72,33,0.003529412,496758,0.560295511
4192,250,596,72,33,0.003529412,496830,0.56037672
4200,295,347,72,33,0.003529412,496902,0.560457929
2562,380,95,72,33,0.003529412,496974,0.560539138
1459,397,353,72,33,0.003529412,497046,0.560620347
1998,9,348,72,33,0.003529412,497118,0.560701557
5375,348,48,71,33,0.003480392,497189,0.560781638
3439,10,689,71,33,0.003480392,497260,0.560861719
2908,674,68,71,33,0.003480392,497331,0.5609418
3322,311,54,71,33,0.003480392,497402,0.561021881
2048,313,236,71,33,0.003480392,497473,0.561101963
2427,2,27,71,33,0.003480392,497544,0.561182044
4213,3,97,71,33,0.003480392,497615,0.561262125
4529,48,50,71,33,0.003480392,497686,0.561342206
3177,10,3,71,33,0.003480392,497757,0.561422287
4744,236,50,71,33,0.003480392,497828,0.561502369
2194,379,354,71,33,0.003480392,497899,0.56158245
1474,32,158,71,33,0.003480392,497970,0.561662531
3037,618,27,71,33,0.003480392,498041,0.561742612
3102,588,427,71,33,0.003480392,498112,0.561822693
5487,171,31,70,33,0.003431373,498182,0.561901647
4282,105,5,70,33,0.003431373,498252,0.5619806
3063,80,95,70,33,0.003431373,498322,0.562059553
1406,558,158,70,33,0.003431373,498392,0.562138507
2618,16,313,69,33,0.003382353,498461,0.562216332
3234,588,498,69,33,0.003382353,498530,0.562294157
4912,328,609,69,33,0.003382353,498599,0.562371983
3534,95,230,69,33,0.003382353,498668,0.562449808
2860,123,131,69,33,0.003382353,498737,0.562527634
2327,313,655,69,33,0.003382353,498806,0.562605459
2253,394,582,69,33,0.003382353,498875,0.562683284
2323,9,77,69,33,0.003382353,498944,0.56276111
2672,105,30,68,33,0.003333333,499012,0.562837807
4435,335,528,68,33,0.003333333,499080,0.562914505
3592,638,95,68,33,0.003333333,499148,0.562991202
3668,107,313,68,33,0.003333333,499216,0.5630679
2589,9,479,68,33,0.003333333,499284,0.563144597
3062,522,397,68,33,0.003333333,499352,0.563221295
4254,145,302,67,33,0.003284314,499419,0.563296864
2256,311,638,67,33,0.003284314,499486,0.563372434
3427,158,10,67,33,0.003284314,499553,0.563448004
2997,582,242,67,33,0.003284314,499620,0.563523573
4029,224,528,67,33,0.003284314,499687,0.563599143
4521,380,528,67,33,0.003284314,499754,0.563674712
3314,310,77,67,33,0.003284314,499821,0.563750282
2791,463,473,66,33,0.003235294,499887,0.563824724
3023,353,141,66,33,0.003235294,499953,0.563899165
3135,501,224,66,33,0.003235294,500019,0.563973607
1830,26,582,66,33,0.003235294,500085,0.564048049
3729,394,397,66,33,0.003235294,500151,0.56412249
4236,522,34,66,33,0.003235294,500217,0.564196932
3845,107,535,66,33,0.003235294,500283,0.564271374
4507,588,54,66,33,0.003235294,500349,0.564345815
2623,307,582,66,33,0.003235294,500415,0.564420257
4032,48,77,66,33,0.003235294,500481,0.564494699
3606,379,131,65,33,0.003186275,500546,0.564568013
5287,427,16,65,33,0.003186275,500611,0.564641326
3731,663,48,65,33,0.003186275,500676,0.56471464
3693,3,50,65,33,0.003186275,500741,0.564787954
3326,544,314,65,33,0.003186275,500806,0.564861268
4157,34,310,64,33,0.003137255,500870,0.564933454
3926,310,6,64,33,0.003137255,500934,0.56500564
4410,243,25,64,33,0.003137255,500998,0.565077825
3651,302,394,64,33,0.003137255,501062,0.565150011
4839,224,242,64,33,0.003137255,501126,0.565222197
4886,68,243,64,33,0.003137255,501190,0.565294383
4440,236,6,64,33,0.003137255,501254,0.565366569
4785,522,204,64,33,0.003137255,501318,0.565438755
3984,588,141,64,33,0.003137255,501382,0.565510941
3281,224,638,64,33,0.003137255,501446,0.565583127
5666,502,498,63,33,0.003088235,501509,0.565654185
2548,16,394,63,33,0.003088235,501572,0.565725242
3675,56,123,63,33,0.003088235,501635,0.5657963
3431,224,264,63,33,0.003088235,501698,0.565867358
4216,335,439,62,33,0.003039216,501760,0.565937289
4164,558,95,62,33,0.003039216,501822,0.566007219
3154,34,105,62,33,0.003039216,501884,0.566077149
5194,354,475,62,33,0.003039216,501946,0.566147079
4782,34,204,61,33,0.002990196,502007,0.566215881
6050,348,596,61,33,0.002990196,502068,0.566284683
2839,353,532,61,33,0.002990196,502129,0.566353485
3716,10,295,61,33,0.002990196,502190,0.566422287
5913,663,130,61,33,0.002990196,502251,0.56649109
2958,558,638,61,33,0.002990196,502312,0.566559892
4037,473,544,61,33,0.002990196,502373,0.566628694
2974,12,27,61,33,0.002990196,502434,0.566697496
2636,689,473,61,33,0.002990196,502495,0.566766298
2622,16,588,61,33,0.002990196,502556,0.5668351
1973,12,80,61,33,0.002990196,502617,0.566903903
3126,335,25,61,33,0.002990196,502678,0.566972705
3350,84,532,61,33,0.002990196,502739,0.567041507
3429,280,11,60,33,0.002941176,502799,0.567109181
5533,130,674,60,33,0.002941176,502859,0.567176855
3655,367,32,59,33,0.002892157,502918,0.567243402
3189,674,353,59,33,0.002892157,502977,0.567309948
5751,15,463,59,33,0.002892157,503036,0.567376494
3817,347,582,59,33,0.002892157,503095,0.567443041
5404,558,107,58,33,0.002843137,503153,0.567508459
4325,609,529,58,33,0.002843137,503211,0.567573878
4475,522,609,58,33,0.002843137,503269,0.567639296
5494,163,16,57,33,0.002794118,503326,0.567703587
6223,97,347,56,33,0.002745098,503382,0.567766749
5080,354,586,56,33,0.002745098,503438,0.567829912
6320,522,517,55,33,0.002696078,503493,0.567891947
4023,328,311,55,33,0.002696078,503548,0.567953982
5647,1,16,54,33,0.002647059,503602,0.568014888
3888,335,543,54,33,0.002647059,503656,0.568075795
6685,475,34,54,33,0.002647059,503710,0.568136702
6988,84,605,54,33,0.002647059,503764,0.568197609
5326,313,605,53,33,0.002598039,503817,0.568257388
3644,588,114,53,33,0.002598039,503870,0.568317167
1993,33,334,53,33,0.002598039,503923,0.568376946
4537,535,3,52,33,0.00254902,503975,0.568435597
5787,479,543,48,33,0.002352941,504023,0.568489736
9159,224,54,46,33,0.002254902,504069,0.56854162
6917,196,558,45,33,0.002205882,504114,0.568592375
9711,155,224,44,33,0.002156863,504158,0.568642003
11136,140,242,41,33,0.002009804,504199,0.568688247
2279,48,331,108,32,0.005294118,504307,0.568810061
1555,335,145,104,32,0.005098039,504411,0.568927363
1371,224,77,98,32,0.004803922,504509,0.569037898
3051,15,348,96,32,0.004705882,504605,0.569146176
1150,9,123,95,32,0.004656863,504700,0.569253327
3785,535,393,95,32,0.004656863,504795,0.569360478
2995,414,367,95,32,0.004656863,504890,0.569467629
4223,171,68,92,32,0.004509804,504982,0.569571396
2686,224,532,92,32,0.004509804,505074,0.569675164
2483,588,689,92,32,0.004509804,505166,0.569778931
1231,302,16,92,32,0.004509804,505258,0.569882698
2549,219,32,91,32,0.004460784,505349,0.569985337
2155,84,26,91,32,0.004460784,505440,0.570087977
3978,471,10,90,32,0.004411765,505530,0.570189488
3735,80,121,89,32,0.004362745,505619,0.570289871
3704,230,145,88,32,0.004313725,505707,0.570389127
2408,562,230,88,32,0.004313725,505795,0.570488383
3325,131,655,88,32,0.004313725,505883,0.570587638
3568,367,250,88,32,0.004313725,505971,0.570686894
2607,397,224,88,32,0.004313725,506059,0.570786149
3336,131,31,88,32,0.004313725,506147,0.570885405
2478,353,335,87,32,0.004264706,506234,0.570983533
2093,313,638,86,32,0.004215686,506320,0.571080532
1740,15,314,85,32,0.004166667,506405,0.571176404
2147,48,335,85,32,0.004166667,506490,0.571272276
4056,131,640,85,32,0.004166667,506575,0.571368148
1426,2,314,85,32,0.004166667,506660,0.57146402
3743,130,280,85,32,0.004166667,506745,0.571559892
2365,265,353,85,32,0.004166667,506830,0.571655764
2234,26,397,85,32,0.004166667,506915,0.571751635
2915,479,354,85,32,0.004166667,507000,0.571847507
1467,130,158,84,32,0.004117647,507084,0.571942251
3491,145,68,84,32,0.004117647,507168,0.572036995
518,26,80,84,32,0.004117647,507252,0.572131739
2296,84,264,84,32,0.004117647,507336,0.572226483
3582,471,473,84,32,0.004117647,507420,0.572321227
3389,131,331,83,32,0.004068627,507503,0.572414843
4175,348,11,83,32,0.004068627,507586,0.572508459
2246,77,145,83,32,0.004068627,507669,0.572602075
887,498,158,83,32,0.004068627,507752,0.572695691
2786,380,6,82,32,0.004019608,507834,0.57278818
3065,588,638,82,32,0.004019608,507916,0.572880668
2785,479,663,82,32,0.004019608,507998,0.572973156
4140,68,562,82,32,0.004019608,508080,0.573065644
2782,123,558,82,32,0.004019608,508162,0.573158132
2481,532,379,81,32,0.003970588,508243,0.573249492
3373,348,479,81,32,0.003970588,508324,0.573340853
3210,6,196,81,32,0.003970588,508405,0.573432213
1983,280,25,81,32,0.003970588,508486,0.573523573
2849,331,31,80,32,0.003921569,508566,0.573613806
3555,243,586,80,32,0.003921569,508646,0.573704038
2070,25,280,80,32,0.003921569,508726,0.57379427
3089,302,145,80,32,0.003921569,508806,0.573884503
2967,331,385,79,32,0.003872549,508885,0.573973607
3355,68,170,79,32,0.003872549,508964,0.574062711
922,9,498,79,32,0.003872549,509043,0.574151816
2577,588,353,79,32,0.003872549,509122,0.57424092
3081,532,243,79,32,0.003872549,509201,0.574330025
3215,522,11,79,32,0.003872549,509280,0.574419129
4491,10,528,79,32,0.003872549,509359,0.574508234
3242,26,11,79,32,0.003872549,509438,0.574597338
3570,543,16,78,32,0.003823529,509516,0.574685315
2263,353,393,78,32,0.003823529,509594,0.574773291
2036,404,27,78,32,0.003823529,509672,0.574861268
2676,588,77,78,32,0.003823529,509750,0.574949244
4259,15,347,78,32,0.003823529,509828,0.575037221
2137,473,394,78,32,0.003823529,509906,0.575125197
1600,274,80,78,32,0.003823529,509984,0.575213174
1986,708,20,78,32,0.003823529,510062,0.57530115
2505,16,443,78,32,0.003823529,510140,0.575389127
2631,310,522,77,32,0.00377451,510217,0.575475976
4000,224,614,77,32,0.00377451,510294,0.575562824
3351,156,16,77,32,0.00377451,510371,0.575649673
2868,280,394,76,32,0.00372549,510447,0.575735394
3883,84,471,76,32,0.00372549,510523,0.575821114
3241,250,310,76,32,0.00372549,510599,0.575906835
3230,353,558,76,32,0.00372549,510675,0.575992556
3564,105,544,76,32,0.00372549,510751,0.576078277
3033,443,393,76,32,0.00372549,510827,0.576163997
2388,33,663,76,32,0.00372549,510903,0.576249718
4795,130,596,76,32,0.00372549,510979,0.576335439
2644,443,236,76,32,0.00372549,511055,0.576421159
1614,582,84,76,32,0.00372549,511131,0.57650688
2382,295,310,76,32,0.00372549,511207,0.576592601
2163,6,313,76,32,0.00372549,511283,0.576678322
4285,354,334,76,32,0.00372549,511359,0.576764042
2605,26,335,75,32,0.003676471,511434,0.576848635
2588,331,535,75,32,0.003676471,511509,0.576933228
1948,394,314,75,32,0.003676471,511584,0.577017821
3759,236,663,75,32,0.003676471,511659,0.577102414
3762,243,16,75,32,0.003676471,511734,0.577187007
2639,655,243,75,32,0.003676471,511809,0.577271599
2396,243,105,75,32,0.003676471,511884,0.577356192
4571,517,32,75,32,0.003676471,511959,0.577440785
4351,130,196,75,32,0.003676471,512034,0.577525378
4178,380,501,75,32,0.003676471,512109,0.577609971
5227,1,219,74,32,0.003627451,512183,0.577693436
3181,6,295,74,32,0.003627451,512257,0.577776901
3899,353,23,74,32,0.003627451,512331,0.577860365
3227,3,219,74,32,0.003627451,512405,0.57794383
1980,302,471,74,32,0.003627451,512479,0.578027295
2978,334,105,74,32,0.003627451,512553,0.57811076
3416,6,397,74,32,0.003627451,512627,0.578194225
2780,532,335,74,32,0.003627451,512701,0.57827769
2353,123,9,73,32,0.003578431,512774,0.578360027
3583,3,31,73,32,0.003578431,512847,0.578442364
2373,398,394,73,32,0.003578431,512920,0.578524701
2619,473,307,73,32,0.003578431,512993,0.578607038
1945,673,105,73,32,0.003578431,513066,0.578689375
3492,367,596,73,32,0.003578431,513139,0.578771712
932,353,158,73,32,0.003578431,513212,0.578854049
3462,80,398,73,32,0.003578431,513285,0.578936386
2415,105,114,73,32,0.003578431,513358,0.579018723
4951,77,5,73,32,0.003578431,513431,0.57910106
3835,48,311,73,32,0.003578431,513504,0.579183397
3922,310,107,72,32,0.003529412,513576,0.579264606
3107,588,2,72,32,0.003529412,513648,0.579345815
3098,105,502,72,32,0.003529412,513720,0.579427025
4596,43,27,72,32,0.003529412,513792,0.579508234
2964,123,95,72,32,0.003529412,513864,0.579589443
3516,367,48,72,32,0.003529412,513936,0.579670652
2968,32,48,72,32,0.003529412,514008,0.579751861
3345,230,196,72,32,0.003529412,514080,0.57983307
4188,380,364,71,32,0.003480392,514151,0.579913151
2777,123,313,71,32,0.003480392,514222,0.579993233
2243,674,335,71,32,0.003480392,514293,0.580073314
3702,471,230,71,32,0.003480392,514364,0.580153395
2590,32,367,71,32,0.003480392,514435,0.580233476
4457,348,311,71,32,0.003480392,514506,0.580313557
2966,380,264,71,32,0.003480392,514577,0.580393639
3635,663,588,71,32,0.003480392,514648,0.58047372
2314,30,473,71,32,0.003480392,514719,0.580553801
2344,596,219,71,32,0.003480392,514790,0.580633882
3179,295,348,70,32,0.003431373,514860,0.580712836
4952,354,348,70,32,0.003431373,514930,0.580791789
3796,34,16,70,32,0.003431373,515000,0.580870742
2507,80,558,70,32,0.003431373,515070,0.580949695
3200,380,265,70,32,0.003431373,515140,0.581028649
1684,243,80,70,32,0.003431373,515210,0.581107602
2972,582,640,70,32,0.003431373,515280,0.581186555
2662,302,367,70,32,0.003431373,515350,0.581265509
1860,9,236,69,32,0.003382353,515419,0.581343334
3976,11,84,69,32,0.003382353,515488,0.581421159
3642,80,130,69,32,0.003382353,515557,0.581498985
3255,463,10,69,32,0.003382353,515626,0.58157681
4942,236,463,69,32,0.003382353,515695,0.581654636
4014,230,529,69,32,0.003382353,515764,0.581732461
4005,380,497,69,32,0.003382353,515833,0.581810286
2490,6,471,69,32,0.003382353,515902,0.581888112
5031,68,29,69,32,0.003382353,515971,0.581965937
2079,313,674,69,32,0.003382353,516040,0.582043763
3376,558,331,69,32,0.003382353,516109,0.582121588
5236,663,475,69,32,0.003382353,516178,0.582199413
2833,532,10,69,32,0.003382353,516247,0.582277239
3927,588,14,69,32,0.003382353,516316,0.582355064
2127,12,353,69,32,0.003382353,516385,0.58243289
1851,609,105,69,32,0.003382353,516454,0.582510715
3870,394,250,69,32,0.003382353,516523,0.58258854
4538,588,34,68,32,0.003333333,516591,0.582665238
5094,528,394,68,32,0.003333333,516659,0.582741935
2723,443,335,68,32,0.003333333,516727,0.582818633
2798,105,25,68,32,0.003333333,516795,0.58289533
4997,471,310,68,32,0.003333333,516863,0.582972028
3874,280,596,68,32,0.003333333,516931,0.583048725
1361,280,314,68,32,0.003333333,516999,0.583125423
3137,26,367,68,32,0.003333333,517067,0.58320212
1787,16,123,68,32,0.003333333,517135,0.583278818
3245,16,107,68,32,0.003333333,517203,0.583355515
2494,310,9,68,32,0.003333333,517271,0.583432213
3383,33,219,67,32,0.003284314,517338,0.583507783
3213,473,674,67,32,0.003284314,517405,0.583583352
3574,475,230,67,32,0.003284314,517472,0.583658922
1598,582,26,67,32,0.003284314,517539,0.583734491
2873,230,158,67,32,0.003284314,517606,0.583810061
3453,558,10,67,32,0.003284314,517673,0.58388563
3451,353,68,66,32,0.003235294,517739,0.583960072
2946,379,498,66,32,0.003235294,517805,0.584034514
3511,522,655,66,32,0.003235294,517871,0.584108956
3057,156,558,66,32,0.003235294,517937,0.584183397
5674,588,614,66,32,0.003235294,518003,0.584257839
2108,532,77,66,32,0.003235294,518069,0.584332281
2347,295,302,66,32,0.003235294,518135,0.584406722
5958,230,117,65,32,0.003186275,518200,0.584480036
2229,443,582,65,32,0.003186275,518265,0.58455335
2169,640,473,65,32,0.003186275,518330,0.584626664
4733,26,68,65,32,0.003186275,518395,0.584699977
3328,32,596,65,32,0.003186275,518460,0.584773291
3745,311,385,65,32,0.003186275,518525,0.584846605
2683,123,498,65,32,0.003186275,518590,0.584919919
3588,673,230,64,32,0.003137255,518654,0.584992105
4154,224,562,64,32,0.003137255,518718,0.585064291
5406,328,398,64,32,0.003137255,518782,0.585136476
5557,380,646,64,32,0.003137255,518846,0.585208662
5340,471,16,64,32,0.003137255,518910,0.585280848
3791,3,348,64,32,0.003137255,518974,0.585353034
2656,77,562,64,32,0.003137255,519038,0.58542522
3096,12,105,64,32,0.003137255,519102,0.585497406
3465,80,264,64,32,0.003137255,519166,0.585569592
3339,588,535,63,32,0.003088235,519229,0.58564065
3224,224,50,63,32,0.003088235,519292,0.585711708
5631,479,439,63,32,0.003088235,519355,0.585782766
3728,123,307,63,32,0.003088235,519418,0.585853824
4402,588,529,63,32,0.003088235,519481,0.585924882
3020,10,586,63,32,0.003088235,519544,0.58599594
2698,50,105,63,32,0.003088235,519607,0.586066998
4189,588,443,63,32,0.003088235,519670,0.586138055
4603,313,5,62,32,0.003039216,519732,0.586207986
2754,353,32,62,32,0.003039216,519794,0.586277916
4181,193,30,62,32,0.003039216,519856,0.586347846
7121,348,126,62,32,0.003039216,519918,0.586417776
2291,313,243,62,32,0.003039216,519980,0.586487706
9145,121,404,62,32,0.003039216,520042,0.586557636
5439,84,502,62,32,0.003039216,520104,0.586627566
4953,588,5,61,32,0.002990196,520165,0.586696368
5084,588,497,61,32,0.002990196,520226,0.58676517
3226,498,331,61,32,0.002990196,520287,0.586833972
5374,479,463,61,32,0.002990196,520348,0.586902775
4917,535,588,61,32,0.002990196,520409,0.586971577
3472,314,414,61,32,0.002990196,520470,0.587040379
6023,230,121,61,32,0.002990196,520531,0.587109181
2898,280,236,61,32,0.002990196,520592,0.587177983
2922,123,6,61,32,0.002990196,520653,0.587246785
2736,367,10,61,32,0.002990196,520714,0.587315588
3614,367,522,60,32,0.002941176,520774,0.587383262
1643,9,596,60,32,0.002941176,520834,0.587450936
4261,34,9,60,32,0.002941176,520894,0.58751861
3766,354,498,60,32,0.002941176,520954,0.587586285
4754,582,528,59,32,0.002892157,521013,0.587652831
2538,586,84,59,32,0.002892157,521072,0.587719377
5482,224,552,59,32,0.002892157,521131,0.587785924
2805,475,105,59,32,0.002892157,521190,0.58785247
3982,3,394,59,32,0.002892157,521249,0.587919016
5308,367,347,59,32,0.002892157,521308,0.587985563
4128,156,219,59,32,0.002892157,521367,0.588052109
4888,335,514,58,32,0.002843137,521425,0.588117528
2593,295,9,58,32,0.002843137,521483,0.588182946
3900,224,544,58,32,0.002843137,521541,0.588248365
3923,313,328,58,32,0.002843137,521599,0.588313783
3627,479,219,58,32,0.002843137,521657,0.588379201
5184,463,558,58,32,0.002843137,521715,0.58844462
2506,311,334,58,32,0.002843137,521773,0.588510038
7057,117,586,58,32,0.002843137,521831,0.588575457
5926,13,31,58,32,0.002843137,521889,0.588640875
5379,522,723,57,32,0.002794118,521946,0.588705166
2667,302,334,57,32,0.002794118,522003,0.588769456
1674,673,80,57,32,0.002794118,522060,0.588833747
5545,558,367,57,32,0.002794118,522117,0.588898037
5007,347,230,57,32,0.002794118,522174,0.588962328
3517,586,367,57,32,0.002794118,522231,0.589026619
5450,130,479,57,32,0.002794118,522288,0.589090909
4065,414,379,56,32,0.002745098,522344,0.589154072
4346,107,3,56,32,0.002745098,522400,0.589217234
4819,30,33,55,32,0.002696078,522455,0.589279269
3203,380,475,55,32,0.002696078,522510,0.589341304
3681,15,105,55,32,0.002696078,522565,0.589403339
3764,532,68,55,32,0.002696078,522620,0.589465373
2961,673,224,55,32,0.002696078,522675,0.589527408
695,586,80,55,32,0.002696078,522730,0.589589443
4343,367,131,55,32,0.002696078,522785,0.589651478
2060,4,380,54,32,0.002647059,522839,0.589712384
3853,158,105,54,32,0.002647059,522893,0.589773291
3448,394,393,53,32,0.002598039,522946,0.58983307
3925,280,107,53,32,0.002598039,522999,0.589892849
5492,145,230,53,32,0.002598039,523052,0.589952628
5938,50,380,53,32,0.002598039,523105,0.590012407
4116,280,141,53,32,0.002598039,523158,0.590072186
5701,588,661,53,32,0.002598039,523211,0.590131965
3856,673,123,52,32,0.00254902,523263,0.590190616
10845,121,250,51,32,0.0025,523314,0.590248139
5721,30,347,51,32,0.0025,523365,0.590305662
7210,543,295,49,32,0.002401961,523414,0.590360929
7068,473,652,48,32,0.002352941,523462,0.590415069
5534,48,107,48,32,0.002352941,523510,0.590469208
6000,34,471,47,32,0.002303922,523557,0.59052222
7506,48,632,45,32,0.002205882,523602,0.590572975
4707,12,404,45,32,0.002205882,523647,0.590623731
6405,310,130,43,32,0.002107843,523690,0.590672231
6136,10,328,42,32,0.002058824,523732,0.590719603
9959,178,15,36,32,0.001764706,523768,0.590760208
3040,27,392,105,31,0.005147059,523873,0.590878637
3192,80,68,100,31,0.004901961,523973,0.590991428
3995,68,167,97,31,0.004754902,524070,0.591100835
3533,48,313,96,31,0.004705882,524166,0.591209113
1492,105,264,94,31,0.004607843,524260,0.591315136
631,280,80,93,31,0.004558824,524353,0.591420032
2810,1,348,93,31,0.004558824,524446,0.591524927
3258,328,310,92,31,0.004509804,524538,0.591628694
3664,68,508,91,31,0.004460784,524629,0.591731333
2857,348,80,90,31,0.004411765,524719,0.591832845
3298,68,34,89,31,0.004362745,524808,0.591933228
1483,353,77,89,31,0.004362745,524897,0.592033612
1931,532,394,88,31,0.004313725,524985,0.592132867
3183,130,145,88,31,0.004313725,525073,0.592232123
3358,471,224,87,31,0.004264706,525160,0.59233025
3268,27,482,86,31,0.004215686,525246,0.59242725
3717,11,367,86,31,0.004215686,525332,0.59252425
2596,158,498,86,31,0.004215686,525418,0.59262125
3067,77,544,85,31,0.004166667,525503,0.592717122
2802,655,219,85,31,0.004166667,525588,0.592812993
3602,27,4,85,31,0.004166667,525673,0.592908865
2896,27,5,85,31,0.004166667,525758,0.593004737
2808,311,196,83,31,0.004068627,525841,0.593098353
2542,385,27,83,31,0.004068627,525924,0.593191969
1592,295,105,83,31,0.004068627,526007,0.593285585
3264,663,219,83,31,0.004068627,526090,0.593379201
2311,655,498,82,31,0.004019608,526172,0.59347169
4594,236,130,82,31,0.004019608,526254,0.593564178
1756,16,522,82,31,0.004019608,526336,0.593656666
3489,204,15,82,31,0.004019608,526418,0.593749154
2787,529,498,81,31,0.003970588,526499,0.593840514
3840,380,328,81,31,0.003970588,526580,0.593931875
2697,16,243,80,31,0.003921569,526660,0.594022107
2059,367,224,80,31,0.003921569,526740,0.594112339
3697,243,310,79,31,0.003872549,526819,0.594201444
995,393,80,79,31,0.003872549,526898,0.594290548
2913,77,121,79,31,0.003872549,526977,0.594379653
3631,56,224,79,31,0.003872549,527056,0.594468757
2608,498,219,79,31,0.003872549,527135,0.594557861
3839,48,68,79,31,0.003872549,527214,0.594646966
3809,236,348,78,31,0.003823529,527292,0.594734942
3541,27,23,77,31,0.00377451,527369,0.594821791
2463,77,274,77,31,0.00377451,527446,0.59490864
1594,6,9,77,31,0.00377451,527523,0.594995488
4575,131,311,77,31,0.00377451,527600,0.595082337
4373,348,443,77,31,0.00377451,527677,0.595169186
2268,367,394,77,31,0.00377451,527754,0.595256034
4509,204,14,77,31,0.00377451,527831,0.595342883
740,33,80,76,31,0.00372549,527907,0.595428604
3471,314,661,76,31,0.00372549,527983,0.595514324
3551,353,274,76,31,0.00372549,528059,0.595600045
2848,310,498,76,31,0.00372549,528135,0.595685766
2407,10,655,76,31,0.00372549,528211,0.595771487
2617,314,264,75,31,0.003676471,528286,0.595856079
3939,552,224,75,31,0.003676471,528361,0.595940672
2536,632,473,74,31,0.003627451,528435,0.596024137
2338,393,354,74,31,0.003627451,528509,0.596107602
3857,130,497,74,31,0.003627451,528583,0.596191067
3003,2,473,74,31,0.003627451,528657,0.596274532
3194,596,264,74,31,0.003627451,528731,0.596357997
3820,16,15,74,31,0.003627451,528805,0.596441462
4212,6,145,74,31,0.003627451,528879,0.596524927
3670,380,674,73,31,0.003578431,528952,0.596607264
3523,501,219,73,31,0.003578431,529025,0.596689601
3864,558,295,73,31,0.003578431,529098,0.596771938
2154,313,334,73,31,0.003578431,529171,0.596854275
5172,68,385,73,31,0.003578431,529244,0.596936612
3216,708,348,73,31,0.003578431,529317,0.597018949
3637,230,674,73,31,0.003578431,529390,0.597101286
3173,443,596,73,31,0.003578431,529463,0.597183623
1303,638,314,72,31,0.003529412,529535,0.597264832
3949,236,497,72,31,0.003529412,529607,0.597346041
3918,224,674,72,31,0.003529412,529679,0.59742725
3100,56,334,72,31,0.003529412,529751,0.597508459
3977,107,347,72,31,0.003529412,529823,0.597589668
4103,68,655,72,31,0.003529412,529895,0.597670878
2762,224,3,72,31,0.003529412,529967,0.597752087
4145,68,26,72,31,0.003529412,530039,0.597833296
2039,414,394,72,31,0.003529412,530111,0.597914505
3430,26,514,72,31,0.003529412,530183,0.597995714
2064,609,77,72,31,0.003529412,530255,0.598076923
3032,280,230,72,31,0.003529412,530327,0.598158132
3694,529,596,72,31,0.003529412,530399,0.598239341
2069,32,479,71,31,0.003480392,530470,0.598319423
3138,473,353,71,31,0.003480392,530541,0.598399504
3481,473,632,71,31,0.003480392,530612,0.598479585
3395,11,609,71,31,0.003480392,530683,0.598559666
1999,632,314,71,31,0.003480392,530754,0.598639747
3638,5,6,71,31,0.003480392,530825,0.598719829
3763,27,12,70,31,0.003431373,530895,0.598798782
3749,314,552,70,31,0.003431373,530965,0.598877735
5725,84,614,70,31,0.003431373,531035,0.598956688
3360,1,196,70,31,0.003431373,531105,0.599035642
3436,250,393,70,31,0.003431373,531175,0.599114595
3319,380,614,70,31,0.003431373,531245,0.599193548
2449,34,314,70,31,0.003431373,531315,0.599272502
2587,522,84,70,31,0.003431373,531385,0.599351455
4633,123,250,70,31,0.003431373,531455,0.599430408
2770,311,674,70,31,0.003431373,531525,0.599509362
4553,68,632,70,31,0.003431373,531595,0.599588315
4476,236,31,69,31,0.003382353,531664,0.59966614
1378,596,77,69,31,0.003382353,531733,0.599743966
3011,25,529,69,31,0.003382353,531802,0.599821791
2444,582,14,69,31,0.003382353,531871,0.599899617
2230,280,265,69,31,0.003382353,531940,0.599977442
4167,3,11,69,31,0.003382353,532009,0.600055267
3824,107,328,69,31,0.003382353,532078,0.600133093
3620,130,243,69,31,0.003382353,532147,0.600210918
3616,32,167,69,31,0.003382353,532216,0.600288744
1170,9,6,68,31,0.003333333,532284,0.600365441
3641,335,265,68,31,0.003333333,532352,0.600442139
3348,107,404,68,31,0.003333333,532420,0.600518836
3394,204,473,68,31,0.003333333,532488,0.600595533
3450,331,497,68,31,0.003333333,532556,0.600672231
1736,638,582,68,31,0.003333333,532624,0.600748928
1836,367,123,68,31,0.003333333,532692,0.600825626
1228,397,314,68,31,0.003333333,532760,0.600902323
4672,302,347,68,31,0.003333333,532828,0.600979021
4022,596,385,68,31,0.003333333,532896,0.601055718
3819,535,311,67,31,0.003284314,532963,0.601131288
2342,16,48,67,31,0.003284314,533030,0.601206858
2987,532,497,67,31,0.003284314,533097,0.601282427
3379,313,479,67,31,0.003284314,533164,0.601357997
2941,196,32,67,31,0.003284314,533231,0.601433566
4767,68,280,67,31,0.003284314,533298,0.601509136
4385,105,482,67,31,0.003284314,533365,0.601584706
3720,25,243,67,31,0.003284314,533432,0.601660275
4494,236,404,67,31,0.003284314,533499,0.601735845
5041,16,242,67,31,0.003284314,533566,0.601811414
4387,479,15,66,31,0.003235294,533632,0.601885856
3316,48,354,66,31,0.003235294,533698,0.601960298
2677,302,131,66,31,0.003235294,533764,0.602034739
2854,295,230,66,31,0.003235294,533830,0.602109181
3935,588,204,66,31,0.003235294,533896,0.602183623
4945,514,443,65,31,0.003186275,533961,0.602256937
3904,6,219,65,31,0.003186275,534026,0.60233025
4674,131,145,65,31,0.003186275,534091,0.602403564
2134,582,497,65,31,0.003186275,534156,0.602476878
4094,443,243,65,31,0.003186275,534221,0.602550192
3784,123,348,65,31,0.003186275,534286,0.602623506
5070,354,558,65,31,0.003186275,534351,0.602696819
2360,313,535,65,31,0.003186275,534416,0.602770133
2661,295,380,65,31,0.003186275,534481,0.602843447
4258,414,397,65,31,0.003186275,534546,0.602916761
6904,68,517,65,31,0.003186275,534611,0.602990074
4981,48,588,65,31,0.003186275,534676,0.603063388
3380,131,302,65,31,0.003186275,534741,0.603136702
4580,10,250,65,31,0.003186275,534806,0.603210016
4151,311,501,64,31,0.003137255,534870,0.603282202
4138,314,294,64,31,0.003137255,534934,0.603354388
3867,80,265,64,31,0.003137255,534998,0.603426573
4063,250,379,64,31,0.003137255,535062,0.603498759
4172,632,68,64,31,0.003137255,535126,0.603570945
3855,3,558,64,31,0.003137255,535190,0.603643131
4663,328,230,64,31,0.003137255,535254,0.603715317
3808,224,475,64,31,0.003137255,535318,0.603787503
3343,398,84,64,31,0.003137255,535382,0.603859689
3374,107,32,64,31,0.003137255,535446,0.603931875
3418,16,6,64,31,0.003137255,535510,0.60400406
3180,475,16,64,31,0.003137255,535574,0.604076246
2488,596,230,64,31,0.003137255,535638,0.604148432
3009,123,11,64,31,0.003137255,535702,0.604220618
2830,663,353,64,31,0.003137255,535766,0.604292804
3852,397,655,63,31,0.003088235,535829,0.604363862
4604,236,471,63,31,0.003088235,535892,0.60443492
2660,393,311,63,31,0.003088235,535955,0.604505978
5097,348,614,63,31,0.003088235,536018,0.604577036
3251,16,532,63,31,0.003088235,536081,0.604648094
1869,302,311,63,31,0.003088235,536144,0.604719152
2947,398,354,63,31,0.003088235,536207,0.60479021
4249,1,347,63,31,0.003088235,536270,0.604861268
6551,663,427,63,31,0.003088235,536333,0.604932326
4304,2,31,63,31,0.003088235,536396,0.605003384
4104,196,204,63,31,0.003088235,536459,0.605074442
3558,274,443,63,31,0.003088235,536522,0.6051455
5037,68,543,62,31,0.003039216,536584,0.60521543
5683,528,310,62,31,0.003039216,536646,0.60528536
2713,311,26,62,31,0.003039216,536708,0.60535529
2778,10,158,62,31,0.003039216,536770,0.60542522
2544,302,48,62,31,0.003039216,536832,0.60549515
2817,475,123,62,31,0.003039216,536894,0.60556508
4084,353,398,62,31,0.003039216,536956,0.60563501
4297,30,204,62,31,0.003039216,537018,0.60570494
5708,34,347,62,31,0.003039216,537080,0.60577487
5195,131,471,62,31,0.003039216,537142,0.6058448
5282,123,54,62,31,0.003039216,537204,0.60591473
3825,243,397,61,31,0.002990196,537265,0.605983533
3085,10,15,61,31,0.002990196,537326,0.606052335
4400,335,605,61,31,0.002990196,537387,0.606121137
3235,558,48,61,31,0.002990196,537448,0.606189939
3266,50,335,61,31,0.002990196,537509,0.606258741
2573,674,32,61,31,0.002990196,537570,0.606327543
3364,558,663,61,31,0.002990196,537631,0.606396346
3905,582,117,61,31,0.002990196,537692,0.606465148
4420,586,310,61,31,0.002990196,537753,0.60653395
2000,443,158,61,31,0.002990196,537814,0.606602752
2370,473,334,61,31,0.002990196,537875,0.606671554
3591,379,596,61,31,0.002990196,537936,0.606740356
2797,367,473,60,31,0.002941176,537996,0.606808031
1769,379,353,60,31,0.002941176,538056,0.606875705
4347,33,723,60,31,0.002941176,538116,0.606943379
4704,243,596,60,31,0.002941176,538176,0.607011053
2852,77,170,60,31,0.002941176,538236,0.607078728
3770,708,196,60,31,0.002941176,538296,0.607146402
3277,84,219,60,31,0.002941176,538356,0.607214076
1496,9,532,60,31,0.002941176,538416,0.607281751
5093,588,328,60,31,0.002941176,538476,0.607349425
6352,196,367,59,31,0.002892157,538535,0.607415971
3375,250,311,59,31,0.002892157,538594,0.607482517
4533,114,335,59,31,0.002892157,538653,0.607549064
2801,26,265,59,31,0.002892157,538712,0.60761561
3342,614,655,59,31,0.002892157,538771,0.607682157
2602,105,117,59,31,0.002892157,538830,0.607748703
3142,514,16,59,31,0.002892157,538889,0.607815249
4990,80,385,59,31,0.002892157,538948,0.607881796
4508,328,394,59,31,0.002892157,539007,0.607948342
3196,3,353,59,31,0.002892157,539066,0.608014888
5242,354,443,59,31,0.002892157,539125,0.608081435
5949,80,347,58,31,0.002843137,539183,0.608146853
3310,48,393,58,31,0.002843137,539241,0.608212272
3677,107,532,58,31,0.002843137,539299,0.60827769
3958,640,230,58,31,0.002843137,539357,0.608343109
1585,9,26,58,31,0.002843137,539415,0.608408527
2398,6,588,58,31,0.002843137,539473,0.608473945
2979,16,236,58,31,0.002843137,539531,0.608539364
3253,123,663,58,31,0.002843137,539589,0.608604782
1808,586,105,58,31,0.002843137,539647,0.608670201
5211,130,141,57,31,0.002794118,539704,0.608734491
5245,163,26,57,31,0.002794118,539761,0.608798782
4880,522,674,57,31,0.002794118,539818,0.608863072
2911,307,224,57,31,0.002794118,539875,0.608927363
4634,354,48,57,31,0.002794118,539932,0.608991654
1147,655,158,57,31,0.002794118,539989,0.609055944
4764,224,265,57,31,0.002794118,540046,0.609120235
3895,522,586,57,31,0.002794118,540103,0.609184525
5269,517,16,56,31,0.002745098,540159,0.609247688
4115,84,68,56,31,0.002745098,540215,0.60931085
4237,313,528,56,31,0.002745098,540271,0.609374013
5131,307,354,56,31,0.002745098,540327,0.609437176
3756,367,3,56,31,0.002745098,540383,0.609500338
3909,558,655,56,31,0.002745098,540439,0.609563501
6810,463,544,56,31,0.002745098,540495,0.609626664
3674,379,48,56,31,0.002745098,540551,0.609689826
5243,130,107,55,31,0.002696078,540606,0.609751861
5489,13,348,55,31,0.002696078,540661,0.609813896
4935,475,14,55,31,0.002696078,540716,0.609875931
4988,130,463,55,31,0.002696078,540771,0.609937965
4629,663,11,55,31,0.002696078,540826,0.61
4559,463,33,55,31,0.002696078,540881,0.610062035
4414,250,354,55,31,0.002696078,540936,0.610124069
5230,310,609,55,31,0.002696078,540991,0.610186104
4480,311,265,55,31,0.002696078,541046,0.610248139
4453,517,105,55,31,0.002696078,541101,0.610310174
4496,353,473,54,31,0.002647059,541155,0.610371081
8270,140,609,54,31,0.002647059,541209,0.610431987
6372,354,347,54,31,0.002647059,541263,0.610492894
2586,529,380,54,31,0.002647059,541317,0.610553801
5783,609,243,54,31,0.002647059,541371,0.610614708
5148,114,334,54,31,0.002647059,541425,0.610675615
5825,331,517,54,31,0.002647059,541479,0.610736522
6331,68,126,54,31,0.002647059,541533,0.610797428
6910,131,723,54,31,0.002647059,541587,0.610858335
3300,84,123,53,31,0.002598039,541640,0.610918114
5984,230,385,53,31,0.002598039,541693,0.610977893
5059,114,582,53,31,0.002598039,541746,0.611037672
6297,16,274,53,31,0.002598039,541799,0.611097451
5694,328,11,53,31,0.002598039,541852,0.61115723
6150,397,328,53,31,0.002598039,541905,0.611217009
5605,535,596,53,31,0.002598039,541958,0.611276788
5050,558,497,52,31,0.00254902,542010,0.611335439
3487,105,605,52,31,0.00254902,542062,0.61139409
2772,582,398,52,31,0.00254902,542114,0.611452741
4858,307,230,52,31,0.00254902,542166,0.611511392
5668,27,673,52,31,0.00254902,542218,0.611570043
3476,529,532,52,31,0.00254902,542270,0.611628694
7368,121,331,52,31,0.00254902,542322,0.611687345
4248,30,479,52,31,0.00254902,542374,0.611745996
7504,4,404,51,31,0.0025,542425,0.611803519
6020,105,126,51,31,0.0025,542476,0.611861042
2789,280,379,51,31,0.0025,542527,0.611918565
4608,33,14,50,31,0.00245098,542577,0.611974961
7029,145,97,50,31,0.00245098,542627,0.612031356
4958,107,265,50,31,0.00245098,542677,0.612087751
2004,295,123,50,31,0.00245098,542727,0.612144146
5171,558,443,50,31,0.00245098,542777,0.612200541
4210,10,196,50,31,0.00245098,542827,0.612256937
3514,507,27,50,31,0.00245098,542877,0.612313332
5104,394,588,50,31,0.00245098,542927,0.612369727
3546,26,10,49,31,0.002401961,542976,0.612424994
6256,114,107,49,31,0.002401961,543025,0.612480262
5421,10,121,49,31,0.002401961,543074,0.612535529
5291,30,31,49,31,0.002401961,543123,0.612590796
4377,27,593,49,31,0.002401961,543172,0.612646064
3528,404,105,48,31,0.002352941,543220,0.612700203
6180,131,141,47,31,0.002303922,543267,0.612753215
4512,230,439,47,31,0.002303922,543314,0.612806226
7277,224,414,47,31,0.002303922,543361,0.612859238
5357,230,22,46,31,0.002254902,543407,0.612911121
5839,313,543,46,31,0.002254902,543453,0.612963005
2998,638,123,46,31,0.002254902,543499,0.613014888
6286,535,31,46,31,0.002254902,543545,0.613066772
5069,393,473,45,31,0.002205882,543590,0.613117528
5461,33,97,45,31,0.002205882,543635,0.613168283
6224,236,689,44,31,0.002156863,543679,0.613217911
4996,562,380,44,31,0.002156863,543723,0.613267539
5891,655,596,43,31,0.002107843,543766,0.613316039
3594,10,723,43,31,0.002107843,543809,0.613364539
5276,311,242,40,31,0.001960784,543849,0.613409655
7787,663,22,39,31,0.001911765,543888,0.613453643
9526,97,250,39,31,0.001911765,543927,0.613497631
9130,383,655,35,31,0.001715686,543962,0.613537108
2749,348,723,108,30,0.005294118,544070,0.613658922
4075,535,48,89,30,0.004362745,544159,0.613759305
2522,393,353,88,30,0.004313725,544247,0.613858561
2435,224,84,85,30,0.004166667,544332,0.613954433
1388,443,394,84,30,0.004117647,544416,0.614049177
2509,193,31,84,30,0.004117647,544500,0.614143921
4264,230,463,83,30,0.004068627,544583,0.614237537
2100,609,331,83,30,0.004068627,544666,0.614331153
3077,224,689,82,30,0.004019608,544748,0.614423641
4070,68,107,82,30,0.004019608,544830,0.614516129
3577,367,535,81,30,0.003970588,544911,0.614607489
2938,204,33,80,30,0.003921569,544991,0.614697722
3106,107,11,80,30,0.003921569,545071,0.614787954
2399,379,10,79,30,0.003872549,545150,0.614877058
5017,131,689,79,30,0.003872549,545229,0.614966163
2241,123,379,79,30,0.003872549,545308,0.615055267
2864,6,68,78,30,0.003823529,545386,0.615143244
1177,9,655,78,30,0.003823529,545464,0.61523122
3078,56,367,77,30,0.00377451,545541,0.615318069
3601,473,250,76,30,0.00372549,545617,0.61540379
3609,230,97,76,30,0.00372549,545693,0.61548951
4243,427,27,76,30,0.00372549,545769,0.615575231
2020,32,588,76,30,0.00372549,545845,0.615660952
2842,498,310,76,30,0.00372549,545921,0.615746673
4527,230,264,76,30,0.00372549,545997,0.615832393
2682,397,16,76,30,0.00372549,546073,0.615918114
3303,6,723,75,30,0.003676471,546148,0.616002707
2919,107,498,75,30,0.003676471,546223,0.6160873
3639,609,394,74,30,0.003627451,546297,0.616170765
4735,22,498,74,30,0.003627451,546371,0.61625423
2395,32,97,74,30,0.003627451,546445,0.616337695
1788,11,582,74,30,0.003627451,546519,0.616421159
2599,302,313,74,30,0.003627451,546593,0.616504624
4947,348,34,74,30,0.003627451,546667,0.616588089
674,302,34,73,30,0.003578431,546740,0.616670426
5139,517,473,73,30,0.003578431,546813,0.616752763
4042,348,334,72,30,0.003529412,546885,0.616833972
4423,48,479,72,30,0.003529412,546957,0.616915182
3562,3,397,72,30,0.003529412,547029,0.616996391
3454,10,596,72,30,0.003529412,547101,0.6170776
2143,6,479,72,30,0.003529412,547173,0.617158809
2703,145,105,72,30,0.003529412,547245,0.617240018
3069,367,84,71,30,0.003480392,547316,0.617320099
1018,30,20,71,30,0.003480392,547387,0.61740018
2149,498,26,71,30,0.003480392,547458,0.617480262
2153,123,311,71,30,0.003480392,547529,0.617560343
1196,501,158,70,30,0.003431373,547599,0.617639296
5182,230,130,70,30,0.003431373,547669,0.617718249
3684,463,310,70,30,0.003431373,547739,0.617797203
3398,3,131,70,30,0.003431373,547809,0.617876156
2752,311,328,70,30,0.003431373,547879,0.617955109
2959,380,463,70,30,0.003431373,547949,0.618034063
1448,397,354,70,30,0.003431373,548019,0.618113016
2746,145,582,70,30,0.003431373,548089,0.618191969
4605,11,655,69,30,0.003382353,548158,0.618269795
3989,588,236,69,30,0.003382353,548227,0.61834762
4160,3,663,69,30,0.003382353,548296,0.618425446
2165,131,80,68,30,0.003333333,548364,0.618502143
2897,15,224,68,30,0.003333333,548432,0.618578841
2330,397,9,68,30,0.003333333,548500,0.618655538
1554,689,27,68,30,0.003333333,548568,0.618732236
2273,331,404,68,30,0.003333333,548636,0.618808933
4777,414,310,68,30,0.003333333,548704,0.61888563
3144,105,20,68,30,0.003333333,548772,0.618962328
3740,588,596,68,30,0.003333333,548840,0.619039025
4737,14,131,68,30,0.003333333,548908,0.619115723
2451,6,334,68,30,0.003333333,548976,0.61919242
3223,33,638,67,30,0.003284314,549043,0.61926799
2992,84,414,67,30,0.003284314,549110,0.61934356
1710,123,397,67,30,0.003284314,549177,0.619419129
3409,380,295,67,30,0.003284314,549244,0.619494699
2186,32,196,67,30,0.003284314,549311,0.619570268
4318,354,398,67,30,0.003284314,549378,0.619645838
4185,443,501,67,30,0.003284314,549445,0.619721408
4389,236,15,67,30,0.003284314,549512,0.619796977
4669,145,15,66,30,0.003235294,549578,0.619871419
3775,295,10,66,30,0.003235294,549644,0.619945861
3191,331,242,66,30,0.003235294,549710,0.620020302
2950,532,367,66,30,0.003235294,549776,0.620094744
3267,9,427,66,30,0.003235294,549842,0.620169186
2695,655,224,66,30,0.003235294,549908,0.620243627
3015,558,353,66,30,0.003235294,549974,0.620318069
4478,502,16,66,30,0.003235294,550040,0.620392511
4479,131,15,66,30,0.003235294,550106,0.620466952
4774,68,427,66,30,0.003235294,550172,0.620541394
2969,123,394,66,30,0.003235294,550238,0.620615836
4656,596,414,66,30,0.003235294,550304,0.620690277
5969,348,243,66,30,0.003235294,550370,0.620764719
3719,379,609,65,30,0.003186275,550435,0.620838033
2985,310,394,65,30,0.003186275,550500,0.620911347
5299,522,348,65,30,0.003186275,550565,0.620984661
4035,48,353,65,30,0.003186275,550630,0.621057974
3421,193,6,65,30,0.003186275,550695,0.621131288
2393,56,80,65,30,0.003186275,550760,0.621204602
2328,280,84,65,30,0.003186275,550825,0.621277916
2921,532,331,65,30,0.003186275,550890,0.621351229
3595,393,443,65,30,0.003186275,550955,0.621424543
5486,348,498,64,30,0.003137255,551019,0.621496729
3894,354,131,64,30,0.003137255,551083,0.621568915
4224,582,544,64,30,0.003137255,551147,0.621641101
2648,379,11,64,30,0.003137255,551211,0.621713287
3091,16,33,64,30,0.003137255,551275,0.621785473
1471,9,723,64,30,0.003137255,551339,0.621857658
3233,32,508,64,30,0.003137255,551403,0.621929844
2965,30,6,64,30,0.003137255,551467,0.62200203
2389,397,379,64,30,0.003137255,551531,0.622074216
2916,32,11,64,30,0.003137255,551595,0.622146402
3921,522,295,63,30,0.003088235,551658,0.62221746
3150,131,335,63,30,0.003088235,551721,0.622288518
2026,32,638,63,30,0.003088235,551784,0.622359576
3425,588,145,63,30,0.003088235,551847,0.622430634
5562,68,497,63,30,0.003088235,551910,0.622501692
3952,33,95,63,30,0.003088235,551973,0.62257275
3211,16,663,63,30,0.003088235,552036,0.622643808
5583,10,427,63,30,0.003088235,552099,0.622714866
2888,6,64,63,30,0.003088235,552162,0.622785924
4118,543,219,63,30,0.003088235,552225,0.622856982
4277,522,475,63,30,0.003088235,552288,0.62292804
3955,379,588,63,30,0.003088235,552351,0.622999098
3956,562,582,63,30,0.003088235,552414,0.623070156
3093,11,394,63,30,0.003088235,552477,0.623141214
4214,131,236,63,30,0.003088235,552540,0.623212272
4929,56,302,62,30,0.003039216,552602,0.623282202
2914,582,141,62,30,0.003039216,552664,0.623352132
6449,68,609,62,30,0.003039216,552726,0.623422062
4226,236,95,62,30,0.003039216,552788,0.623491992
4187,56,473,62,30,0.003039216,552850,0.623561922
3709,310,31,62,30,0.003039216,552912,0.623631852
3302,32,475,62,30,0.003039216,552974,0.623701782
4539,335,392,62,30,0.003039216,553036,0.623771712
3996,295,219,62,30,0.003039216,553098,0.623841642
4025,479,50,62,30,0.003039216,553160,0.623911572
3887,224,22,62,30,0.003039216,553222,0.623981502
5918,131,14,62,30,0.003039216,553284,0.624051432
4849,328,224,62,30,0.003039216,553346,0.624121363
2080,33,311,62,30,0.003039216,553408,0.624191293
4724,158,380,61,30,0.002990196,553469,0.624260095
5261,13,32,61,30,0.002990196,553530,0.624328897
4156,394,596,61,30,0.002990196,553591,0.624397699
3621,311,264,61,30,0.002990196,553652,0.624466501
3751,33,307,61,30,0.002990196,553713,0.624535303
3199,439,314,61,30,0.002990196,553774,0.624604106
3155,367,443,61,30,0.002990196,553835,0.624672908
4452,443,242,61,30,0.002990196,553896,0.62474171
3686,236,3,61,30,0.002990196,553957,0.624810512
3352,663,334,61,30,0.002990196,554018,0.624879314
3698,311,130,61,30,0.002990196,554079,0.624948116
4001,313,34,61,30,0.002990196,554140,0.625016919
3844,16,265,60,30,0.002941176,554200,0.625084593
2844,193,196,60,30,0.002941176,554260,0.625152267
2675,9,463,60,30,0.002941176,554320,0.625219941
4222,380,307,60,30,0.002941176,554380,0.625287616
4253,84,131,60,30,0.002941176,554440,0.62535529
3676,582,54,60,30,0.002941176,554500,0.625422964
5073,348,394,60,30,0.002941176,554560,0.625490638
5033,230,414,60,30,0.002941176,554620,0.625558313
3658,80,97,60,30,0.002941176,554680,0.625625987
2887,328,314,59,30,0.002892157,554739,0.625692533
2932,393,77,59,30,0.002892157,554798,0.62575908
4395,674,95,59,30,0.002892157,554857,0.625825626
1521,32,334,59,30,0.002892157,554916,0.625892172
5030,354,50,59,30,0.002892157,554975,0.625958719
3133,105,64,59,30,0.002892157,555034,0.626025265
5544,130,25,59,30,0.002892157,555093,0.626091811
3464,77,56,59,30,0.002892157,555152,0.626158358
2499,16,354,59,30,0.002892157,555211,0.626224904
3786,501,394,59,30,0.002892157,555270,0.62629145
3208,582,56,59,30,0.002892157,555329,0.626357997
4834,3,347,59,30,0.002892157,555388,0.626424543
4232,394,107,59,30,0.002892157,555447,0.62649109
4002,10,609,58,30,0.002843137,555505,0.626556508
3695,532,311,58,30,0.002843137,555563,0.626621926
5485,354,295,58,30,0.002843137,555621,0.626687345
1685,313,443,58,30,0.002843137,555679,0.626752763
4591,219,68,58,30,0.002843137,555737,0.626818182
3780,302,68,58,30,0.002843137,555795,0.6268836
2455,397,311,58,30,0.002843137,555853,0.626949019
2806,280,264,58,30,0.002843137,555911,0.627014437
6398,522,170,58,30,0.002843137,555969,0.627079856
2835,393,230,58,30,0.002843137,556027,0.627145274
4397,95,471,58,30,0.002843137,556085,0.627210693
3372,473,596,58,30,0.002843137,556143,0.627276111
4328,6,632,58,30,0.002843137,556201,0.627341529
5186,596,347,58,30,0.002843137,556259,0.627406948
5388,552,33,57,30,0.002794118,556316,0.627471238
5389,204,310,57,30,0.002794118,556373,0.627535529
4419,12,224,57,30,0.002794118,556430,0.62759982
5567,236,242,57,30,0.002794118,556487,0.62766411
4832,463,131,57,30,0.002794118,556544,0.627728401
4943,596,522,57,30,0.002794118,556601,0.627792691
3301,6,311,57,30,0.002794118,556658,0.627856982
3499,26,107,57,30,0.002794118,556715,0.627921272
5527,414,609,57,30,0.002794118,556772,0.627985563
5459,463,588,57,30,0.002794118,556829,0.628049853
5188,347,16,57,30,0.002794118,556886,0.628114144
4356,498,68,57,30,0.002794118,556943,0.628178434
4710,130,393,57,30,0.002794118,557000,0.628242725
4736,335,560,57,30,0.002794118,557057,0.628307016
4595,328,16,57,30,0.002794118,557114,0.628371306
4593,535,313,57,30,0.002794118,557171,0.628435597
5285,131,532,56,30,0.002745098,557227,0.628498759
4270,26,558,56,30,0.002745098,557283,0.628561922
3535,532,274,56,30,0.002745098,557339,0.628625085
3530,310,663,56,30,0.002745098,557395,0.628688247
4117,502,380,56,30,0.002745098,557451,0.62875141
3525,16,471,56,30,0.002745098,557507,0.628814573
4883,463,331,56,30,0.002745098,557563,0.628877735
3156,236,158,56,30,0.002745098,557619,0.628940898
5768,224,708,56,30,0.002745098,557675,0.62900406
4900,16,22,56,30,0.002745098,557731,0.629067223
4003,16,50,56,30,0.002745098,557787,0.629130386
3369,638,16,56,30,0.002745098,557843,0.629193548
7032,514,596,56,30,0.002745098,557899,0.629256711
7299,124,27,56,30,0.002745098,557955,0.629319874
2867,498,230,55,30,0.002696078,558010,0.629381908
5776,535,385,55,30,0.002696078,558065,0.629443943
5119,473,280,55,30,0.002696078,558120,0.629505978
3630,6,50,55,30,0.002696078,558175,0.629568013
2390,331,95,55,30,0.002696078,558230,0.629630047
1480,196,20,55,30,0.002696078,558285,0.629692082
4028,674,463,55,30,0.002696078,558340,0.629754117
6037,145,347,55,30,0.002696078,558395,0.629816152
3422,2,588,55,30,0.002696078,558450,0.629878186
4050,5,473,55,30,0.002696078,558505,0.629940221
2988,56,9,55,30,0.002696078,558560,0.630002256
4546,497,16,54,30,0.002647059,558614,0.630063163
5409,562,32,54,30,0.002647059,558668,0.630124069
4649,84,501,54,30,0.002647059,558722,0.630184976
4344,219,379,54,30,0.002647059,558776,0.630245883
4449,236,588,54,30,0.002647059,558830,0.63030679
4830,335,544,54,30,0.002647059,558884,0.630367697
4592,522,393,54,30,0.002647059,558938,0.630428604
4372,517,224,54,30,0.002647059,558992,0.63048951
3873,535,354,54,30,0.002647059,559046,0.630550417
3915,80,614,54,30,0.002647059,559100,0.630611324
3871,302,498,54,30,0.002647059,559154,0.630672231
6960,535,404,54,30,0.002647059,559208,0.630733138
3600,443,497,54,30,0.002647059,559262,0.630794045
4016,331,674,54,30,0.002647059,559316,0.630854952
3632,335,246,54,30,0.002647059,559370,0.630915858
5100,5,27,53,30,0.002598039,559423,0.630975637
6784,236,475,53,30,0.002598039,559476,0.631035416
4379,354,313,53,30,0.002598039,559529,0.631095195
4873,522,141,53,30,0.002598039,559582,0.631154974
4872,471,302,53,30,0.002598039,559635,0.631214753
3243,558,335,53,30,0.002598039,559688,0.631274532
5143,224,511,53,30,0.002598039,559741,0.631334311
5712,114,224,53,30,0.002598039,559794,0.63139409
4211,609,353,52,30,0.00254902,559846,0.631452741
4526,84,588,52,30,0.00254902,559898,0.631511392
3497,501,443,52,30,0.00254902,559950,0.631570043
5362,131,394,52,30,0.00254902,560002,0.631628694
3985,48,3,52,30,0.00254902,560054,0.631687345
3858,663,77,52,30,0.00254902,560106,0.631745996
6189,68,171,52,30,0.00254902,560158,0.631804647
6100,29,348,51,30,0.0025,560209,0.63186217
2691,274,314,51,30,0.0025,560260,0.631919693
5563,380,439,51,30,0.0025,560311,0.631977216
7328,114,528,51,30,0.0025,560362,0.632034739
3746,614,353,51,30,0.0025,560413,0.632092263
7412,224,2,51,30,0.0025,560464,0.632149786
3239,640,310,51,30,0.0025,560515,0.632207309
3320,582,614,51,30,0.0025,560566,0.632264832
5063,367,95,51,30,0.0025,560617,0.632322355
4626,3,689,51,30,0.0025,560668,0.632379878
4398,443,107,51,30,0.0025,560719,0.632437401
2865,310,3,51,30,0.0025,560770,0.632494924
2089,582,243,51,30,0.0025,560821,0.632552448
4231,56,588,51,30,0.0025,560872,0.632609971
3649,77,204,50,30,0.00245098,560922,0.632666366
4057,475,224,49,30,0.002401961,560971,0.632721633
6138,95,347,49,30,0.002401961,561020,0.632776901
5498,663,1,49,30,0.002401961,561069,0.632832168
5044,34,348,49,30,0.002401961,561118,0.632887435
3902,331,475,49,30,0.002401961,561167,0.632942702
4437,394,236,49,30,0.002401961,561216,0.63299797
5665,328,10,49,30,0.002401961,561265,0.633053237
4825,347,335,49,30,0.002401961,561314,0.633108504
2696,582,501,49,30,0.002401961,561363,0.633163772
6330,16,708,49,30,0.002401961,561412,0.633219039
6011,114,16,49,30,0.002401961,561461,0.633274306
2790,582,204,49,30,0.002401961,561510,0.633329574
5306,114,230,48,30,0.002352941,561558,0.633383713
2943,32,498,48,30,0.002352941,561606,0.633437852
3187,532,393,48,30,0.002352941,561654,0.633491992
5578,522,280,48,30,0.002352941,561702,0.633546131
8440,328,498,48,30,0.002352941,561750,0.633600271
5971,335,646,48,30,0.002352941,561798,0.63365441
4652,310,689,48,30,0.002352941,561846,0.63370855
6814,498,502,48,30,0.002352941,561894,0.633762689
3831,638,310,47,30,0.002303922,561941,0.6338157
3938,295,379,47,30,0.002303922,561988,0.633868712
4352,9,439,47,30,0.002303922,562035,0.633921723
5873,380,25,46,30,0.002254902,562081,0.633973607
4114,265,655,46,30,0.002254902,562127,0.634025491
4618,393,50,45,30,0.002205882,562172,0.634076246
7757,328,50,45,30,0.002205882,562217,0.634127002
3822,673,331,44,30,0.002156863,562261,0.63417663
8297,511,331,44,30,0.002156863,562305,0.634226258
5877,609,404,43,30,0.002107843,562348,0.634274758
5237,310,280,42,30,0.002058824,562390,0.634322129
6143,10,501,41,30,0.002009804,562431,0.634368374
3919,582,265,41,30,0.002009804,562472,0.634414618
9186,588,25,38,30,0.001862745,562510,0.634457478
10045,543,497,33,30,0.001617647,562543,0.634494699
3149,354,335,88,29,0.004313725,562631,0.634593954
2901,588,15,86,29,0.004215686,562717,0.634690954
3560,68,5,85,29,0.004166667,562802,0.634786826
2820,77,427,81,29,0.003970588,562883,0.634878186
2278,393,394,80,29,0.003921569,562963,0.634968419
2738,708,27,79,29,0.003872549,563042,0.635057523
3659,171,32,78,29,0.003823529,563120,0.6351455
4383,130,640,77,29,0.00377451,563197,0.635232348
3002,367,236,76,29,0.00372549,563273,0.635318069
3557,543,582,76,29,0.00372549,563349,0.63540379
4773,663,544,76,29,0.00372549,563425,0.63548951
2497,479,689,75,29,0.003676471,563500,0.635574103
3585,596,84,73,29,0.003578431,563573,0.63565644
3913,473,11,72,29,0.003529412,563645,0.635737649
3503,310,443,72,29,0.003529412,563717,0.635818859
2796,77,502,71,29,0.003480392,563788,0.63589894
3404,145,380,71,29,0.003480392,563859,0.635979021
4853,3,596,70,29,0.003431373,563929,0.636057974
2501,2,582,70,29,0.003431373,563999,0.636136928
3607,295,204,70,29,0.003431373,564069,0.636215881
4141,663,3,70,29,0.003431373,564139,0.636294834
3293,250,84,69,29,0.003382353,564208,0.63637266
3699,145,219,69,29,0.003382353,564277,0.636450485
5576,131,347,69,29,0.003382353,564346,0.63652831
2383,3,393,69,29,0.003382353,564415,0.636606136
4662,328,250,69,29,0.003382353,564484,0.636683961
2878,156,131,68,29,0.003333333,564552,0.636760659
3962,204,196,68,29,0.003333333,564620,0.636837356
3510,463,380,67,29,0.003284314,564687,0.636912926
1654,30,314,67,29,0.003284314,564754,0.636988495
2793,193,348,67,29,0.003284314,564821,0.637064065
4396,80,663,67,29,0.003284314,564888,0.637139635
4791,348,29,67,29,0.003284314,564955,0.637215204
5517,68,560,67,29,0.003284314,565022,0.637290774
4278,522,97,66,29,0.003235294,565088,0.637365215
4316,404,367,66,29,0.003235294,565154,0.637439657
3185,123,295,66,29,0.003235294,565220,0.637514099
5077,224,560,66,29,0.003235294,565286,0.63758854
4485,310,347,66,29,0.003235294,565352,0.637662982
4067,15,16,66,29,0.003235294,565418,0.637737424
3246,302,31,65,29,0.003186275,565483,0.637810738
3486,522,145,65,29,0.003186275,565548,0.637884051
2052,16,84,65,29,0.003186275,565613,0.637957365
5347,68,250,65,29,0.003186275,565678,0.638030679
4769,311,517,65,29,0.003186275,565743,0.638103993
4441,663,107,64,29,0.003137255,565807,0.638176179
5173,107,528,64,29,0.003137255,565871,0.638248365
4557,414,16,64,29,0.003137255,565935,0.63832055
5127,80,307,64,29,0.003137255,565999,0.638392736
4786,463,31,64,29,0.003137255,566063,0.638464922
5251,3,463,64,29,0.003137255,566127,0.638537108
5325,535,471,64,29,0.003137255,566191,0.638609294
5187,348,3,64,29,0.003137255,566255,0.63868148
1899,397,77,64,29,0.003137255,566319,0.638753666
2381,56,393,64,29,0.003137255,566383,0.638825852
3898,614,498,63,29,0.003088235,566446,0.63889691
5438,130,508,63,29,0.003088235,566509,0.638967968
3788,501,310,63,29,0.003088235,566572,0.639039025
3218,310,558,63,29,0.003088235,566635,0.639110083
3802,32,280,63,29,0.003088235,566698,0.639181141
3198,313,114,63,29,0.003088235,566761,0.639252199
3721,335,64,63,29,0.003088235,566824,0.639323257
6171,236,204,63,29,0.003088235,566887,0.639394315
3550,6,48,63,29,0.003088235,566950,0.639465373
2067,32,307,63,29,0.003088235,567013,0.639536431
4051,11,219,63,29,0.003088235,567076,0.639607489
2838,532,236,63,29,0.003088235,567139,0.639678547
1527,32,331,63,29,0.003088235,567202,0.639749605
1346,558,80,63,29,0.003088235,567265,0.639820663
3981,307,380,63,29,0.003088235,567328,0.639891721
4456,663,236,63,29,0.003088235,567391,0.639962779
3012,393,107,62,29,0.003039216,567453,0.640032709
3129,532,558,62,29,0.003039216,567515,0.640102639
4394,335,708,62,29,0.003039216,567577,0.640172569
4775,230,398,62,29,0.003039216,567639,0.640242499
3821,331,114,62,29,0.003039216,567701,0.64031243
4364,224,501,62,29,0.003039216,567763,0.64038236
3948,379,77,62,29,0.003039216,567825,0.64045229
4573,1,14,62,29,0.003039216,567887,0.64052222
5795,354,15,61,29,0.002990196,567948,0.640591022
2688,26,379,61,29,0.002990196,568009,0.640659824
4299,26,274,61,29,0.002990196,568070,0.640728626
3381,10,26,61,29,0.002990196,568131,0.640797428
3800,335,632,61,29,0.002990196,568192,0.640866231
2702,31,582,61,29,0.002990196,568253,0.640935033
3366,596,131,61,29,0.002990196,568314,0.641003835
6208,171,347,61,29,0.002990196,568375,0.641072637
4586,56,95,61,29,0.002990196,568436,0.641141439
3617,11,9,60,29,0.002941176,568496,0.641209113
3608,2,313,60,29,0.002941176,568556,0.641276788
2650,689,582,60,29,0.002941176,568616,0.641344462
3220,379,311,60,29,0.002941176,568676,0.641412136
5351,552,582,60,29,0.002941176,568736,0.641479811
3143,529,224,60,29,0.002941176,568796,0.641547485
1795,501,582,60,29,0.002941176,568856,0.641615159
4616,473,529,60,29,0.002941176,568916,0.641682833
3750,16,250,60,29,0.002941176,568976,0.641750508
5596,348,393,60,29,0.002941176,569036,0.641818182
3758,130,84,60,29,0.002941176,569096,0.641885856
3868,56,48,59,29,0.002892157,569155,0.641952402
3473,219,230,59,29,0.002892157,569214,0.642018949
3288,311,529,59,29,0.002892157,569273,0.642085495
2730,16,26,59,29,0.002892157,569332,0.642152042
3666,302,95,59,29,0.002892157,569391,0.642218588
3313,16,586,59,29,0.002892157,569450,0.642285134
2763,311,295,59,29,0.002892157,569509,0.642351681
3260,498,532,59,29,0.002892157,569568,0.642418227
3565,331,295,59,29,0.002892157,569627,0.642484773
5729,535,141,59,29,0.002892157,569686,0.64255132
3022,532,596,58,29,0.002843137,569744,0.642616738
4940,11,498,58,29,0.002843137,569802,0.642682157
2466,280,393,58,29,0.002843137,569860,0.642747575
4019,310,250,58,29,0.002843137,569918,0.642812993
4393,380,117,58,29,0.002843137,569976,0.642878412
5504,107,242,58,29,0.002843137,570034,0.64294383
3975,6,558,58,29,0.002843137,570092,0.643009249
1823,582,280,58,29,0.002843137,570150,0.643074667
2991,498,280,58,29,0.002843137,570208,0.643140086
3278,380,348,58,29,0.002843137,570266,0.643205504
2693,532,230,58,29,0.002843137,570324,0.643270923
4788,473,2,58,29,0.002843137,570382,0.643336341
4698,34,14,58,29,0.002843137,570440,0.64340176
4676,204,131,58,29,0.002843137,570498,0.643467178
4109,588,655,58,29,0.002843137,570556,0.643532596
2708,250,314,57,29,0.002794118,570613,0.643596887
4388,33,475,57,29,0.002794118,570670,0.643661178
4468,367,243,57,29,0.002794118,570727,0.643725468
4487,328,9,57,29,0.002794118,570784,0.643789759
3769,280,497,57,29,0.002794118,570841,0.643854049
5556,552,380,57,29,0.002794118,570898,0.64391834
5076,27,383,57,29,0.002794118,570955,0.64398263
5531,84,392,57,29,0.002794118,571012,0.644046921
5047,479,2,57,29,0.002794118,571069,0.644111211
3034,614,105,56,29,0.002745098,571125,0.644174374
2892,310,84,56,29,0.002745098,571181,0.644237537
4405,473,114,56,29,0.002745098,571237,0.644300699
4245,80,3,56,29,0.002745098,571293,0.644363862
4753,522,107,56,29,0.002745098,571349,0.644427025
5785,354,196,56,29,0.002745098,571405,0.644490187
4905,380,15,56,29,0.002745098,571461,0.64455335
4822,219,367,56,29,0.002745098,571517,0.644616513
5939,84,646,56,29,0.002745098,571573,0.644679675
4752,479,313,56,29,0.002745098,571629,0.644742838
3843,84,302,56,29,0.002745098,571685,0.644806
5643,532,347,56,29,0.002745098,571741,0.644869163
5010,522,26,56,29,0.002745098,571797,0.644932326
4517,295,32,56,29,0.002745098,571853,0.644995488
3400,313,250,55,29,0.002696078,571908,0.645057523
5481,393,532,55,29,0.002696078,571963,0.645119558
4122,331,614,55,29,0.002696078,572018,0.645181593
4229,393,609,55,29,0.002696078,572073,0.645243627
3036,10,532,55,29,0.002696078,572128,0.645305662
4587,224,398,55,29,0.002696078,572183,0.645367697
5951,335,552,55,29,0.002696078,572238,0.645429732
3914,397,219,55,29,0.002696078,572293,0.645491766
3974,708,32,55,29,0.002696078,572348,0.645553801
3971,1,105,55,29,0.002696078,572403,0.645615836
4567,517,582,55,29,0.002696078,572458,0.645677871
4579,558,6,55,29,0.002696078,572513,0.645739905
4198,204,16,54,29,0.002647059,572567,0.645800812
2769,84,335,54,29,0.002647059,572621,0.645861719
4221,414,84,54,29,0.002647059,572675,0.645922626
6312,348,64,54,29,0.002647059,572729,0.645983533
4244,498,131,54,29,0.002647059,572783,0.646044439
4370,219,473,54,29,0.002647059,572837,0.646105346
4854,673,32,54,29,0.002647059,572891,0.646166253
4625,105,2,54,29,0.002647059,572945,0.64622716
2469,33,3,54,29,0.002647059,572999,0.646288067
3460,32,655,54,29,0.002647059,573053,0.646348974
2933,443,230,54,29,0.002647059,573107,0.64640988
3777,4,230,54,29,0.002647059,573161,0.646470787
7063,48,674,54,29,0.002647059,573215,0.646531694
3536,367,586,53,29,0.002598039,573268,0.646591473
4552,708,68,53,29,0.002598039,573321,0.646651252
5238,348,84,53,29,0.002598039,573374,0.646711031
6514,48,2,53,29,0.002598039,573427,0.64677081
3703,379,95,53,29,0.002598039,573480,0.646830589
4378,310,295,53,29,0.002598039,573533,0.646890368
2355,280,334,53,29,0.002598039,573586,0.646950147
4627,331,204,53,29,0.002598039,573639,0.647009926
3647,105,683,53,29,0.002598039,573692,0.647069704
4076,123,497,53,29,0.002598039,573745,0.647129483
2975,274,243,53,29,0.002598039,573798,0.647189262
5659,56,398,53,29,0.002598039,573851,0.647249041
3815,586,219,53,29,0.002598039,573904,0.64730882
3747,32,236,53,29,0.002598039,573957,0.647368599
4766,107,141,53,29,0.002598039,574010,0.647428378
2535,397,236,53,29,0.002598039,574063,0.647488157
5710,502,655,52,29,0.00254902,574115,0.647546808
4314,586,243,52,29,0.00254902,574167,0.647605459
2930,558,123,52,29,0.00254902,574219,0.64766411
2461,379,443,52,29,0.00254902,574271,0.647722761
3175,562,335,52,29,0.00254902,574323,0.647781412
2792,11,77,52,29,0.00254902,574375,0.647840063
4273,311,114,52,29,0.00254902,574427,0.647898714
5797,1,95,52,29,0.00254902,574479,0.647957365
3064,331,439,52,29,0.00254902,574531,0.648016016
4664,224,34,52,29,0.00254902,574583,0.648074667
5912,34,230,52,29,0.00254902,574635,0.648133318
7046,130,398,51,29,0.0025,574686,0.648190841
5428,314,22,51,29,0.0025,574737,0.648248365
3170,586,77,51,29,0.0025,574788,0.648305888
1746,4,582,51,29,0.0025,574839,0.648363411
5760,614,522,51,29,0.0025,574890,0.648420934
5733,473,26,51,29,0.0025,574941,0.648478457
4884,130,77,51,29,0.0025,574992,0.64853598
5993,498,558,51,29,0.0025,575043,0.648593503
5053,2,48,51,29,0.0025,575094,0.648651026
3912,33,640,51,29,0.0025,575145,0.64870855
4882,562,558,51,29,0.0025,575196,0.648766073
4279,32,34,51,29,0.0025,575247,0.648823596
6624,117,314,51,29,0.0025,575298,0.648881119
6304,663,114,51,29,0.0025,575349,0.648938642
5386,97,31,51,29,0.0025,575400,0.648996165
4292,123,15,51,29,0.0025,575451,0.649053688
4309,224,25,51,29,0.0025,575502,0.649111211
4376,393,11,51,29,0.0025,575553,0.649168734
4193,26,32,51,29,0.0025,575604,0.649226258
5222,479,196,51,29,0.0025,575655,0.649283781
6520,131,674,51,29,0.0025,575706,0.649341304
4792,34,145,50,29,0.00245098,575756,0.649397699
3636,313,529,50,29,0.00245098,575806,0.649454094
3467,522,236,50,29,0.00245098,575856,0.64951049
3953,353,302,50,29,0.00245098,575906,0.649566885
5610,236,638,50,29,0.00245098,575956,0.64962328
5801,586,596,50,29,0.00245098,576006,0.649679675
10070,80,133,50,29,0.00245098,576056,0.64973607
6056,427,335,50,29,0.00245098,576106,0.649792466
3334,380,638,50,29,0.00245098,576156,0.649848861
5246,243,265,50,29,0.00245098,576206,0.649905256
3661,80,497,50,29,0.00245098,576256,0.649961651
5212,632,16,50,29,0.00245098,576306,0.650018046
4182,84,48,50,29,0.00245098,576356,0.650074442
5856,522,497,50,29,0.00245098,576406,0.650130837
5979,131,638,50,29,0.00245098,576456,0.650187232
4442,145,16,50,29,0.00245098,576506,0.650243627
6392,348,114,50,29,0.00245098,576556,0.650300023
7887,588,517,50,29,0.00245098,576606,0.650356418
4878,84,313,50,29,0.00245098,576656,0.650412813
4332,14,16,49,29,0.002401961,576705,0.65046808
5260,479,236,49,29,0.002401961,576754,0.650523348
3046,302,354,49,29,0.002401961,576803,0.650578615
4317,3,535,49,29,0.002401961,576852,0.650633882
3662,331,479,49,29,0.002401961,576901,0.65068915
5152,335,482,49,29,0.002401961,576950,0.650744417
4612,443,164,49,29,0.002401961,576999,0.650799684
3897,265,243,49,29,0.002401961,577048,0.650854952
6636,328,302,49,29,0.002401961,577097,0.650910219
5232,640,219,49,29,0.002401961,577146,0.650965486
4353,123,77,49,29,0.002401961,577195,0.651020753
4484,274,26,49,29,0.002401961,577244,0.651076021
5777,224,114,49,29,0.002401961,577293,0.651131288
2214,404,80,49,29,0.002401961,577342,0.651186555
4645,331,56,49,29,0.002401961,577391,0.651241823
4247,14,348,49,29,0.002401961,577440,0.65129709
5900,353,130,48,29,0.002352941,577488,0.651351229
4924,522,250,48,29,0.002352941,577536,0.651405369
3773,302,353,48,29,0.002352941,577584,0.651459508
3842,311,97,48,29,0.002352941,577632,0.651513648
3708,313,141,48,29,0.002352941,577680,0.651567787
6703,131,479,48,29,0.002352941,577728,0.651621926
4606,514,280,48,29,0.002352941,577776,0.651676066
5511,2,15,48,29,0.002352941,577824,0.651730205
3458,20,29,48,29,0.002352941,577872,0.651784345
5521,3,427,48,29,0.002352941,577920,0.651838484
7066,479,14,48,29,0.002352941,577968,0.651892624
5773,307,131,47,29,0.002303922,578015,0.651945635
4799,105,392,47,29,0.002303922,578062,0.651998647
2910,394,379,47,29,0.002303922,578109,0.652051658
6345,328,443,47,29,0.002303922,578156,0.65210467
5441,295,663,47,29,0.002303922,578203,0.652157681
4038,393,16,47,29,0.002303922,578250,0.652210693
8285,471,558,47,29,0.002303922,578297,0.652263704
4613,354,535,47,29,0.002303922,578344,0.652316716
4998,10,640,47,29,0.002303922,578391,0.652369727
4283,295,33,47,29,0.002303922,578438,0.652422739
3688,313,158,47,29,0.002303922,578485,0.65247575
5034,498,242,47,29,0.002303922,578532,0.652528762
6987,68,511,47,29,0.002303922,578579,0.652581773
6027,544,10,47,29,0.002303922,578626,0.652634785
8314,552,463,47,29,0.002303922,578673,0.652687796
5149,3,307,46,29,0.002254902,578719,0.65273968
4778,501,32,46,29,0.002254902,578765,0.652791563
6791,22,131,46,29,0.002254902,578811,0.652843447
4581,158,353,46,29,0.002254902,578857,0.65289533
4864,295,196,46,29,0.002254902,578903,0.652947214
4220,331,15,46,29,0.002254902,578949,0.652999098
2471,313,586,46,29,0.002254902,578995,0.653050981
6018,380,613,45,29,0.002205882,579040,0.653101737
3340,313,497,45,29,0.002205882,579085,0.653152493
2646,582,529,45,29,0.002205882,579130,0.653203248
4368,32,141,45,29,0.002205882,579175,0.653254004
6105,230,328,45,29,0.002205882,579220,0.65330476
6325,11,313,45,29,0.002205882,579265,0.653355515
6128,427,380,45,29,0.002205882,579310,0.653406271
4112,394,443,45,29,0.002205882,579355,0.653457027
3587,398,314,45,29,0.002205882,579400,0.653507783
5845,640,708,45,29,0.002205882,579445,0.653558538
6821,663,596,45,29,0.002205882,579490,0.653609294
6846,48,347,45,29,0.002205882,579535,0.65366005
4308,174,27,44,29,0.002156863,579579,0.653709677
4305,394,243,44,29,0.002156863,579623,0.653759305
4689,682,380,44,29,0.002156863,579667,0.653808933
6137,131,156,44,29,0.002156863,579711,0.653858561
5480,56,16,43,29,0.002107843,579754,0.653907061
6704,473,528,42,29,0.002058824,579796,0.653954433
7115,331,613,42,29,0.002058824,579838,0.654001805
5472,331,682,42,29,0.002058824,579880,0.654049177
6778,393,364,42,29,0.002058824,579922,0.654096549
8252,2,463,42,29,0.002058824,579964,0.654143921
4047,367,655,41,29,0.002009804,580005,0.654190165
6031,354,609,41,29,0.002009804,580046,0.654236409
5108,314,511,41,29,0.002009804,580087,0.654282653
6912,348,427,41,29,0.002009804,580128,0.654328897
8102,145,632,41,29,0.002009804,580169,0.654375141
3799,95,32,40,29,0.001960784,580209,0.654420257
6026,15,31,40,29,0.001960784,580249,0.654465373
6443,582,503,38,29,0.001862745,580287,0.654508234
8798,124,15,38,29,0.001862745,580325,0.654551094
6878,32,156,36,29,0.001764706,580361,0.654591699
6985,77,163,35,29,0.001715686,580396,0.654631175
14750,140,54,29,29,0.001421569,580425,0.654663885
3014,145,131,86,28,0.004215686,580511,0.654760884
3270,107,33,76,28,0.00372549,580587,0.654846605
3515,609,84,75,28,0.003676471,580662,0.654931198
3936,535,334,74,28,0.003627451,580736,0.655014663
1800,313,498,73,28,0.003578431,580809,0.655097
3556,302,663,73,28,0.003578431,580882,0.655179337
4547,236,414,72,28,0.003529412,580954,0.655260546
3622,250,353,72,28,0.003529412,581026,0.655341755
1152,9,393,72,28,0.003529412,581098,0.655422964
2764,473,397,71,28,0.003480392,581169,0.655503045
3628,529,219,71,28,0.003480392,581240,0.655583127
3744,674,498,70,28,0.003431373,581310,0.65566208
1258,582,655,69,28,0.003382353,581379,0.655739905
3732,22,27,69,28,0.003382353,581448,0.655817731
4330,230,723,69,28,0.003382353,581517,0.655895556
2640,394,335,68,28,0.003333333,581585,0.655972254
1902,33,354,67,28,0.003284314,581652,0.656047823
3689,34,131,67,28,0.003284314,581719,0.656123393
3539,145,31,66,28,0.003235294,581785,0.656197834
3115,80,26,66,28,0.003235294,581851,0.656272276
5834,27,446,65,28,0.003186275,581916,0.65634559
3885,84,522,64,28,0.003137255,581980,0.656417776
4306,522,689,64,28,0.003137255,582044,0.656489962
4350,219,131,64,28,0.003137255,582108,0.656562148
3359,314,274,64,28,0.003137255,582172,0.656634333
3426,27,195,64,28,0.003137255,582236,0.656706519
3370,313,14,64,28,0.003137255,582300,0.656778705
3131,250,9,63,28,0.003088235,582363,0.656849763
5497,68,398,63,28,0.003088235,582426,0.656920821
2351,501,380,63,28,0.003088235,582489,0.656991879
3678,385,380,63,28,0.003088235,582552,0.657062937
3388,331,427,63,28,0.003088235,582615,0.657133995
5331,219,522,63,28,0.003088235,582678,0.657205053
3053,95,331,63,28,0.003088235,582741,0.657276111
4201,230,114,63,28,0.003088235,582804,0.657347169
3248,314,560,62,28,0.003039216,582866,0.657417099
5595,131,11,62,28,0.003039216,582928,0.657487029
5879,11,107,62,28,0.003039216,582990,0.657556959
3836,380,242,62,28,0.003039216,583052,0.657626889
4717,80,242,61,28,0.002990196,583113,0.657695691
4784,123,347,61,28,0.002990196,583174,0.657764494
4126,34,33,61,28,0.002990196,583235,0.657833296
4391,582,170,61,28,0.002990196,583296,0.657902098
3309,280,586,61,28,0.002990196,583357,0.6579709
3117,398,335,60,28,0.002941176,583417,0.658038574
4746,131,204,60,28,0.002941176,583477,0.658106249
3432,514,219,60,28,0.002941176,583537,0.658173923
6532,348,497,60,28,0.002941176,583597,0.658241597
2303,33,331,60,28,0.002941176,583657,0.658309271
3385,638,31,60,28,0.002941176,583717,0.658376946
3406,674,302,59,28,0.002892157,583776,0.658443492
4180,131,170,59,28,0.002892157,583835,0.658510038
4528,84,385,59,28,0.002892157,583894,0.658576585
2021,9,586,59,28,0.002892157,583953,0.658643131
5011,219,443,59,28,0.002892157,584012,0.658709677
4536,313,439,59,28,0.002892157,584071,0.658776224
3604,673,353,59,28,0.002892157,584130,0.65884277
4831,331,97,59,28,0.002892157,584189,0.658909316
6334,68,54,59,28,0.002892157,584248,0.658975863
3950,353,609,58,28,0.002843137,584306,0.659041281
4857,354,236,58,28,0.002843137,584364,0.6591067
3782,131,379,58,28,0.002843137,584422,0.659172118
4407,367,498,58,28,0.002843137,584480,0.659237537
3152,586,16,58,28,0.002843137,584538,0.659302955
3816,673,9,58,28,0.002843137,584596,0.659368374
6746,348,280,58,28,0.002843137,584654,0.659433792
3537,511,27,58,28,0.002843137,584712,0.65949921
3730,528,27,58,28,0.002843137,584770,0.659564629
623,32,80,58,28,0.002843137,584828,0.659630047
4105,586,280,57,28,0.002794118,584885,0.659694338
4827,224,517,57,28,0.002794118,584942,0.659758628
3813,77,14,57,28,0.002794118,584999,0.659822919
4066,558,204,57,28,0.002794118,585056,0.65988721
5334,15,475,57,28,0.002794118,585113,0.6599515
5924,171,33,57,28,0.002794118,585170,0.660015791
4361,529,397,56,28,0.002745098,585226,0.660078953
3490,77,4,56,28,0.002745098,585282,0.660142116
3504,379,313,56,28,0.002745098,585338,0.660205279
3016,33,145,56,28,0.002745098,585394,0.660268441
4549,32,126,56,28,0.002745098,585450,0.660331604
4589,123,145,56,28,0.002745098,585506,0.660394767
4902,3,114,56,28,0.002745098,585562,0.660457929
4620,236,114,56,28,0.002745098,585618,0.660521092
3901,274,529,56,28,0.002745098,585674,0.660584254
3589,379,236,56,28,0.002745098,585730,0.660647417
6909,68,130,56,28,0.002745098,585786,0.66071058
2583,302,219,56,28,0.002745098,585842,0.660773742
4813,131,663,56,28,0.002745098,585898,0.660836905
2316,328,80,56,28,0.002745098,585954,0.660900068
4548,33,689,56,28,0.002745098,586010,0.66096323
3705,473,535,56,28,0.002745098,586066,0.661026393
2733,404,380,56,28,0.002745098,586122,0.661089556
4113,535,32,55,28,0.002696078,586177,0.66115159
2903,558,9,55,28,0.002696078,586232,0.661213625
3500,379,522,55,28,0.002696078,586287,0.66127566
4269,473,443,55,28,0.002696078,586342,0.661337695
5290,609,11,55,28,0.002696078,586397,0.661399729
3774,310,50,55,28,0.002696078,586452,0.661461764
5535,535,107,55,28,0.002696078,586507,0.661523799
4431,15,131,55,28,0.002696078,586562,0.661585834
4647,471,313,55,28,0.002696078,586617,0.661647868
4499,522,50,55,28,0.002696078,586672,0.661709903
4503,632,558,55,28,0.002696078,586727,0.661771938
3074,640,131,55,28,0.002696078,586782,0.661833972
4488,158,310,54,28,0.002647059,586836,0.661894879
5660,535,131,54,28,0.002647059,586890,0.661955786
4274,331,130,54,28,0.002647059,586944,0.662016693
4723,535,397,54,28,0.002647059,586998,0.6620776
6292,655,514,54,28,0.002647059,587052,0.662138507
5297,379,295,54,28,0.002647059,587106,0.662199413
5426,131,354,54,28,0.002647059,587160,0.66226032
3509,6,522,54,28,0.002647059,587214,0.662321227
3908,33,11,54,28,0.002647059,587268,0.662382134
6474,471,367,54,28,0.002647059,587322,0.662443041
3878,313,64,54,28,0.002647059,587376,0.662503948
3752,34,302,54,28,0.002647059,587430,0.662564855
4052,331,121,54,28,0.002647059,587484,0.662625761
4685,107,663,53,28,0.002598039,587537,0.66268554
4695,335,2,53,28,0.002598039,587590,0.662745319
5553,310,114,53,28,0.002598039,587643,0.662805098
1961,9,689,53,28,0.002598039,587696,0.662864877
4327,16,204,53,28,0.002598039,587749,0.662924656
5217,588,723,53,28,0.002598039,587802,0.662984435
3141,16,145,53,28,0.002598039,587855,0.663044214
3561,314,4,53,28,0.002598039,587908,0.663103993
2923,475,479,53,28,0.002598039,587961,0.663163772
6402,348,50,53,28,0.002598039,588014,0.663223551
4772,588,121,53,28,0.002598039,588067,0.66328333
7969,171,655,52,28,0.00254902,588119,0.663341981
4015,164,27,52,28,0.00254902,588171,0.663400632
6378,522,528,52,28,0.00254902,588223,0.663459283
3930,582,64,52,28,0.00254902,588275,0.663517934
4466,97,224,52,28,0.00254902,588327,0.663576585
2559,302,295,52,28,0.00254902,588379,0.663635236
4720,663,655,52,28,0.00254902,588431,0.663693887
4102,311,723,52,28,0.00254902,588483,0.663752538
5911,107,385,52,28,0.00254902,588535,0.663811189
4433,114,105,52,28,0.00254902,588587,0.66386984
5518,609,236,52,28,0.00254902,588639,0.663928491
5809,243,514,52,28,0.00254902,588691,0.663987142
5121,614,443,52,28,0.00254902,588743,0.664045793
4012,302,77,51,28,0.0025,588794,0.664103316
5478,196,708,51,28,0.0025,588845,0.664160839
2405,640,105,51,28,0.0025,588896,0.664218362
5615,107,114,51,28,0.0025,588947,0.664275885
4840,473,130,51,28,0.0025,588998,0.664333409
5690,114,310,51,28,0.0025,589049,0.664390932
4534,10,475,51,28,0.0025,589100,0.664448455
2669,522,158,51,28,0.0025,589151,0.664505978
6008,56,596,51,28,0.0025,589202,0.664563501
5996,331,544,51,28,0.0025,589253,0.664621024
3931,638,558,51,28,0.0025,589304,0.664678547
7866,463,250,51,28,0.0025,589355,0.66473607
4148,302,15,51,28,0.0025,589406,0.664793594
5309,204,353,51,28,0.0025,589457,0.664851117
4257,11,443,51,28,0.0025,589508,0.66490864
4176,10,141,51,28,0.0025,589559,0.664966163
5197,6,114,51,28,0.0025,589610,0.665023686
4267,640,558,51,28,0.0025,589661,0.665081209
3667,397,302,50,28,0.00245098,589711,0.665137604
5623,236,243,50,28,0.00245098,589761,0.665194
4362,682,27,50,28,0.00245098,589811,0.665250395
5213,498,264,50,28,0.00245098,589861,0.66530679
7529,414,404,50,28,0.00245098,589911,0.665363185
5051,20,689,50,28,0.00245098,589961,0.66541958
3929,16,638,50,28,0.00245098,590011,0.665475976
4642,56,230,50,28,0.00245098,590061,0.665532371
6255,130,34,50,28,0.00245098,590111,0.665588766
5239,6,498,50,28,0.00245098,590161,0.665645161
6108,48,250,50,28,0.00245098,590211,0.665701557
2788,32,532,50,28,0.00245098,590261,0.665757952
4658,367,280,50,28,0.00245098,590311,0.665814347
3329,397,10,49,28,0.002401961,590360,0.665869614
2832,6,3,49,28,0.002401961,590409,0.665924882
6167,230,54,49,28,0.002401961,590458,0.665980149
4716,385,77,49,28,0.002401961,590507,0.666035416
8399,535,605,49,28,0.002401961,590556,0.666090684
3125,50,582,49,28,0.002401961,590605,0.666145951
4166,31,68,49,28,0.002401961,590654,0.666201218
4574,32,243,49,28,0.002401961,590703,0.666256485
7471,130,609,49,28,0.002401961,590752,0.666311753
7051,43,31,49,28,0.002401961,590801,0.66636702
7468,77,85,49,28,0.002401961,590850,0.666422287
4789,156,498,49,28,0.002401961,590899,0.666477555
5384,236,501,49,28,0.002401961,590948,0.666532822
4920,367,313,49,28,0.002401961,590997,0.666588089
5092,394,68,49,28,0.002401961,591046,0.666643357
5109,380,97,49,28,0.002401961,591095,0.666698624
4771,475,348,49,28,0.002401961,591144,0.666753891
4759,95,558,49,28,0.002401961,591193,0.666809159
4132,588,11,49,28,0.002401961,591242,0.666864426
6441,224,141,49,28,0.002401961,591291,0.666919693
3531,313,609,49,28,0.002401961,591340,0.666974961
4284,11,243,49,28,0.002401961,591389,0.667030228
5012,27,269,48,28,0.002352941,591437,0.667084367
3321,310,334,48,28,0.002352941,591485,0.667138507
6876,26,605,48,28,0.002352941,591533,0.667192646
2895,196,105,48,28,0.002352941,591581,0.667246785
6918,348,535,48,28,0.002352941,591629,0.667300925
3841,310,479,48,28,0.002352941,591677,0.667355064
3382,443,354,48,28,0.002352941,591725,0.667409204
4500,383,367,48,28,0.002352941,591773,0.667463343
3130,394,224,48,28,0.002352941,591821,0.667517483
3973,310,596,48,28,0.002352941,591869,0.667571622
3941,265,394,48,28,0.002352941,591917,0.667625761
6155,335,5,48,28,0.002352941,591965,0.667679901
3153,582,404,48,28,0.002352941,592013,0.66773404
4632,528,105,48,28,0.002352941,592061,0.66778818
2742,655,443,48,28,0.002352941,592109,0.667842319
3572,26,230,47,28,0.002303922,592156,0.66789533
3967,280,164,47,28,0.002303922,592203,0.667948342
4018,274,380,47,28,0.002303922,592250,0.668001353
2438,529,105,47,28,0.002303922,592297,0.668054365
2422,280,77,47,28,0.002303922,592344,0.668107376
4489,3,56,47,28,0.002303922,592391,0.668160388
4403,367,50,47,28,0.002303922,592438,0.6682134
6848,105,294,47,28,0.002303922,592485,0.668266411
3543,674,354,47,28,0.002303922,592532,0.668319423
7178,446,473,47,28,0.002303922,592579,0.668372434
4313,16,95,47,28,0.002303922,592626,0.668425446
2962,522,3,47,28,0.002303922,592673,0.668478457
7096,43,48,47,28,0.002303922,592720,0.668531469
5068,632,224,47,28,0.002303922,592767,0.66858448
4739,56,311,47,28,0.002303922,592814,0.668637492
4911,443,398,46,28,0.002254902,592860,0.668689375
5231,535,443,46,28,0.002254902,592906,0.668741259
5016,131,588,46,28,0.002254902,592952,0.668793142
5460,274,498,46,28,0.002254902,592998,0.668845026
2158,443,9,46,28,0.002254902,593044,0.66889691
5336,708,16,46,28,0.002254902,593090,0.668948793
4972,16,596,46,28,0.002254902,593136,0.669000677
5199,236,117,46,28,0.002254902,593182,0.66905256
7022,663,511,46,28,0.002254902,593228,0.669104444
3038,522,394,46,28,0.002254902,593274,0.669156328
6747,479,56,46,28,0.002254902,593320,0.669208211
5947,130,529,46,28,0.002254902,593366,0.669260095
6770,80,562,46,28,0.002254902,593412,0.669311978
3987,475,302,46,28,0.002254902,593458,0.669363862
3013,397,334,46,28,0.002254902,593504,0.669415746
3778,295,331,46,28,0.002254902,593550,0.669467629
6302,131,48,46,28,0.002254902,593596,0.669519513
6353,265,596,46,28,0.002254902,593642,0.669571396
7660,663,517,45,28,0.002205882,593687,0.669622152
5465,2,68,45,28,0.002205882,593732,0.669672908
6089,544,302,45,28,0.002205882,593777,0.669723663
6017,528,380,45,28,0.002205882,593822,0.669774419
6368,3,121,45,28,0.002205882,593867,0.669825175
6781,562,10,45,28,0.002205882,593912,0.669875931
7577,348,609,45,28,0.002205882,593957,0.669926686
3650,295,313,45,28,0.002205882,594002,0.669977442
6421,528,331,45,28,0.002205882,594047,0.670028198
5111,15,196,45,28,0.002205882,594092,0.670078953
6526,6,535,45,28,0.002205882,594137,0.670129709
7885,517,310,45,28,0.002205882,594182,0.670180465
5125,614,230,45,28,0.002205882,594227,0.67023122
5433,117,80,45,28,0.002205882,594272,0.670281976
2533,9,398,45,28,0.002205882,594317,0.670332732
5744,25,394,45,28,0.002205882,594362,0.670383487
5895,27,294,45,28,0.002205882,594407,0.670434243
6825,230,64,45,28,0.002205882,594452,0.670484999
5959,558,141,45,28,0.002205882,594497,0.670535755
6162,439,230,44,28,0.002156863,594541,0.670585382
3566,439,27,44,28,0.002156863,594585,0.67063501
4111,443,32,44,28,0.002156863,594629,0.670684638
7492,310,517,44,28,0.002156863,594673,0.670734266
4683,582,5,44,28,0.002156863,594717,0.670783894
4569,15,123,44,28,0.002156863,594761,0.670833521
4560,10,145,44,28,0.002156863,594805,0.670883149
3120,638,380,44,28,0.002156863,594849,0.670932777
6996,663,250,44,28,0.002156863,594893,0.670982405
7307,414,236,43,28,0.002107843,594936,0.671030905
5294,204,558,43,28,0.002107843,594979,0.671079404
8160,663,274,43,28,0.002107843,595022,0.671127904
6085,307,68,43,28,0.002107843,595065,0.671176404
5848,609,10,43,28,0.002107843,595108,0.671224904
5570,605,243,43,28,0.002107843,595151,0.671273404
3261,274,105,43,28,0.002107843,595194,0.671321904
4384,582,328,43,28,0.002107843,595237,0.671370404
4415,16,463,43,28,0.002107843,595280,0.671418904
4841,307,145,43,28,0.002107843,595323,0.671467404
6995,77,482,42,28,0.002058824,595365,0.671514776
3127,529,314,42,28,0.002058824,595407,0.671562148
4833,498,265,42,28,0.002058824,595449,0.67160952
7808,204,479,42,28,0.002058824,595491,0.671656891
3549,463,105,42,28,0.002058824,595533,0.671704263
6396,328,471,42,28,0.002058824,595575,0.671751635
4382,6,84,42,28,0.002058824,595617,0.671799007
5358,77,34,42,28,0.002058824,595659,0.671846379
5888,32,560,42,28,0.002058824,595701,0.671893751
4987,532,473,41,28,0.002009804,595742,0.671939995
7060,348,307,41,28,0.002009804,595783,0.67198624
6840,158,68,41,28,0.002009804,595824,0.672032484
8959,552,479,41,28,0.002009804,595865,0.672078728
4447,674,443,41,28,0.002009804,595906,0.672124972
11147,155,498,41,28,0.002009804,595947,0.672171216
4657,2,335,41,28,0.002009804,595988,0.67221746
5116,479,145,41,28,0.002009804,596029,0.672263704
7011,16,517,41,28,0.002009804,596070,0.672309948
7013,313,294,40,28,0.001960784,596110,0.672355064
10034,640,552,40,28,0.001960784,596150,0.67240018
5254,689,68,40,28,0.001960784,596190,0.672445297
3501,313,26,40,28,0.001960784,596230,0.672490413
3603,689,105,40,28,0.001960784,596270,0.672535529
2700,123,443,40,28,0.001960784,596310,0.672580645
8379,114,609,40,28,0.001960784,596350,0.672625761
8053,552,335,39,28,0.001911765,596389,0.67266975
7849,2,14,39,28,0.001911765,596428,0.672713738
5110,394,529,39,28,0.001911765,596467,0.672757726
7045,673,33,39,28,0.001911765,596506,0.672801714
3324,9,640,39,28,0.001911765,596545,0.672845703
5604,265,443,38,28,0.001862745,596583,0.672888563
7160,77,708,38,28,0.001862745,596621,0.672931423
5677,295,475,38,28,0.001862745,596659,0.672974284
11414,181,6,37,28,0.001813725,596696,0.673016016
5107,280,130,37,28,0.001813725,596733,0.673057749
5828,588,26,36,28,0.001764706,596769,0.673098353
4439,609,224,36,28,0.001764706,596805,0.673138958
13636,85,582,34,28,0.001666667,596839,0.673177307
10535,48,528,33,28,0.001617647,596872,0.673214527
13463,674,163,31,28,0.001519608,596903,0.673249492
2306,721,27,95,27,0.004656863,596998,0.673356643
3112,414,335,73,27,0.003578431,597071,0.67343898
1840,9,334,68,27,0.003333333,597139,0.673515678
1318,614,158,68,27,0.003333333,597207,0.673592375
5453,5,31,67,27,0.003284314,597274,0.673667945
3147,11,397,67,27,0.003284314,597341,0.673743515
3573,34,68,66,27,0.003235294,597407,0.673817956
3488,11,230,66,27,0.003235294,597473,0.673892398
3633,10,674,66,27,0.003235294,597539,0.67396684
4324,614,131,65,27,0.003186275,597604,0.674040153
5071,328,379,65,27,0.003186275,597669,0.674113467
2627,12,529,65,27,0.003186275,597734,0.674186781
3597,219,26,64,27,0.003137255,597798,0.674258967
4555,204,224,64,27,0.003137255,597862,0.674331153
5272,5,348,64,27,0.003137255,597926,0.674403339
1766,529,84,63,27,0.003088235,597989,0.674474397
2877,243,84,63,27,0.003088235,598052,0.674545455
1981,219,158,62,27,0.003039216,598114,0.674615385
4289,393,243,62,27,0.003039216,598176,0.674685315
3964,302,463,61,27,0.002990196,598237,0.674754117
3615,398,353,61,27,0.002990196,598298,0.674822919
5680,380,427,61,27,0.002990196,598359,0.674891721
5726,348,655,61,27,0.002990196,598420,0.674960523
3031,674,230,61,27,0.002990196,598481,0.675029326
2236,383,27,60,27,0.002941176,598541,0.675097
4694,250,16,60,27,0.002941176,598601,0.675164674
3197,311,475,60,27,0.002941176,598661,0.675232348
3624,596,532,60,27,0.002941176,598721,0.675300023
7044,394,261,60,27,0.002941176,598781,0.675367697
3672,397,586,59,27,0.002892157,598840,0.675434243
6113,236,145,59,27,0.002892157,598899,0.67550079
2879,6,10,59,27,0.002892157,598958,0.675567336
3734,394,310,58,27,0.002843137,599016,0.675632754
4504,123,463,58,27,0.002843137,599074,0.675698173
5134,12,394,58,27,0.002843137,599132,0.675763591
3229,379,32,57,27,0.002794118,599189,0.675827882
3283,1,582,57,27,0.002794118,599246,0.675892172
3414,26,497,57,27,0.002794118,599303,0.675956463
2594,397,230,57,27,0.002794118,599360,0.676020753
5234,663,397,56,27,0.002745098,599416,0.676083916
5323,48,558,56,27,0.002745098,599472,0.676147079
2871,6,475,56,27,0.002745098,599528,0.676210241
4133,80,638,56,27,0.002745098,599584,0.676273404
5479,107,56,56,27,0.002745098,599640,0.676336567
5140,335,502,56,27,0.002745098,599696,0.676399729
2561,11,314,56,27,0.002745098,599752,0.676462892
3970,10,204,56,27,0.002745098,599808,0.676526055
975,9,443,56,27,0.002745098,599864,0.676589217
5040,230,427,56,27,0.002745098,599920,0.67665238
3679,219,331,55,27,0.002696078,599975,0.676714415
3477,33,367,55,27,0.002696078,600030,0.676776449
6428,535,682,55,27,0.002696078,600085,0.676838484
4235,522,6,55,27,0.002696078,600140,0.676900519
2197,10,334,55,27,0.002696078,600195,0.676962554
4124,501,353,55,27,0.002696078,600250,0.677024588
3957,1,6,55,27,0.002696078,600305,0.677086623
4703,20,473,55,27,0.002696078,600360,0.677148658
6170,204,638,55,27,0.002696078,600415,0.677210693
5601,354,663,54,27,0.002647059,600469,0.677271599
4949,224,543,54,27,0.002647059,600523,0.677332506
4401,95,10,54,27,0.002647059,600577,0.677393413
6389,171,15,54,27,0.002647059,600631,0.67745432
2057,32,3,54,27,0.002647059,600685,0.677515227
4275,522,443,54,27,0.002647059,600739,0.677576134
4678,30,14,54,27,0.002647059,600793,0.67763704
5730,354,414,54,27,0.002647059,600847,0.677697947
5137,145,33,54,27,0.002647059,600901,0.677758854
4877,84,114,54,27,0.002647059,600955,0.677819761
5101,558,471,54,27,0.002647059,601009,0.677880668
2307,9,204,54,27,0.002647059,601063,0.677941575
3403,582,543,54,27,0.002647059,601117,0.678002481
3646,3,77,54,27,0.002647059,601171,0.678063388
3028,655,529,54,27,0.002647059,601225,0.678124295
2227,582,586,53,27,0.002598039,601278,0.678184074
5382,130,307,53,27,0.002598039,601331,0.678243853
3696,204,295,53,27,0.002598039,601384,0.678303632
3928,15,558,53,27,0.002598039,601437,0.678363411
3932,475,310,53,27,0.002598039,601490,0.67842319
4455,145,310,53,27,0.002598039,601543,0.678482969
3586,274,655,53,27,0.002598039,601596,0.678542748
3733,15,32,53,27,0.002598039,601649,0.678602527
3768,354,471,53,27,0.002598039,601702,0.678662305
3184,640,204,53,27,0.002598039,601755,0.678722084
3961,640,6,52,27,0.00254902,601807,0.678780735
7428,117,535,52,27,0.00254902,601859,0.678839386
5049,12,236,52,27,0.00254902,601911,0.678898037
5473,1,5,52,27,0.00254902,601963,0.678956688
4418,311,56,52,27,0.00254902,602015,0.679015339
3959,522,529,52,27,0.00254902,602067,0.679073991
7627,26,347,52,27,0.00254902,602119,0.679132642
5008,56,471,52,27,0.00254902,602171,0.679191293
2861,543,314,52,27,0.00254902,602223,0.679249944
4631,498,367,52,27,0.00254902,602275,0.679308595
4926,25,264,52,27,0.00254902,602327,0.679367246
3683,2,479,52,27,0.00254902,602379,0.679425897
3424,397,131,51,27,0.0025,602430,0.67948342
5857,552,310,51,27,0.0025,602481,0.679540943
7338,130,632,51,27,0.0025,602532,0.679598466
5741,230,528,51,27,0.0025,602583,0.679655989
5696,15,380,51,27,0.0025,602634,0.679713512
5539,673,16,51,27,0.0025,602685,0.679771035
4680,501,498,51,27,0.0025,602736,0.679828559
5961,632,95,51,27,0.0025,602787,0.679886082
5928,394,398,51,27,0.0025,602838,0.679943605
4670,596,25,51,27,0.0025,602889,0.680001128
4677,68,121,51,27,0.0025,602940,0.680058651
4260,501,26,51,27,0.0025,602991,0.680116174
8010,498,347,51,27,0.0025,603042,0.680173697
2264,632,20,51,27,0.0025,603093,0.68023122
6523,236,295,51,27,0.0025,603144,0.680288744
5167,310,398,51,27,0.0025,603195,0.680346267
5169,353,674,51,27,0.0025,603246,0.68040379
4357,663,543,50,27,0.00245098,603296,0.680460185
6058,230,34,50,27,0.00245098,603346,0.68051658
4135,689,310,50,27,0.00245098,603396,0.680572975
5038,130,3,50,27,0.00245098,603446,0.680629371
4601,123,107,50,27,0.00245098,603496,0.680685766
6507,130,427,50,27,0.00245098,603546,0.680742161
2822,311,158,50,27,0.00245098,603596,0.680798556
7582,14,204,50,27,0.00245098,603646,0.680854952
4363,171,158,50,27,0.00245098,603696,0.680911347
6946,131,609,50,27,0.00245098,603746,0.680967742
4206,314,164,50,27,0.00245098,603796,0.681024137
7058,68,501,50,27,0.00245098,603846,0.681080532
5026,614,280,50,27,0.00245098,603896,0.681136928
5672,348,508,50,27,0.00245098,603946,0.681193323
8242,347,708,50,27,0.00245098,603996,0.681249718
4815,97,588,50,27,0.00245098,604046,0.681306113
5270,1,310,50,27,0.00245098,604096,0.681362508
4436,280,473,49,27,0.002401961,604145,0.681417776
5124,16,562,49,27,0.002401961,604194,0.681473043
7437,663,126,49,27,0.002401961,604243,0.68152831
6804,348,26,49,27,0.002401961,604292,0.681583578
4300,335,334,49,27,0.002401961,604341,0.681638845
4472,394,11,49,27,0.002401961,604390,0.681694112
4688,26,164,48,27,0.002352941,604438,0.681748252
3690,26,141,48,27,0.002352941,604486,0.681802391
4139,11,335,48,27,0.002352941,604534,0.681856531
4919,310,348,48,27,0.002352941,604582,0.68191067
4142,443,265,48,27,0.002352941,604630,0.681964809
4837,15,33,48,27,0.002352941,604678,0.682018949
6442,130,614,48,27,0.002352941,604726,0.682073088
5808,130,560,48,27,0.002352941,604774,0.682127228
5552,552,230,48,27,0.002352941,604822,0.682181367
3391,674,123,48,27,0.002352941,604870,0.682235506
7184,354,243,48,27,0.002352941,604918,0.682289646
4531,219,77,48,27,0.002352941,604966,0.682343785
5349,663,640,48,27,0.002352941,605014,0.682397925
3613,274,219,48,27,0.002352941,605062,0.682452064
6029,11,529,48,27,0.002352941,605110,0.682506203
7281,48,723,48,27,0.002352941,605158,0.682560343
3354,475,313,48,27,0.002352941,605206,0.682614482
5067,84,558,48,27,0.002352941,605254,0.682668622
5338,77,646,48,27,0.002352941,605302,0.682722761
6145,3,609,48,27,0.002352941,605350,0.682776901
4024,614,335,48,27,0.002352941,605398,0.68283104
4946,77,714,47,27,0.002303922,605445,0.682884051
4869,393,10,47,27,0.002303922,605492,0.682937063
4421,558,280,47,27,0.002303922,605539,0.682990074
5248,33,498,47,27,0.002303922,605586,0.683043086
6609,335,682,47,27,0.002303922,605633,0.683096097
6141,131,6,47,27,0.002303922,605680,0.683149109
5468,331,605,47,27,0.002303922,605727,0.68320212
5422,84,95,47,27,0.002303922,605774,0.683255132
4430,30,348,47,27,0.002303922,605821,0.683308143
7168,328,84,47,27,0.002303922,605868,0.683361155
4123,673,471,47,27,0.002303922,605915,0.683414166
1305,498,80,47,27,0.002303922,605962,0.683467178
7294,502,596,47,27,0.002303922,606009,0.683520189
6541,663,609,47,27,0.002303922,606056,0.683573201
4262,379,264,47,27,0.002303922,606103,0.683626212
4761,274,10,47,27,0.002303922,606150,0.683679224
5079,347,105,47,27,0.002303922,606197,0.683732236
7913,517,588,47,27,0.002303922,606244,0.683785247
3285,307,310,47,27,0.002303922,606291,0.683838259
4743,33,236,47,27,0.002303922,606338,0.68389127
4925,609,310,46,27,0.002254902,606384,0.683943154
2191,414,80,46,27,0.002254902,606430,0.683995037
5082,32,517,46,27,0.002254902,606476,0.684046921
5661,522,121,46,27,0.002254902,606522,0.684098804
3610,586,655,46,27,0.002254902,606568,0.684150688
5469,663,479,46,27,0.002254902,606614,0.684202572
5312,236,674,46,27,0.002254902,606660,0.684254455
5361,15,97,46,27,0.002254902,606706,0.684306339
4984,6,394,46,27,0.002254902,606752,0.684358222
6403,535,250,46,27,0.002254902,606798,0.684410106
2460,638,105,46,27,0.002254902,606844,0.68446199
6651,56,443,46,27,0.002254902,606890,0.684513873
4469,2,32,46,27,0.002254902,606936,0.684565757
4458,310,497,46,27,0.002254902,606982,0.68461764
1692,9,15,46,27,0.002254902,607028,0.684669524
6194,130,30,46,27,0.002254902,607074,0.684721408
4365,20,5,46,27,0.002254902,607120,0.684773291
5770,131,348,46,27,0.002254902,607166,0.684825175
6695,27,332,46,27,0.002254902,607212,0.684877058
4697,31,16,46,27,0.002254902,607258,0.684928942
3983,77,632,46,27,0.002254902,607304,0.684980826
2768,4,354,46,27,0.002254902,607350,0.685032709
4826,80,501,46,27,0.002254902,607396,0.685084593
5687,544,380,46,27,0.002254902,607442,0.685136476
4079,498,84,46,27,0.002254902,607488,0.68518836
5292,380,689,45,27,0.002205882,607533,0.685239116
3654,14,20,45,27,0.002205882,607578,0.685289871
5062,501,532,45,27,0.002205882,607623,0.685340627
4566,558,463,45,27,0.002205882,607668,0.685391383
5117,367,404,45,27,0.002205882,607713,0.685442139
4020,498,394,45,27,0.002205882,607758,0.685492894
4412,48,334,45,27,0.002205882,607803,0.68554365
6296,171,558,45,27,0.002205882,607848,0.685594406
4321,673,48,45,27,0.002205882,607893,0.685645161
7950,328,529,45,27,0.002205882,607938,0.685695917
6149,34,663,45,27,0.002205882,607983,0.685746673
6248,498,514,45,27,0.002205882,608028,0.685797428
5447,532,514,45,27,0.002205882,608073,0.685848184
5436,84,33,45,27,0.002205882,608118,0.68589894
4550,588,439,45,27,0.002205882,608163,0.685949695
5646,84,535,45,27,0.002205882,608208,0.686000451
4731,674,638,45,27,0.002205882,608253,0.686051207
3160,123,334,45,27,0.002205882,608298,0.686101963
6818,5,14,45,27,0.002205882,608343,0.686152718
5019,80,114,45,27,0.002205882,608388,0.686203474
5723,543,230,45,27,0.002205882,608433,0.68625423
4903,632,131,45,27,0.002205882,608478,0.686304985
2527,9,609,44,27,0.002156863,608522,0.686354613
4828,14,6,44,27,0.002156863,608566,0.686404241
5738,663,532,44,27,0.002156863,608610,0.686453869
4246,588,64,44,27,0.002156863,608654,0.686503497
4238,663,689,44,27,0.002156863,608698,0.686553124
6952,68,618,44,27,0.002156863,608742,0.686602752
3524,439,582,44,27,0.002156863,608786,0.68665238
6406,107,501,44,27,0.002156863,608830,0.686702008
6399,68,56,44,27,0.002156863,608874,0.686751635
5657,640,31,44,27,0.002156863,608918,0.686801263
6534,473,141,44,27,0.002156863,608962,0.686850891
5675,16,307,44,27,0.002156863,609006,0.686900519
5006,398,9,44,27,0.002156863,609050,0.686950147
6088,353,204,44,27,0.002156863,609094,0.686999774
4492,77,723,44,27,0.002156863,609138,0.687049402
4702,105,552,44,27,0.002156863,609182,0.68709903
5021,77,54,44,27,0.002156863,609226,0.687148658
3353,123,655,44,27,0.002156863,609270,0.687198286
4474,439,105,44,27,0.002156863,609314,0.687247913
7002,552,302,44,27,0.002156863,609358,0.687297541
5826,543,10,44,27,0.002156863,609402,0.687347169
5878,158,511,44,27,0.002156863,609446,0.687396797
6348,236,723,43,27,0.002107843,609489,0.687445297
6186,380,34,43,27,0.002107843,609532,0.687493797
6482,30,196,43,27,0.002107843,609575,0.687542296
5917,131,334,43,27,0.002107843,609618,0.687590796
5360,588,632,43,27,0.002107843,609661,0.687639296
8126,347,31,43,27,0.002107843,609704,0.687687796
8133,475,596,43,27,0.002107843,609747,0.687736296
6070,56,32,43,27,0.002107843,609790,0.687784796
4779,552,105,43,27,0.002107843,609833,0.687833296
5150,105,156,43,27,0.002107843,609876,0.687881796
4099,385,105,43,27,0.002107843,609919,0.687930296
3111,30,582,43,27,0.002107843,609962,0.687978795
4757,443,274,43,27,0.002107843,610005,0.688027295
4719,77,593,43,27,0.002107843,610048,0.688075795
5141,473,126,43,27,0.002107843,610091,0.688124295
4161,50,334,43,27,0.002107843,610134,0.688172795
3793,638,522,43,27,0.002107843,610177,0.688221295
5024,443,522,42,27,0.002058824,610219,0.688268667
7881,171,348,42,27,0.002058824,610261,0.688316039
4679,11,311,42,27,0.002058824,610303,0.688363411
4675,105,507,42,27,0.002058824,610345,0.688410783
3217,609,314,42,27,0.002058824,610387,0.688458155
5600,479,30,42,27,0.002058824,610429,0.688505527
5794,6,236,42,27,0.002058824,610471,0.688552899
4009,123,638,42,27,0.002058824,610513,0.688600271
4790,123,596,42,27,0.002058824,610555,0.688647643
7435,354,145,42,27,0.002058824,610597,0.688695015
5703,311,34,42,27,0.002058824,610639,0.688742387
6783,348,529,42,27,0.002058824,610681,0.688789759
4965,414,77,42,27,0.002058824,610723,0.688837131
4700,2,380,42,27,0.002058824,610765,0.688884503
8156,328,522,42,27,0.002058824,610807,0.688931875
4058,443,302,42,27,0.002058824,610849,0.688979247
3943,475,471,41,27,0.002009804,610890,0.689025491
5614,380,274,41,27,0.002009804,610931,0.689071735
7127,114,331,41,27,0.002009804,610972,0.689117979
4665,313,708,41,27,0.002009804,611013,0.689164223
5872,522,307,41,27,0.002009804,611054,0.689210467
3986,640,14,41,27,0.002009804,611095,0.689256711
7663,250,107,41,27,0.002009804,611136,0.689302955
7957,543,95,41,27,0.002009804,611177,0.689349199
6169,130,114,41,27,0.002009804,611218,0.689395443
3113,501,84,41,27,0.002009804,611259,0.689441687
6293,354,31,41,27,0.002009804,611300,0.689487931
4640,10,497,41,27,0.002009804,611341,0.689534176
6492,26,163,41,27,0.002009804,611382,0.68958042
3966,280,354,41,27,0.002009804,611423,0.689626664
5185,123,723,41,27,0.002009804,611464,0.689672908
5390,12,367,41,27,0.002009804,611505,0.689719152
5702,354,723,40,27,0.001960784,611545,0.689764268
6994,663,560,40,27,0.001960784,611585,0.689809384
5491,250,443,40,27,0.001960784,611625,0.6898545
4742,689,16,40,27,0.001960784,611665,0.689899617
5398,97,230,40,27,0.001960784,611705,0.689944733
8472,348,250,40,27,0.001960784,611745,0.689989849
4007,632,471,40,27,0.001960784,611785,0.690034965
6668,674,471,40,27,0.001960784,611825,0.690080081
5114,379,250,40,27,0.001960784,611865,0.690125197
7260,331,170,40,27,0.001960784,611905,0.690170314
8653,347,14,40,27,0.001960784,611945,0.69021543
8915,310,5,40,27,0.001960784,611985,0.690260546
5994,236,614,40,27,0.001960784,612025,0.690305662
5778,640,475,39,27,0.001911765,612064,0.69034965
4146,15,582,39,27,0.001911765,612103,0.690393639
6907,332,27,39,27,0.001911765,612142,0.690437627
9167,121,27,39,27,0.001911765,612181,0.690481615
6053,80,158,38,27,0.001862745,612219,0.690524476
6416,31,310,38,27,0.001862745,612257,0.690567336
6294,393,114,38,27,0.001862745,612295,0.690610196
1752,514,80,38,27,0.001862745,612333,0.690653057
5399,302,609,38,27,0.001862745,612371,0.690695917
6947,31,204,38,27,0.001862745,612409,0.690738777
6939,160,353,38,27,0.001862745,612447,0.690781638
9762,77,701,37,27,0.001813725,612484,0.69082337
8544,16,503,37,27,0.001813725,612521,0.690865103
7324,3,723,37,27,0.001813725,612558,0.690906835
6915,593,397,37,27,0.001813725,612595,0.690948568
5156,380,4,37,27,0.001813725,612632,0.6909903
5516,95,219,37,27,0.001813725,612669,0.691032032
5698,380,562,37,27,0.001813725,612706,0.691073765
4914,562,9,36,27,0.001764706,612742,0.69111437
8262,562,463,36,27,0.001764706,612778,0.691154974
7807,56,522,36,27,0.001764706,612814,0.691195579
5324,107,638,36,27,0.001764706,612850,0.691236183
8990,29,14,36,27,0.001764706,612886,0.691276788
4173,398,77,35,27,0.001715686,612921,0.691316264
5192,145,335,35,27,0.001715686,612956,0.691355741
11711,605,265,34,27,0.001666667,612990,0.69139409
9088,97,307,34,27,0.001666667,613024,0.691432439
5904,379,141,34,27,0.001666667,613058,0.691470787
5622,274,310,33,27,0.001617647,613091,0.691508008
11499,471,14,33,27,0.001617647,613124,0.691545229
9628,511,522,33,27,0.001617647,613157,0.69158245
3118,593,27,84,26,0.004117647,613241,0.691677194
6454,562,544,74,26,0.003627451,613315,0.691760659
2547,674,9,67,26,0.003284314,613382,0.691836228
5265,311,528,65,26,0.003186275,613447,0.691909542
4106,80,50,62,26,0.003039216,613509,0.691979472
3061,9,114,61,26,0.002990196,613570,0.692048274
4069,130,638,61,26,0.002990196,613631,0.692117076
4991,562,204,61,26,0.002990196,613692,0.692185879
5686,56,68,60,26,0.002941176,613752,0.692253553
2744,529,443,60,26,0.002941176,613812,0.692321227
3172,311,497,59,26,0.002892157,613871,0.692387774
4506,6,640,59,26,0.002892157,613930,0.69245432
4425,224,250,58,26,0.002843137,613988,0.692519738
5321,663,204,58,26,0.002843137,614046,0.692585157
3056,588,84,57,26,0.002794118,614103,0.692649447
5103,230,204,57,26,0.002794118,614160,0.692713738
3402,16,3,57,26,0.002794118,614217,0.692778028
7293,502,586,57,26,0.002794118,614274,0.692842319
6237,219,347,56,26,0.002745098,614330,0.692905482
3468,443,10,56,26,0.002745098,614386,0.692968644
2424,242,27,56,26,0.002745098,614442,0.693031807
5762,380,196,55,26,0.002696078,614497,0.693093842
4668,77,682,55,26,0.002696078,614552,0.693155876
2402,614,314,54,26,0.002647059,614606,0.693216783
4765,543,131,54,26,0.002647059,614660,0.69327769
5454,68,141,54,26,0.002647059,614714,0.693338597
4337,335,164,54,26,0.002647059,614768,0.693399504
3861,6,689,54,26,0.002647059,614822,0.693460411
3367,353,311,54,26,0.002647059,614876,0.693521317
6913,471,33,53,26,0.002598039,614929,0.693581096
4358,588,586,52,26,0.00254902,614981,0.693639747
5267,130,385,52,26,0.00254902,615033,0.693698398
6120,535,609,52,26,0.00254902,615085,0.693757049
4144,295,95,52,26,0.00254902,615137,0.6938157
4794,380,145,52,26,0.00254902,615189,0.693874351
6487,130,242,52,26,0.00254902,615241,0.693933002
3413,655,26,52,26,0.00254902,615293,0.693991654
2315,443,77,52,26,0.00254902,615345,0.694050305
5443,145,204,51,26,0.0025,615396,0.694107828
3304,379,393,51,26,0.0025,615447,0.694165351
3212,250,230,51,26,0.0025,615498,0.694222874
4691,12,243,51,26,0.0025,615549,0.694280397
3761,30,68,51,26,0.0025,615600,0.69433792
7624,347,475,51,26,0.0025,615651,0.694395443
3924,471,80,51,26,0.0025,615702,0.694452966
2192,501,314,51,26,0.0025,615753,0.69451049
2875,95,123,51,26,0.0025,615804,0.694568013
2876,32,443,51,26,0.0025,615855,0.694625536
2276,280,335,51,26,0.0025,615906,0.694683059
6278,48,295,51,26,0.0025,615957,0.694740582
4149,310,475,51,26,0.0025,616008,0.694798105
5327,145,558,50,26,0.00245098,616058,0.6948545
3832,529,236,50,26,0.00245098,616108,0.694910896
4690,160,27,50,26,0.00245098,616158,0.694967291
3140,307,105,50,26,0.00245098,616208,0.695023686
3916,632,32,50,26,0.00245098,616258,0.695080081
4334,328,353,50,26,0.00245098,616308,0.695136476
3435,379,586,50,26,0.00245098,616358,0.695192872
3041,532,123,50,26,0.00245098,616408,0.695249267
4467,123,236,50,26,0.00245098,616458,0.695305662
6414,1,33,50,26,0.00245098,616508,0.695362057
5540,380,714,49,26,0.002401961,616557,0.695417325
4209,107,50,49,26,0.002401961,616606,0.695472592
5983,5,196,49,26,0.002401961,616655,0.695527859
5346,230,14,49,26,0.002401961,616704,0.695583127
5864,250,219,49,26,0.002401961,616753,0.695638394
5691,224,196,49,26,0.002401961,616802,0.695693661
4741,31,33,49,26,0.002401961,616851,0.695748928
3478,443,311,49,26,0.002401961,616900,0.695804196
5256,471,331,49,26,0.002401961,616949,0.695859463
6209,219,663,49,26,0.002401961,616998,0.69591473
3540,31,224,49,26,0.002401961,617047,0.695969998
5391,11,522,49,26,0.002401961,617096,0.696025265
5639,9,517,49,26,0.002401961,617145,0.696080532
3781,32,393,49,26,0.002401961,617194,0.6961358
3880,414,582,49,26,0.002401961,617243,0.696191067
5000,12,398,49,26,0.002401961,617292,0.696246334
6367,236,502,48,26,0.002352941,617340,0.696300474
3767,219,335,48,26,0.002352941,617388,0.696354613
3287,196,6,48,26,0.002352941,617436,0.696408753
4265,32,497,48,26,0.002352941,617484,0.696462892
4329,473,655,48,26,0.002352941,617532,0.696517031
4471,310,311,48,26,0.002352941,617580,0.696571171
4540,6,508,48,26,0.002352941,617628,0.69662531
5196,522,544,48,26,0.002352941,617676,0.69667945
6732,397,501,48,26,0.002352941,617724,0.696733589
4077,26,354,48,26,0.002352941,617772,0.696787728
4564,379,471,48,26,0.002352941,617820,0.696841868
5973,43,302,48,26,0.002352941,617868,0.696896007
5136,663,393,48,26,0.002352941,617916,0.696950147
3423,655,532,47,26,0.002303922,617963,0.697003158
6628,1,131,47,26,0.002303922,618010,0.69705617
8267,394,502,47,26,0.002303922,618057,0.697109181
4910,313,632,47,26,0.002303922,618104,0.697162193
4011,10,50,47,26,0.002303922,618151,0.697215204
4204,33,295,47,26,0.002303922,618198,0.697268216
6115,398,243,47,26,0.002303922,618245,0.697321227
5766,663,84,47,26,0.002303922,618292,0.697374239
3461,123,10,47,26,0.002303922,618339,0.69742725
5550,302,517,47,26,0.002303922,618386,0.697480262
4709,674,663,47,26,0.002303922,618433,0.697533273
6823,708,347,47,26,0.002303922,618480,0.697586285
5875,80,479,47,26,0.002303922,618527,0.697639296
6787,84,593,47,26,0.002303922,618574,0.697692308
6281,335,661,47,26,0.002303922,618621,0.697745319
3862,367,219,47,26,0.002303922,618668,0.697798331
7023,427,224,47,26,0.002303922,618715,0.697851342
5029,398,230,47,26,0.002303922,618762,0.697904354
4107,354,3,47,26,0.002303922,618809,0.697957365
5373,708,31,47,26,0.002303922,618856,0.698010377
3838,158,314,47,26,0.002303922,618903,0.698063388
4098,586,107,47,26,0.002303922,618950,0.6981164
7961,68,164,47,26,0.002303922,618997,0.698169411
5412,535,236,46,26,0.002254902,619043,0.698221295
5654,517,380,46,26,0.002254902,619089,0.698273178
5536,105,593,46,26,0.002254902,619135,0.698325062
4904,479,84,46,26,0.002254902,619181,0.698376946
5126,130,562,46,26,0.002254902,619227,0.698428829
3073,307,123,46,26,0.002254902,619273,0.698480713
8207,348,398,46,26,0.002254902,619319,0.698532596
4628,15,6,46,26,0.002254902,619365,0.69858448
4650,107,614,46,26,0.002254902,619411,0.698636364
5906,501,243,46,26,0.002254902,619457,0.698688247
5884,219,529,46,26,0.002254902,619503,0.698740131
4294,380,479,46,26,0.002254902,619549,0.698792014
4295,501,335,46,26,0.002254902,619595,0.698843898
5464,313,117,45,26,0.002205882,619640,0.698894654
4215,30,310,45,26,0.002205882,619685,0.698945409
5274,236,141,45,26,0.002205882,619730,0.698996165
5056,522,532,45,26,0.002205882,619775,0.699046921
6780,48,394,45,26,0.002205882,619820,0.699097677
5995,354,97,45,26,0.002205882,619865,0.699148432
2902,9,614,45,26,0.002205882,619910,0.699199188
5345,354,114,45,26,0.002205882,619955,0.699249944
8157,1,663,45,26,0.002205882,620000,0.699300699
2953,544,16,45,26,0.002205882,620045,0.699351455
4136,558,313,45,26,0.002205882,620090,0.699402211
4392,618,20,45,26,0.002205882,620135,0.699452966
3214,655,105,45,26,0.002205882,620180,0.699503722
4818,331,723,45,26,0.002205882,620225,0.699554478
4982,204,219,45,26,0.002205882,620270,0.699605233
5847,354,280,45,26,0.002205882,620315,0.699655989
7474,48,54,45,26,0.002205882,620360,0.699706745
4933,95,313,45,26,0.002205882,620405,0.699757501
3446,123,532,44,26,0.002156863,620449,0.699807128
5408,398,50,44,26,0.002156863,620493,0.699856756
5181,280,614,44,26,0.002156863,620537,0.699906384
6831,230,242,44,26,0.002156863,620581,0.699956012
6249,16,544,44,26,0.002156863,620625,0.70000564
7092,171,310,44,26,0.002156863,620669,0.700055267
6716,158,31,44,26,0.002156863,620713,0.700104895
4701,6,97,44,26,0.002156863,620757,0.700154523
7222,196,5,44,26,0.002156863,620801,0.700204151
6114,586,131,44,26,0.002156863,620845,0.700253778
2739,640,582,44,26,0.002156863,620889,0.700303406
9387,502,514,43,26,0.002107843,620932,0.700351906
5573,261,27,43,26,0.002107843,620975,0.700400406
6772,404,609,43,26,0.002107843,621018,0.700448906
5574,668,27,43,26,0.002107843,621061,0.700497406
5953,219,394,43,26,0.002107843,621104,0.700545906
6142,543,310,43,26,0.002107843,621147,0.700594406
7352,314,446,43,26,0.002107843,621190,0.700642905
7609,348,77,43,26,0.002107843,621233,0.700691405
5337,16,34,43,26,0.002107843,621276,0.700739905
5339,27,652,43,26,0.002107843,621319,0.700788405
5960,12,586,43,26,0.002107843,621362,0.700836905
4078,307,9,43,26,0.002107843,621405,0.700885405
3271,295,335,43,26,0.002107843,621448,0.700933905
4590,32,689,43,26,0.002107843,621491,0.700982405
4217,105,1,43,26,0.002107843,621534,0.701030905
3024,280,397,43,26,0.002107843,621577,0.701079404
3998,558,145,43,26,0.002107843,621620,0.701127904
3991,427,105,43,26,0.002107843,621663,0.701176404
4021,331,141,43,26,0.002107843,621706,0.701224904
4497,123,586,43,26,0.002107843,621749,0.701273404
3723,2,105,43,26,0.002107843,621792,0.701321904
4646,107,6,43,26,0.002107843,621835,0.701370404
4170,14,32,43,26,0.002107843,621878,0.701418904
5057,84,528,42,26,0.002058824,621920,0.701466276
5706,131,84,42,26,0.002058824,621962,0.701513648
7668,130,167,42,26,0.002058824,622004,0.70156102
3715,295,588,42,26,0.002058824,622046,0.701608392
7632,334,33,42,26,0.002058824,622088,0.701655764
6469,34,335,42,26,0.002058824,622130,0.701703136
3167,586,331,42,26,0.002058824,622172,0.701750508
6679,236,307,42,26,0.002058824,622214,0.70179788
3771,404,331,42,26,0.002058824,622256,0.701845252
5843,674,280,42,26,0.002058824,622298,0.701892624
6741,14,347,42,26,0.002058824,622340,0.701939995
6879,614,609,42,26,0.002058824,622382,0.701987367
3911,95,48,42,26,0.002058824,622424,0.702034739
4913,501,529,42,26,0.002058824,622466,0.702082111
4197,443,141,42,26,0.002058824,622508,0.702129483
3290,9,164,42,26,0.002058824,622550,0.702176855
4975,353,15,42,26,0.002058824,622592,0.702224227
6855,243,311,42,26,0.002058824,622634,0.702271599
5208,331,4,42,26,0.002058824,622676,0.702318971
5378,558,723,42,26,0.002058824,622718,0.702366343
6537,347,6,42,26,0.002058824,622760,0.702413715
6140,385,353,42,26,0.002058824,622802,0.702461087
4190,614,84,41,26,0.002009804,622843,0.702507331
9400,347,354,41,26,0.002009804,622884,0.702553575
6159,463,219,41,26,0.002009804,622925,0.70259982
4036,34,20,41,26,0.002009804,622966,0.702646064
5630,77,517,41,26,0.002009804,623007,0.702692308
4918,582,632,41,26,0.002009804,623048,0.702738552
5589,243,335,41,26,0.002009804,623089,0.702784796
5350,394,498,41,26,0.002009804,623130,0.70283104
7313,532,501,41,26,0.002009804,623171,0.702877284
6873,638,347,41,26,0.002009804,623212,0.702923528
4681,367,471,41,26,0.002009804,623253,0.702969772
5142,558,77,41,26,0.002009804,623294,0.703016016
3803,9,34,41,26,0.002009804,623335,0.70306226
6666,463,353,41,26,0.002009804,623376,0.703108504
7712,335,29,41,26,0.002009804,623417,0.703154748
5519,250,588,41,26,0.002009804,623458,0.703200993
5528,261,367,41,26,0.002009804,623499,0.703247237
6898,95,353,40,26,0.001960784,623539,0.703292353
5240,640,311,40,26,0.001960784,623579,0.703337469
7107,34,331,40,26,0.001960784,623619,0.703382585
5314,97,310,40,26,0.001960784,623659,0.703427701
6871,532,130,40,26,0.001960784,623699,0.703472818
4495,25,105,40,26,0.001960784,623739,0.703517934
6425,522,501,40,26,0.001960784,623779,0.70356305
4380,10,479,40,26,0.001960784,623819,0.703608166
6614,328,586,40,26,0.001960784,623859,0.703653282
5526,331,514,40,26,0.001960784,623899,0.703698398
4411,95,588,40,26,0.001960784,623939,0.703743515
6322,528,10,40,26,0.001960784,623979,0.703788631
5581,34,6,40,26,0.001960784,624019,0.703833747
8643,3,204,40,26,0.001960784,624059,0.703878863
6788,123,439,40,26,0.001960784,624099,0.703923979
6064,3,250,40,26,0.001960784,624139,0.703969095
5986,354,655,40,26,0.001960784,624179,0.704014212
5228,588,398,40,26,0.001960784,624219,0.704059328
9082,609,95,40,26,0.001960784,624259,0.704104444
7423,204,640,40,26,0.001960784,624299,0.70414956
4780,204,582,39,26,0.001911765,624338,0.704193548
4722,95,68,39,26,0.001911765,624377,0.704237537
4715,123,689,39,26,0.001911765,624416,0.704281525
8962,56,663,39,26,0.001911765,624455,0.704325513
4989,145,295,39,26,0.001911765,624494,0.704369501
7728,174,31,39,26,0.001911765,624533,0.70441349
8545,145,498,39,26,0.001911765,624572,0.704457478
9576,117,331,39,26,0.001911765,624611,0.704501466
5667,328,588,39,26,0.001911765,624650,0.704545455
9683,596,646,39,26,0.001911765,624689,0.704589443
5262,532,385,39,26,0.001911765,624728,0.704633431
10874,552,250,39,26,0.001911765,624767,0.704677419
5271,473,497,39,26,0.001911765,624806,0.704721408
3384,385,80,39,26,0.001911765,624845,0.704765396
3292,640,335,39,26,0.001911765,624884,0.704809384
6117,674,347,39,26,0.001911765,624923,0.704853372
9272,171,689,39,26,0.001911765,624962,0.704897361
6109,95,131,38,26,0.001862745,625000,0.704940221
4578,107,264,38,26,0.001862745,625038,0.704983081
4307,663,638,38,26,0.001862745,625076,0.705025942
6504,31,558,38,26,0.001862745,625114,0.705068802
7367,158,463,38,26,0.001862745,625152,0.705111663
5145,10,265,38,26,0.001862745,625190,0.705154523
7637,171,16,38,26,0.001862745,625228,0.705197383
7370,348,562,38,26,0.001862745,625266,0.705240244
7361,107,130,38,26,0.001862745,625304,0.705283104
7186,471,295,38,26,0.001862745,625342,0.705325964
8149,328,219,38,26,0.001862745,625380,0.705368825
9542,11,25,38,26,0.001862745,625418,0.705411685
8355,68,328,38,26,0.001862745,625456,0.705454545
6099,498,107,38,26,0.001862745,625494,0.705497406
6665,353,33,38,26,0.001862745,625532,0.705540266
6706,479,443,38,26,0.001862745,625570,0.705583127
6795,56,219,38,26,0.001862745,625608,0.705625987
7000,543,663,38,26,0.001862745,625646,0.705668847
9575,535,501,37,26,0.001813725,625683,0.70571058
6639,314,507,37,26,0.001813725,625720,0.705752312
6664,310,14,37,26,0.001813725,625757,0.705794045
8921,354,242,37,26,0.001813725,625794,0.705835777
8889,250,347,37,26,0.001813725,625831,0.70587751
6673,354,404,37,26,0.001813725,625868,0.705919242
8052,68,195,37,26,0.001813725,625905,0.705960975
7108,26,398,37,26,0.001813725,625942,0.706002707
7844,68,605,37,26,0.001813725,625979,0.706044439
7784,517,313,37,26,0.001813725,626016,0.706086172
7767,596,528,37,26,0.001813725,626053,0.706127904
6888,463,471,37,26,0.001813725,626090,0.706169637
7575,68,294,37,26,0.001813725,626127,0.706211369
5495,593,331,37,26,0.001813725,626164,0.706253102
5717,302,655,37,26,0.001813725,626201,0.706294834
5970,131,313,37,26,0.001813725,626238,0.706336567
5645,302,50,37,26,0.001813725,626275,0.706378299
5586,27,246,37,26,0.001813725,626312,0.706420032
5793,353,614,37,26,0.001813725,626349,0.706461764
4639,307,10,37,26,0.001813725,626386,0.706503497
4885,9,2,37,26,0.001813725,626423,0.706545229
6094,34,380,37,26,0.001813725,626460,0.706586961
4607,16,393,37,26,0.001813725,626497,0.706628694
3692,640,9,36,26,0.001764706,626533,0.706669298
7143,393,414,36,26,0.001764706,626569,0.706709903
7519,479,121,36,26,0.001764706,626605,0.706750508
7123,614,558,36,26,0.001764706,626641,0.706791112
3576,9,562,36,26,0.001764706,626677,0.706831717
6097,393,535,36,26,0.001764706,626713,0.706872321
5543,385,331,36,26,0.001764706,626749,0.706912926
5658,632,348,36,26,0.001764706,626785,0.70695353
7218,443,31,36,26,0.001764706,626821,0.706994135
8038,311,1,36,26,0.001764706,626857,0.707034739
8188,543,348,36,26,0.001764706,626893,0.707075344
6837,12,498,35,26,0.001715686,626928,0.707114821
7936,34,48,35,26,0.001715686,626963,0.707154297
8154,158,614,35,26,0.001715686,626998,0.707193774
9833,498,167,35,26,0.001715686,627033,0.707233251
5714,558,236,35,26,0.001715686,627068,0.707272727
5883,471,123,35,26,0.001715686,627103,0.707312204
9451,511,463,35,26,0.001715686,627138,0.707351681
8758,56,463,35,26,0.001715686,627173,0.707391157
6003,30,311,35,26,0.001715686,627208,0.707430634
7358,562,471,35,26,0.001715686,627243,0.707470111
6572,673,588,34,26,0.001666667,627277,0.707508459
6263,50,230,34,26,0.001666667,627311,0.707546808
5499,10,614,34,26,0.001666667,627345,0.707585157
7925,397,404,34,26,0.001666667,627379,0.707623506
3168,331,85,34,26,0.001666667,627413,0.707661854
6502,393,498,34,26,0.001666667,627447,0.707700203
4087,640,354,33,26,0.001617647,627480,0.707737424
13684,392,242,33,26,0.001617647,627513,0.707774645
6471,295,640,33,26,0.001617647,627546,0.707811866
7646,207,27,33,26,0.001617647,627579,0.707849086
9266,562,367,33,26,0.001617647,627612,0.707886307
7494,673,243,32,26,0.001568627,627644,0.7079224
5002,558,348,32,26,0.001568627,627676,0.707958493
3691,562,314,32,26,0.001568627,627708,0.707994586
8029,31,196,32,26,0.001568627,627740,0.708030679
6104,107,427,32,26,0.001568627,627772,0.708066772
5209,379,6,31,26,0.001519608,627803,0.708101737
6735,2,331,31,26,0.001519608,627834,0.708136702
4732,196,313,31,26,0.001519608,627865,0.708171667
10219,393,605,31,26,0.001519608,627896,0.708206632
8500,236,682,31,26,0.001519608,627927,0.708241597
8187,528,609,30,26,0.001470588,627957,0.708275434
7394,552,311,28,26,0.001372549,627985,0.708307016
3656,614,68,76,25,0.00372549,628061,0.708392736
4006,20,126,66,25,0.003235294,628127,0.708467178
4191,535,394,64,25,0.003137255,628191,0.708539364
3296,473,107,63,25,0.003088235,628254,0.708610422
4816,674,33,63,25,0.003088235,628317,0.70868148
2658,4,367,60,25,0.002941176,628377,0.708749154
4610,140,27,60,25,0.002941176,628437,0.708816828
5946,347,64,60,25,0.002941176,628497,0.708884503
6071,348,30,60,25,0.002941176,628557,0.708952177
3219,501,379,58,25,0.002843137,628615,0.709017595
4684,95,302,58,25,0.002843137,628673,0.709083014
5170,689,347,57,25,0.002794118,628730,0.709147304
4250,196,310,56,25,0.002745098,628786,0.709210467
3275,562,167,55,25,0.002696078,628841,0.709272502
4276,673,302,54,25,0.002647059,628895,0.709333409
6258,596,242,54,25,0.002647059,628949,0.709394315
5956,385,367,54,25,0.002647059,629003,0.709455222
2937,32,26,54,25,0.002647059,629057,0.709516129
3311,242,353,54,25,0.002647059,629111,0.709577036
4992,380,502,53,25,0.002598039,629164,0.709636815
4959,328,334,53,25,0.002598039,629217,0.709696594
3590,12,443,53,25,0.002598039,629270,0.709756373
4867,95,522,52,25,0.00254902,629322,0.709815024
4374,25,16,52,25,0.00254902,629374,0.709873675
4004,236,313,52,25,0.00254902,629426,0.709932326
1861,313,532,52,25,0.00254902,629478,0.709990977
3305,9,145,52,25,0.00254902,629530,0.710049628
4939,471,9,52,25,0.00254902,629582,0.710108279
4291,31,6,52,25,0.00254902,629634,0.71016693
3176,10,307,51,25,0.0025,629685,0.710224453
3520,314,508,51,25,0.0025,629736,0.710281976
4375,663,6,51,25,0.0025,629787,0.710339499
2884,16,334,50,25,0.00245098,629837,0.710395894
3052,397,443,50,25,0.00245098,629887,0.71045229
4623,532,663,50,25,0.00245098,629937,0.710508685
5990,295,97,50,25,0.00245098,629987,0.71056508
2144,353,123,50,25,0.00245098,630037,0.710621475
5822,614,302,50,25,0.00245098,630087,0.710677871
6430,68,529,49,25,0.002401961,630136,0.710733138
5851,328,596,49,25,0.002401961,630185,0.710788405
2907,394,77,49,25,0.002401961,630234,0.710843672
4713,34,295,49,25,0.002401961,630283,0.71089894
5028,243,353,49,25,0.002401961,630332,0.710954207
3827,123,158,49,25,0.002401961,630381,0.711009474
6773,30,5,49,25,0.002401961,630430,0.711064742
5572,10,14,49,25,0.002401961,630479,0.711120009
4134,393,404,49,25,0.002401961,630528,0.711175276
6447,13,473,49,25,0.002401961,630577,0.711230544
5876,10,34,48,25,0.002352941,630625,0.711284683
2397,280,9,48,25,0.002352941,630673,0.711338822
2557,20,508,48,25,0.002352941,630721,0.711392962
4721,463,32,48,25,0.002352941,630769,0.711447101
6318,27,261,48,25,0.002352941,630817,0.711501241
2239,26,77,48,25,0.002352941,630865,0.71155538
3891,605,380,48,25,0.002352941,630913,0.71160952
6554,68,2,48,25,0.002352941,630961,0.711663659
4339,314,482,48,25,0.002352941,631009,0.711717798
6201,105,587,48,25,0.002352941,631057,0.711771938
5176,501,596,48,25,0.002352941,631105,0.711826077
7275,236,439,48,25,0.002352941,631153,0.711880217
6561,13,15,48,25,0.002352941,631201,0.711934356
5095,15,310,48,25,0.002352941,631249,0.711988495
7269,31,14,48,25,0.002352941,631297,0.712042635
5113,313,364,47,25,0.002303922,631344,0.712095646
7238,632,347,47,25,0.002303922,631391,0.712148658
4039,514,655,47,25,0.002303922,631438,0.712201669
6886,674,367,47,25,0.002303922,631485,0.712254681
4897,56,353,47,25,0.002303922,631532,0.712307692
4895,77,164,47,25,0.002303922,631579,0.712360704
4995,479,596,47,25,0.002303922,631626,0.712413715
3907,674,334,47,25,0.002303922,631673,0.712466727
6549,328,68,47,25,0.002303922,631720,0.712519738
4630,535,33,47,25,0.002303922,631767,0.71257275
4673,674,31,47,25,0.002303922,631814,0.712625761
4293,638,131,47,25,0.002303922,631861,0.712678773
4651,20,640,47,25,0.002303922,631908,0.712731784
7511,348,347,47,25,0.002303922,631955,0.712784796
2352,379,394,47,25,0.002303922,632002,0.712837807
5078,443,558,47,25,0.002303922,632049,0.712890819
7120,380,170,46,25,0.002254902,632095,0.712942702
5402,588,243,46,25,0.002254902,632141,0.712994586
5259,3,295,46,25,0.002254902,632187,0.71304647
5467,614,596,46,25,0.002254902,632233,0.713098353
5475,3,145,46,25,0.002254902,632279,0.713150237
4745,414,354,46,25,0.002254902,632325,0.71320212
6662,588,280,46,25,0.002254902,632371,0.713254004
3047,582,708,46,25,0.002254902,632417,0.713305888
4055,397,107,46,25,0.002254902,632463,0.713357771
1278,501,80,46,25,0.002254902,632509,0.713409655
7684,130,250,46,25,0.002254902,632555,0.713461538
6073,517,331,46,25,0.002254902,632601,0.713513422
5853,68,264,46,25,0.002254902,632647,0.713565306
4868,497,224,46,25,0.002254902,632693,0.713617189
4218,77,439,46,25,0.002254902,632739,0.713669073
5742,219,498,46,25,0.002254902,632785,0.713720956
4874,398,11,46,25,0.002254902,632831,0.71377284
2468,9,158,46,25,0.002254902,632877,0.713824724
4183,107,95,46,25,0.002254902,632923,0.713876607
5695,123,427,46,25,0.002254902,632969,0.713928491
5105,80,6,45,25,0.002205882,633014,0.713979247
4345,473,1,45,25,0.002205882,633059,0.714030002
5509,414,353,45,25,0.002205882,633104,0.714080758
6351,9,652,45,25,0.002205882,633149,0.714131514
6653,130,50,45,25,0.002205882,633194,0.714182269
6529,347,471,45,25,0.002205882,633239,0.714233025
5395,224,479,45,25,0.002205882,633284,0.714283781
6308,558,586,45,25,0.002205882,633329,0.714334536
4281,32,114,45,25,0.002205882,633374,0.714385292
6659,243,131,45,25,0.002205882,633419,0.714436048
3660,632,582,45,25,0.002205882,633464,0.714486804
4836,204,6,45,25,0.002205882,633509,0.714537559
5784,77,383,45,25,0.002205882,633554,0.714588315
4976,80,689,45,25,0.002205882,633599,0.714639071
5905,224,404,45,25,0.002205882,633644,0.714689826
5640,27,140,45,25,0.002205882,633689,0.714740582
5889,27,207,45,25,0.002205882,633734,0.714791338
7381,243,242,45,25,0.002205882,633779,0.714842093
4960,50,310,45,25,0.002205882,633824,0.714892849
3881,582,439,45,25,0.002205882,633869,0.714943605
3671,32,30,45,25,0.002205882,633914,0.71499436
5707,27,175,45,25,0.002205882,633959,0.715045116
4893,6,463,45,25,0.002205882,634004,0.715095872
4768,9,328,45,25,0.002205882,634049,0.715146628
4961,97,48,44,25,0.002156863,634093,0.715196255
3579,204,314,44,25,0.002156863,634137,0.715245883
6626,348,107,44,25,0.002156863,634181,0.715295511
4756,123,529,44,25,0.002156863,634225,0.715345139
4422,97,473,44,25,0.002156863,634269,0.715394767
7443,48,56,44,25,0.002156863,634313,0.715444394
5624,31,348,44,25,0.002156863,634357,0.715494022
7376,230,5,44,25,0.002156863,634401,0.71554365
4241,310,532,44,25,0.002156863,634445,0.715593278
4199,307,473,44,25,0.002156863,634489,0.715642905
6908,236,56,44,25,0.002156863,634533,0.715692533
3459,314,20,44,25,0.002156863,634577,0.715742161
6548,596,614,44,25,0.002156863,634621,0.715791789
3741,33,353,44,25,0.002156863,634665,0.715841417
6538,380,517,44,25,0.002156863,634709,0.715891044
4821,105,646,44,25,0.002156863,634753,0.715940672
6748,11,48,44,25,0.002156863,634797,0.7159903
6745,130,501,44,25,0.002156863,634841,0.716039928
4510,27,174,44,25,0.002156863,634885,0.716089556
7007,328,367,44,25,0.002156863,634929,0.716139183
5944,250,10,44,25,0.002156863,634973,0.716188811
4615,582,562,44,25,0.002156863,635017,0.716238439
6817,552,68,44,25,0.002156863,635061,0.716288067
5999,471,6,44,25,0.002156863,635105,0.716337695
3706,674,331,44,25,0.002156863,635149,0.716387322
5429,130,313,44,25,0.002156863,635193,0.71643695
6121,501,367,44,25,0.002156863,635237,0.716486578
6700,11,68,44,25,0.002156863,635281,0.716536206
6919,95,31,43,25,0.002107843,635324,0.716584706
10203,1,290,43,25,0.002107843,635367,0.716633206
5756,158,230,43,25,0.002107843,635410,0.716681705
6847,1,558,43,25,0.002107843,635453,0.716730205
6571,43,32,43,25,0.002107843,635496,0.716778705
5626,131,280,43,25,0.002107843,635539,0.716827205
7369,131,107,43,25,0.002107843,635582,0.716875705
5541,130,264,43,25,0.002107843,635625,0.716924205
5585,6,596,43,25,0.002107843,635668,0.716972705
4272,498,32,43,25,0.002107843,635711,0.717021205
3965,123,243,43,25,0.002107843,635754,0.717069704
4980,311,117,43,25,0.002107843,635797,0.717118204
4428,11,354,43,25,0.002107843,635840,0.717166704
4963,353,385,43,25,0.002107843,635883,0.717215204
4597,84,334,43,25,0.002107843,635926,0.717263704
2728,105,85,43,25,0.002107843,635969,0.717312204
3877,475,335,43,25,0.002107843,636012,0.717360704
4461,219,123,43,25,0.002107843,636055,0.717409204
4845,328,404,43,25,0.002107843,636098,0.717457704
6983,11,265,42,25,0.002058824,636140,0.717505076
5836,354,674,42,25,0.002058824,636182,0.717552448
4809,528,379,42,25,0.002058824,636224,0.71759982
4811,26,522,42,25,0.002058824,636266,0.717647192
5123,243,393,42,25,0.002058824,636308,0.717694564
7803,27,569,42,25,0.002058824,636350,0.717741935
4954,32,632,42,25,0.002058824,636392,0.717789307
4598,280,501,42,25,0.002058824,636434,0.717836679
3396,302,348,42,25,0.002058824,636476,0.717884051
6794,439,354,42,25,0.002058824,636518,0.717931423
4155,30,302,42,25,0.002058824,636560,0.717978795
7195,543,463,42,25,0.002058824,636602,0.718026167
4909,219,302,42,25,0.002058824,636644,0.718073539
4866,473,532,42,25,0.002058824,636686,0.718120911
4266,33,50,42,25,0.002058824,636728,0.718168283
4993,26,473,42,25,0.002058824,636770,0.718215655
4859,354,77,42,25,0.002058824,636812,0.718263027
5554,535,95,42,25,0.002058824,636854,0.718310399
4763,394,219,42,25,0.002058824,636896,0.718357771
3648,6,638,42,25,0.002058824,636938,0.718405143
6340,22,219,42,25,0.002058824,636980,0.718452515
4239,673,663,42,25,0.002058824,637022,0.718499887
2523,397,123,42,25,0.002058824,637064,0.718547259
8217,68,242,42,25,0.002058824,637106,0.718594631
1742,295,80,42,25,0.002058824,637148,0.718642003
5882,501,11,42,25,0.002058824,637190,0.718689375
8487,230,683,42,25,0.002058824,637232,0.718736747
4121,12,77,42,25,0.002058824,637274,0.718784119
5226,250,236,42,25,0.002058824,637316,0.718831491
4470,295,522,42,25,0.002058824,637358,0.718878863
4465,274,582,42,25,0.002058824,637400,0.718926235
4240,12,314,41,25,0.002009804,637441,0.718972479
7349,314,448,41,25,0.002009804,637482,0.719018723
7472,335,126,41,25,0.002009804,637523,0.719064967
3188,414,314,41,25,0.002009804,637564,0.719111211
4974,105,29,41,25,0.002009804,637605,0.719157455
3629,501,9,41,25,0.002009804,637646,0.7192037
3553,33,77,41,25,0.002009804,637687,0.719249944
4714,674,394,41,25,0.002009804,637728,0.719296188
4230,614,26,41,25,0.002009804,637769,0.719342432
7495,313,682,41,25,0.002009804,637810,0.719388676
4955,501,397,41,25,0.002009804,637851,0.71943492
8824,443,714,41,25,0.002009804,637892,0.719481164
5862,614,219,41,25,0.002009804,637933,0.719527408
7834,171,6,41,25,0.002009804,637974,0.719573652
4165,33,84,41,25,0.002009804,638015,0.719619896
6046,25,274,41,25,0.002009804,638056,0.71966614
5175,95,379,41,25,0.002009804,638097,0.719712384
6975,471,95,41,25,0.002009804,638138,0.719758628
6221,5,479,41,25,0.002009804,638179,0.719804873
7880,394,414,41,25,0.002009804,638220,0.719851117
5705,674,11,41,25,0.002009804,638261,0.719897361
6383,50,311,40,25,0.001960784,638301,0.719942477
6540,501,131,40,25,0.001960784,638341,0.719987593
6386,80,14,40,25,0.001960784,638381,0.720032709
3710,310,26,40,25,0.001960784,638421,0.720077825
5250,310,463,40,25,0.001960784,638461,0.720122942
6990,588,1,40,25,0.001960784,638501,0.720168058
4493,295,638,40,25,0.001960784,638541,0.720213174
6599,243,164,40,25,0.001960784,638581,0.72025829
5507,130,471,40,25,0.001960784,638621,0.720303406
4322,655,280,40,25,0.001960784,638661,0.720348522
7649,80,646,40,25,0.001960784,638701,0.720393639
6889,663,170,40,25,0.001960784,638741,0.720438755
7543,236,97,40,25,0.001960784,638781,0.720483871
8462,347,68,40,25,0.001960784,638821,0.720528987
5075,414,311,40,25,0.001960784,638861,0.720574103
7865,48,307,40,25,0.001960784,638901,0.720619219
3059,498,9,40,25,0.001960784,638941,0.720664336
6897,204,498,40,25,0.001960784,638981,0.720709452
5580,107,497,40,25,0.001960784,639021,0.720754568
7332,117,311,40,25,0.001960784,639061,0.720799684
6462,331,502,40,25,0.001960784,639101,0.7208448
7290,43,9,40,25,0.001960784,639141,0.720889917
7227,311,364,40,25,0.001960784,639181,0.720935033
8596,13,558,40,25,0.001960784,639221,0.720980149
6884,145,471,39,25,0.001911765,639260,0.721024137
6723,3,280,39,25,0.001911765,639299,0.721068125
6845,502,397,39,25,0.001911765,639338,0.721112114
4446,331,145,39,25,0.001911765,639377,0.721156102
7558,394,347,39,25,0.001911765,639416,0.72120009
7481,663,562,39,25,0.001911765,639455,0.721244079
6165,335,508,39,25,0.001911765,639494,0.721288067
5430,10,535,39,25,0.001911765,639533,0.721332055
6241,618,473,39,25,0.001911765,639572,0.721376043
4977,3,638,39,25,0.001911765,639611,0.721420032
6411,158,522,39,25,0.001911765,639650,0.72146402
6972,224,682,39,25,0.001911765,639689,0.721508008
6962,347,310,39,25,0.001911765,639728,0.721551996
7122,3,398,39,25,0.001911765,639767,0.721595985
5588,404,310,39,25,0.001911765,639806,0.721639973
3363,353,334,39,25,0.001911765,639845,0.721683961
5571,243,532,39,25,0.001911765,639884,0.721727949
4203,313,614,39,25,0.001911765,639923,0.721771938
6122,250,243,39,25,0.001911765,639962,0.721815926
5936,380,14,38,25,0.001862745,640000,0.721858786
4609,475,48,38,25,0.001862745,640038,0.721901647
6457,367,663,38,25,0.001862745,640076,0.721944507
4660,15,80,38,25,0.001862745,640114,0.721987367
6480,479,204,38,25,0.001862745,640152,0.722030228
6287,335,714,38,25,0.001862745,640190,0.722073088
4312,32,50,38,25,0.001862745,640228,0.722115949
5273,2,230,38,25,0.001862745,640266,0.722158809
7766,48,114,38,25,0.001862745,640304,0.722201669
7631,34,15,38,25,0.001862745,640342,0.72224453
5001,638,15,38,25,0.001862745,640380,0.72228739
4899,544,582,38,25,0.001862745,640418,0.72233025
8301,123,528,38,25,0.001862745,640456,0.722373111
8248,655,274,38,25,0.001862745,640494,0.722415971
8221,5,32,38,25,0.001862745,640532,0.722458831
6999,131,596,38,25,0.001862745,640570,0.722501692
3940,497,314,38,25,0.001862745,640608,0.722544552
6714,498,393,38,25,0.001862745,640646,0.722587413
4793,379,107,38,25,0.001862745,640684,0.722630273
6755,230,404,38,25,0.001862745,640722,0.722673133
5728,311,632,38,25,0.001862745,640760,0.722715994
4726,674,145,38,25,0.001862745,640798,0.722758854
3625,30,105,38,25,0.001862745,640836,0.722801714
6613,314,140,38,25,0.001862745,640874,0.722844575
2225,596,334,37,25,0.001813725,640911,0.722886307
6767,236,427,37,25,0.001813725,640948,0.72292804
8144,68,156,37,25,0.001813725,640985,0.722969772
9056,385,107,37,25,0.001813725,641022,0.723011505
8926,56,385,37,25,0.001813725,641059,0.723053237
6656,114,311,37,25,0.001813725,641096,0.72309497
8757,535,242,37,25,0.001813725,641133,0.723136702
6602,156,310,37,25,0.001813725,641170,0.723178434
3280,663,158,37,25,0.001813725,641207,0.723220167
4169,638,313,37,25,0.001813725,641244,0.723261899
7291,511,16,37,25,0.001813725,641281,0.723303632
6422,280,48,37,25,0.001813725,641318,0.723345364
7136,145,313,37,25,0.001813725,641355,0.723387097
6316,311,562,37,25,0.001813725,641392,0.723428829
6851,236,22,37,25,0.001813725,641429,0.723470562
7486,204,723,37,25,0.001813725,641466,0.723512294
7981,107,196,37,25,0.001813725,641503,0.723554027
8222,27,624,37,25,0.001813725,641540,0.723595759
6076,20,219,37,25,0.001813725,641577,0.723637492
5090,145,9,37,25,0.001813725,641614,0.723679224
4956,20,34,37,25,0.001813725,641651,0.723720956
5850,250,586,37,25,0.001813725,641688,0.723762689
5611,596,6,37,25,0.001813725,641725,0.723804421
5954,48,443,37,25,0.001813725,641762,0.723846154
6390,77,503,36,25,0.001764706,641798,0.723886758
4233,95,6,36,25,0.001764706,641834,0.723927363
5018,532,107,36,25,0.001764706,641870,0.723967968
6496,204,380,36,25,0.001764706,641906,0.724008572
5198,1,32,36,25,0.001764706,641942,0.724049177
7304,56,26,36,25,0.001764706,641978,0.724089781
5592,586,498,36,25,0.001764706,642014,0.724130386
7912,80,4,36,25,0.001764706,642050,0.72417099
3004,673,10,36,25,0.001764706,642086,0.724211595
7694,463,3,36,25,0.001764706,642122,0.724252199
6682,473,56,36,25,0.001764706,642158,0.724292804
8521,463,497,35,25,0.001715686,642193,0.724332281
6964,123,562,35,25,0.001715686,642228,0.724371757
6600,393,328,35,25,0.001715686,642263,0.724411234
5275,367,26,35,25,0.001715686,642298,0.724450711
5488,33,632,35,25,0.001715686,642333,0.724490187
6724,593,532,35,25,0.001715686,642368,0.724529664
8391,463,663,35,25,0.001715686,642403,0.724569141
4092,397,532,35,25,0.001715686,642438,0.724608617
9161,34,498,35,25,0.001715686,642473,0.724648094
4948,32,640,35,25,0.001715686,642508,0.72468757
5225,393,302,35,25,0.001715686,642543,0.724727047
7434,498,596,35,25,0.001715686,642578,0.724766524
7342,618,196,35,25,0.001715686,642613,0.724806
4367,586,26,35,25,0.001715686,642648,0.724845477
5745,331,196,34,25,0.001666667,642682,0.724883826
9381,528,48,34,25,0.001666667,642716,0.724922175
5584,242,105,34,25,0.001666667,642750,0.724960523
8945,663,265,34,25,0.001666667,642784,0.724998872
5835,593,105,34,25,0.001666667,642818,0.725037221
8003,114,379,34,25,0.001666667,642852,0.72507557
5322,302,84,34,25,0.001666667,642886,0.725113918
6461,471,522,34,25,0.001666667,642920,0.725152267
8589,618,15,34,25,0.001666667,642954,0.725190616
8616,16,552,34,25,0.001666667,642988,0.725228965
6766,25,586,34,25,0.001666667,643022,0.725267313
6963,535,243,34,25,0.001666667,643056,0.725305662
2653,514,158,34,25,0.001666667,643090,0.725344011
7458,280,385,34,25,0.001666667,643124,0.72538236
11390,332,280,33,25,0.001617647,643157,0.72541958
6896,6,443,33,25,0.001617647,643190,0.725456801
5792,6,195,33,25,0.001617647,643223,0.725494022
7997,311,502,33,25,0.001617647,643256,0.725531243
4153,97,105,33,25,0.001617647,643289,0.725568464
5868,12,354,33,25,0.001617647,643322,0.725605685
11766,80,269,33,25,0.001617647,643355,0.725642905
5253,280,558,33,25,0.001617647,643388,0.725680126
11933,552,640,33,25,0.001617647,643421,0.725717347
9580,34,517,33,25,0.001617647,643454,0.725754568
8220,497,131,33,25,0.001617647,643487,0.725791789
5763,385,84,32,25,0.001568627,643519,0.725827882
9908,543,394,32,25,0.001568627,643551,0.725863975
9651,393,439,32,25,0.001568627,643583,0.725900068
8044,158,243,32,25,0.001568627,643615,0.725936161
6729,311,4,32,25,0.001568627,643647,0.725972254
8602,219,479,31,25,0.001519608,643678,0.726007219
8218,107,164,31,25,0.001519608,643709,0.726042184
10773,544,48,31,25,0.001519608,643740,0.726077149
8070,163,380,30,25,0.001470588,643770,0.726110986
8299,558,544,30,25,0.001470588,643800,0.726144823
10317,174,16,30,25,0.001470588,643830,0.72617866
11074,56,646,30,25,0.001470588,643860,0.726212497
12524,479,446,27,25,0.001323529,643887,0.726242951
13562,342,367,26,25,0.00127451,643913,0.726272276
2569,379,84,55,24,0.002696078,643968,0.726334311
4619,56,3,52,24,0.00254902,644020,0.726392962
6074,379,328,52,24,0.00254902,644072,0.726451613
5590,105,121,52,24,0.00254902,644124,0.726510264
2333,367,77,51,24,0.0025,644175,0.726567787
3480,16,11,51,24,0.0025,644226,0.72662531
5206,20,167,51,24,0.0025,644277,0.726682833
4073,310,723,51,24,0.0025,644328,0.726740356
4994,274,280,50,24,0.00245098,644378,0.726796752
4844,250,473,50,24,0.00245098,644428,0.726853147
4916,552,32,50,24,0.00245098,644478,0.726909542
3593,582,130,49,24,0.002401961,644527,0.726964809
5003,130,170,48,24,0.002352941,644575,0.727018949
4999,123,97,48,24,0.002352941,644623,0.727073088
6705,663,674,48,24,0.002352941,644671,0.727127228
4583,33,535,48,24,0.002352941,644719,0.727181367
5088,158,9,48,24,0.002352941,644767,0.727235506
4516,3,84,48,24,0.002352941,644815,0.727289646
6284,56,236,48,24,0.002352941,644863,0.727343785
2758,31,20,48,24,0.002352941,644911,0.727397925
4360,310,674,47,24,0.002303922,644958,0.727450936
3765,32,295,47,24,0.002303922,645005,0.727503948
6605,68,25,47,24,0.002303922,645052,0.727556959
4525,311,14,47,24,0.002303922,645099,0.727609971
6694,473,614,47,24,0.002303922,645146,0.727662982
4119,404,394,47,24,0.002303922,645193,0.727715994
6793,204,95,47,24,0.002303922,645240,0.727769005
3665,380,158,46,24,0.002254902,645286,0.727820889
5052,20,558,46,24,0.002254902,645332,0.727872772
5278,243,367,46,24,0.002254902,645378,0.727924656
7211,224,502,46,24,0.002254902,645424,0.72797654
5551,663,394,46,24,0.002254902,645470,0.728028423
5427,123,114,46,24,0.002254902,645516,0.728080307
5807,609,443,46,24,0.002254902,645562,0.72813219
7894,427,32,46,24,0.002254902,645608,0.728184074
4740,311,204,46,24,0.002254902,645654,0.728235958
4565,314,683,46,24,0.002254902,645700,0.728287841
3860,280,32,46,24,0.002254902,645746,0.728339725
6518,280,23,46,24,0.002254902,645792,0.728391608
4130,463,9,46,24,0.002254902,645838,0.728443492
2334,4,27,45,24,0.002205882,645883,0.728494248
5966,145,311,45,24,0.002205882,645928,0.728545003
5419,77,392,45,24,0.002205882,645973,0.728595759
5177,314,156,45,24,0.002205882,646018,0.728646515
6594,25,514,45,24,0.002205882,646063,0.72869727
4473,6,11,45,24,0.002205882,646108,0.728748026
7259,224,385,45,24,0.002205882,646153,0.728798782
5446,673,311,45,24,0.002205882,646198,0.728849538
5607,15,204,45,24,0.002205882,646243,0.728900293
5754,84,141,45,24,0.002205882,646288,0.728951049
4770,30,131,45,24,0.002205882,646333,0.729001805
4892,475,31,45,24,0.002205882,646378,0.72905256
4749,353,663,45,24,0.002205882,646423,0.729103316
5522,596,348,45,24,0.002205882,646468,0.729154072
7028,236,562,45,24,0.002205882,646513,0.729204827
7464,335,587,44,24,0.002156863,646557,0.729254455
5166,348,170,44,24,0.002156863,646601,0.729304083
4030,586,397,44,24,0.002156863,646645,0.729353711
7157,236,196,44,24,0.002156863,646689,0.729403339
6387,596,501,44,24,0.002156863,646733,0.729452966
6283,558,130,44,24,0.002156863,646777,0.729502594
5365,463,230,44,24,0.002156863,646821,0.729552222
8145,463,15,44,24,0.002156863,646865,0.72960185
6829,43,230,44,24,0.002156863,646909,0.729651478
5425,131,586,44,24,0.002156863,646953,0.729701105
7644,328,479,44,24,0.002156863,646997,0.729750733
5923,479,353,44,24,0.002156863,647041,0.729800361
5043,280,242,44,24,0.002156863,647085,0.729849989
3882,393,84,44,24,0.002156863,647129,0.729899617
5985,618,348,44,24,0.002156863,647173,0.729949244
8396,535,463,44,24,0.002156863,647217,0.729998872
3082,367,588,44,24,0.002156863,647261,0.7300485
4481,614,310,44,24,0.002156863,647305,0.730098128
6103,588,414,44,24,0.002156863,647349,0.730147755
3851,32,64,44,24,0.002156863,647393,0.730197383
4013,295,6,44,24,0.002156863,647437,0.730247011
6182,6,167,43,24,0.002107843,647480,0.730295511
7461,236,364,43,24,0.002107843,647523,0.730344011
5671,11,586,43,24,0.002107843,647566,0.730392511
5950,609,117,43,24,0.002107843,647609,0.730441011
6375,353,50,43,24,0.002107843,647652,0.73048951
7772,348,544,43,24,0.002107843,647695,0.73053801
5919,588,708,43,24,0.002107843,647738,0.73058651
6967,250,404,43,24,0.002107843,647781,0.73063501
7703,354,497,43,24,0.002107843,647824,0.73068351
6242,171,295,43,24,0.002107843,647867,0.73073201
6226,26,250,43,24,0.002107843,647910,0.73078051
7725,43,588,43,24,0.002107843,647953,0.73082901
5597,479,64,43,24,0.002107843,647996,0.73087751
6731,97,16,43,24,0.002107843,648039,0.730926009
5561,196,14,43,24,0.002107843,648082,0.730974509
8799,552,6,43,24,0.002107843,648125,0.731023009
8150,33,167,43,24,0.002107843,648168,0.731071509
4661,479,77,43,24,0.002107843,648211,0.731120009
4519,48,397,43,24,0.002107843,648254,0.731168509
4922,243,331,43,24,0.002107843,648297,0.731217009
5233,614,32,43,24,0.002107843,648340,0.731265509
3513,475,588,43,24,0.002107843,648383,0.731314009
4301,97,302,43,24,0.002107843,648426,0.731362508
3048,32,397,43,24,0.002107843,648469,0.731411008
3814,311,414,43,24,0.002107843,648512,0.731459508
4158,609,335,43,24,0.002107843,648555,0.731508008
4477,328,123,43,24,0.002107843,648598,0.731556508
4162,528,80,43,24,0.002107843,648641,0.731605008
5530,558,11,42,24,0.002058824,648683,0.73165238
4847,313,544,42,24,0.002058824,648725,0.731699752
5451,501,280,42,24,0.002058824,648767,0.731747124
5456,193,15,42,24,0.002058824,648809,0.731794496
5457,123,204,42,24,0.002058824,648851,0.731841868
5470,56,379,42,24,0.002058824,648893,0.73188924
3193,640,224,42,24,0.002058824,648935,0.731936612
4228,26,501,42,24,0.002058824,648977,0.731983984
7219,131,64,42,24,0.002058824,649019,0.732031356
5637,596,33,42,24,0.002058824,649061,0.732078728
7426,473,85,42,24,0.002058824,649103,0.7321261
6417,15,230,42,24,0.002058824,649145,0.732173472
5587,33,674,42,24,0.002058824,649187,0.732220844
4755,394,473,42,24,0.002058824,649229,0.732268216
6531,80,25,42,24,0.002058824,649271,0.732315588
4409,123,196,42,24,0.002058824,649313,0.73236296
4061,398,397,42,24,0.002058824,649355,0.732410332
4464,586,335,42,24,0.002058824,649397,0.732457704
5279,674,532,42,24,0.002058824,649439,0.732505076
8059,5,347,42,24,0.002058824,649481,0.732552448
5280,2,348,42,24,0.002058824,649523,0.73259982
4970,674,313,41,24,0.002009804,649564,0.732646064
6743,3,501,41,24,0.002009804,649605,0.732692308
4936,243,582,41,24,0.002009804,649646,0.732738552
6382,84,663,41,24,0.002009804,649687,0.732784796
7182,507,16,41,24,0.002009804,649728,0.73283104
6623,265,529,41,24,0.002009804,649769,0.732877284
6451,385,596,41,24,0.002009804,649810,0.732923528
5881,219,31,41,24,0.002009804,649851,0.732969772
4908,130,588,41,24,0.002009804,649892,0.733016016
6957,6,294,41,24,0.002009804,649933,0.73306226
5838,131,243,41,24,0.002009804,649974,0.733108504
6979,84,31,41,24,0.002009804,650015,0.733154748
4823,22,655,41,24,0.002009804,650056,0.733200993
4535,6,532,41,24,0.002009804,650097,0.733247237
7879,48,280,41,24,0.002009804,650138,0.733293481
2847,596,123,41,24,0.002009804,650179,0.733339725
6931,84,347,41,24,0.002009804,650220,0.733385969
5183,479,334,41,24,0.002009804,650261,0.733432213
6086,236,528,41,24,0.002009804,650302,0.733478457
5757,105,140,40,24,0.001960784,650342,0.733523573
7042,131,97,40,24,0.001960784,650382,0.733568689
6445,307,15,40,24,0.001960784,650422,0.733613806
5740,475,196,40,24,0.001960784,650462,0.733658922
6842,77,12,40,24,0.001960784,650502,0.733704038
7166,22,224,40,24,0.001960784,650542,0.733749154
6542,439,380,40,24,0.001960784,650582,0.73379427
6959,640,167,40,24,0.001960784,650622,0.733839386
5945,97,32,40,24,0.001960784,650662,0.733884503
5255,558,588,40,24,0.001960784,650702,0.733929619
7671,171,638,40,24,0.001960784,650742,0.733974735
5060,632,380,40,24,0.001960784,650782,0.734019851
5818,145,522,40,24,0.001960784,650822,0.734064967
2843,9,529,40,24,0.001960784,650862,0.734110083
6034,502,25,40,24,0.001960784,650902,0.7341552
5434,12,655,40,24,0.001960784,650942,0.734200316
5910,353,535,40,24,0.001960784,650982,0.734245432
5133,48,663,40,24,0.001960784,651022,0.734290548
5154,219,532,40,24,0.001960784,651062,0.734335664
6205,310,34,40,24,0.001960784,651102,0.734380781
4542,532,562,40,24,0.001960784,651142,0.734425897
5463,10,398,40,24,0.001960784,651182,0.734471013
8186,502,265,40,24,0.001960784,651222,0.734516129
3997,265,380,40,24,0.001960784,651262,0.734561245
8633,243,274,40,24,0.001960784,651302,0.734606361
6154,131,529,40,24,0.001960784,651342,0.734651478
4966,393,48,40,24,0.001960784,651382,0.734696594
4968,16,497,40,24,0.001960784,651422,0.73474171
4242,310,307,40,24,0.001960784,651462,0.734786826
7415,334,367,40,24,0.001960784,651502,0.734831942
6533,443,347,40,24,0.001960784,651542,0.734877058
6506,307,347,39,24,0.001911765,651581,0.734921047
6805,145,95,39,24,0.001911765,651620,0.734965035
6856,331,54,39,24,0.001911765,651659,0.735009023
6612,348,158,39,24,0.001911765,651698,0.735053012
6820,6,243,39,24,0.001911765,651737,0.735097
3937,105,511,39,24,0.001911765,651776,0.735140988
6448,2,16,39,24,0.001911765,651815,0.735184976
6857,219,471,39,24,0.001911765,651854,0.735228965
3273,586,529,39,24,0.001911765,651893,0.735272953
7640,12,219,39,24,0.001911765,651932,0.735316941
7580,236,14,39,24,0.001911765,651971,0.735360929
5354,307,313,39,24,0.001911765,652010,0.735404918
5193,11,131,39,24,0.001911765,652049,0.735448906
8033,529,242,39,24,0.001911765,652088,0.735492894
5437,624,348,39,24,0.001911765,652127,0.735536882
7876,230,514,39,24,0.001911765,652166,0.735580871
3058,331,264,39,24,0.001911765,652205,0.735624859
7133,243,141,39,24,0.001911765,652244,0.735668847
4891,473,54,39,24,0.001911765,652283,0.735712836
7095,224,156,39,24,0.001911765,652322,0.735756824
4179,307,335,39,24,0.001911765,652361,0.735800812
5957,394,10,39,24,0.001911765,652400,0.7358448
6434,302,532,39,24,0.001911765,652439,0.735888789
5746,311,605,39,24,0.001911765,652478,0.735932777
7366,379,347,39,24,0.001911765,652517,0.735976765
4459,123,280,39,24,0.001911765,652556,0.736020753
7190,588,364,39,24,0.001911765,652595,0.736064742
6158,314,605,38,24,0.001862745,652633,0.736107602
4448,379,3,38,24,0.001862745,652671,0.736150462
6400,105,167,38,24,0.001862745,652709,0.736193323
6393,313,170,38,24,0.001862745,652747,0.736236183
5974,43,380,38,24,0.001862745,652785,0.736279044
6555,48,463,38,24,0.001862745,652823,0.736321904
5922,632,230,38,24,0.001862745,652861,0.736364764
4545,614,9,38,24,0.001862745,652899,0.736407625
5128,264,394,38,24,0.001862745,652937,0.736450485
8057,230,682,38,24,0.001862745,652975,0.736493345
7278,27,85,38,24,0.001862745,653013,0.736536206
8956,535,15,38,24,0.001862745,653051,0.736579066
8174,535,347,38,24,0.001862745,653089,0.736621926
5178,443,473,38,24,0.001862745,653127,0.736664787
6951,174,204,38,24,0.001862745,653165,0.736707647
4812,475,32,38,24,0.001862745,653203,0.736750508
6764,11,471,38,24,0.001862745,653241,0.736793368
6621,27,193,38,24,0.001862745,653279,0.736836228
6658,497,243,38,24,0.001862745,653317,0.736879089
6632,380,544,38,24,0.001862745,653355,0.736921949
6611,522,196,38,24,0.001862745,653393,0.736964809
6463,522,14,37,24,0.001813725,653430,0.737006542
6678,3,107,37,24,0.001813725,653467,0.737048274
6956,114,9,37,24,0.001813725,653504,0.737090007
3420,514,84,37,24,0.001813725,653541,0.737131739
7014,56,394,37,24,0.001813725,653578,0.737173472
3493,1,20,37,24,0.001813725,653615,0.737215204
7021,5,68,37,24,0.001813725,653652,0.737256937
6459,632,475,37,24,0.001813725,653689,0.737298669
7756,3,130,37,24,0.001813725,653726,0.737340402
7655,588,385,37,24,0.001813725,653763,0.737382134
5542,310,97,37,24,0.001813725,653800,0.737423866
5682,123,14,37,24,0.001813725,653837,0.737465599
5099,310,385,37,24,0.001813725,653874,0.737507331
5218,673,219,37,24,0.001813725,653911,0.737549064
6562,1,15,36,24,0.001764706,653947,0.737589668
4202,501,230,36,24,0.001764706,653983,0.737630273
8327,353,163,36,24,0.001764706,654019,0.737670878
12989,535,569,36,24,0.001764706,654055,0.737711482
4850,463,335,36,24,0.001764706,654091,0.737752087
9816,13,632,36,24,0.001764706,654127,0.737792691
6585,105,383,36,24,0.001764706,654163,0.737833296
5353,609,219,36,24,0.001764706,654199,0.7378739
5934,331,25,36,24,0.001764706,654235,0.737914505
5004,30,313,36,24,0.001764706,654271,0.737955109
4907,302,307,36,24,0.001764706,654307,0.737995714
8447,380,54,36,24,0.001764706,654343,0.738036319
6619,3,196,36,24,0.001764706,654379,0.738076923
11290,224,163,36,24,0.001764706,654415,0.738117528
5523,517,335,36,24,0.001764706,654451,0.738158132
4227,379,655,36,24,0.001764706,654487,0.738198737
6184,123,130,36,24,0.001764706,654523,0.738239341
9165,348,404,36,24,0.001764706,654559,0.738279946
3754,498,10,36,24,0.001764706,654595,0.73832055
3903,313,398,36,24,0.001764706,654631,0.738361155
8134,354,439,36,24,0.001764706,654667,0.73840176
7776,163,243,36,24,0.001764706,654703,0.738442364
5812,522,427,36,24,0.001764706,654739,0.738482969
6740,663,614,36,24,0.001764706,654775,0.738523573
6213,56,354,36,24,0.001764706,654811,0.738564178
7861,107,543,36,24,0.001764706,654847,0.738604782
5854,479,34,36,24,0.001764706,654883,0.738645387
6977,347,131,36,24,0.001764706,654919,0.738685991
5635,663,535,36,24,0.001764706,654955,0.738726596
3810,514,380,36,24,0.001764706,654991,0.738767201
6980,34,463,36,24,0.001764706,655027,0.738807805
7890,114,10,36,24,0.001764706,655063,0.73884841
7875,219,348,35,24,0.001715686,655098,0.738887886
7533,398,250,35,24,0.001715686,655133,0.738927363
10479,171,14,35,24,0.001715686,655168,0.73896684
6891,353,501,35,24,0.001715686,655203,0.739006316
8286,354,141,35,24,0.001715686,655238,0.739045793
5503,379,307,35,24,0.001715686,655273,0.73908527
7688,34,354,35,24,0.001715686,655308,0.739124746
6630,498,164,35,24,0.001715686,655343,0.739164223
8293,613,380,35,24,0.001715686,655378,0.7392037
6925,609,398,35,24,0.001715686,655413,0.739243176
5921,1,230,35,24,0.001715686,655448,0.739282653
6553,2,224,35,24,0.001715686,655483,0.739322129
7706,328,414,35,24,0.001715686,655518,0.739361606
8139,334,9,35,24,0.001715686,655553,0.739401083
6544,31,131,35,24,0.001715686,655588,0.739440559
5501,614,236,35,24,0.001715686,655623,0.739480036
6134,393,280,35,24,0.001715686,655658,0.739519513
7174,250,26,35,24,0.001715686,655693,0.739558989
4424,632,105,35,24,0.001715686,655728,0.739598466
5655,532,33,35,24,0.001715686,655763,0.739637943
7436,138,353,35,24,0.001715686,655798,0.739677419
4941,463,123,35,24,0.001715686,655833,0.739716896
5977,314,646,35,24,0.001715686,655868,0.739756373
11138,145,427,34,24,0.001666667,655902,0.739794721
6051,26,313,34,24,0.001666667,655936,0.73983307
8317,171,204,34,24,0.001666667,655970,0.739871419
7761,114,11,34,24,0.001666667,656004,0.739909768
6550,562,311,34,24,0.001666667,656038,0.739948116
6661,586,250,34,24,0.001666667,656072,0.739986465
6635,219,236,34,24,0.001666667,656106,0.740024814
10318,10,517,34,24,0.001666667,656140,0.740063163
6586,347,9,34,24,0.001666667,656174,0.740101511
6997,3,141,34,24,0.001666667,656208,0.74013986
7705,224,30,34,24,0.001666667,656242,0.740178209
5840,398,68,34,24,0.001666667,656276,0.740216558
7739,479,54,34,24,0.001666667,656310,0.740254906
2853,463,80,34,24,0.001666667,656344,0.740293255
6468,20,33,34,24,0.001666667,656378,0.740331604
6314,398,224,34,24,0.001666667,656412,0.740369953
6811,84,295,34,24,0.001666667,656446,0.740408301
7266,439,310,34,24,0.001666667,656480,0.74044665
5455,22,353,34,24,0.001666667,656514,0.740484999
3846,393,334,34,24,0.001666667,656548,0.740523348
7250,674,50,34,24,0.001666667,656582,0.740561696
7302,552,219,34,24,0.001666667,656616,0.740600045
8987,68,265,34,24,0.001666667,656650,0.740638394
4556,133,27,34,24,0.001666667,656684,0.740676743
6062,20,105,33,24,0.001617647,656717,0.740713963
7329,54,314,33,24,0.001617647,656750,0.740751184
7962,311,552,33,24,0.001617647,656783,0.740788405
6172,394,532,33,24,0.001617647,656816,0.740825626
8999,130,274,33,24,0.001617647,656849,0.740862847
7722,471,77,33,24,0.001617647,656882,0.740900068
9713,156,31,33,24,0.001617647,656915,0.740937289
3207,582,158,33,24,0.001617647,656948,0.740974509
7145,204,543,33,24,0.001617647,656981,0.74101173
5855,16,114,33,24,0.001617647,657014,0.741048951
4207,26,311,33,24,0.001617647,657047,0.741086172
8767,236,269,33,24,0.001617647,657080,0.741123393
12509,124,204,33,24,0.001617647,657113,0.741160614
7390,398,586,32,24,0.001568627,657145,0.741196707
7664,280,31,32,24,0.001568627,657177,0.741232799
7666,158,145,32,24,0.001568627,657209,0.741268892
3434,9,242,32,24,0.001568627,657241,0.741304985
7240,558,640,32,24,0.001568627,657273,0.741341078
2783,9,535,32,24,0.001568627,657305,0.741377171
8199,347,295,32,24,0.001568627,657337,0.741413264
9827,562,529,32,24,0.001568627,657369,0.741449357
4614,26,614,32,24,0.001568627,657401,0.74148545
8520,204,331,32,24,0.001568627,657433,0.741521543
9808,80,517,32,24,0.001568627,657465,0.741557636
6517,331,164,32,24,0.001568627,657497,0.741593729
8321,80,34,32,24,0.001568627,657529,0.741629822
6785,353,31,32,24,0.001568627,657561,0.741665915
6808,280,163,32,24,0.001568627,657593,0.741702008
9274,427,302,32,24,0.001568627,657625,0.741738101
9980,335,207,32,24,0.001568627,657657,0.741774194
6744,497,230,32,24,0.001568627,657689,0.741810286
6192,522,614,32,24,0.001568627,657721,0.741846379
8565,353,723,31,24,0.001519608,657752,0.741881344
5221,609,354,31,24,0.001519608,657783,0.741916309
7388,347,123,31,24,0.001519608,657814,0.741951275
6670,532,609,31,24,0.001519608,657845,0.74198624
10900,379,156,31,24,0.001519608,657876,0.742021205
7601,16,689,31,24,0.001519608,657907,0.74205617
5257,2,9,30,24,0.001470588,657937,0.742090007
8976,522,414,30,24,0.001470588,657967,0.742123844
9493,114,529,30,24,0.001470588,657997,0.742157681
8510,2,632,30,24,0.001470588,658027,0.742191518
3475,443,123,30,24,0.001470588,658057,0.742225355
7080,13,68,30,24,0.001470588,658087,0.742259192
11312,463,107,30,24,0.001470588,658117,0.74229303
8709,33,126,29,24,0.001421569,658146,0.742325739
8271,535,398,29,24,0.001421569,658175,0.742358448
6116,479,307,29,24,0.001421569,658204,0.742391157
10985,511,640,28,24,0.001372549,658232,0.742422739
9829,552,48,28,24,0.001372549,658260,0.74245432
9914,34,236,27,24,0.001323529,658287,0.742484773
5207,529,586,27,24,0.001323529,658314,0.742515227
3663,230,280,57,23,0.002794118,658371,0.742579517
5286,614,471,54,23,0.002647059,658425,0.742640424
3580,379,334,54,23,0.002647059,658479,0.742701331
6001,48,196,51,23,0.0025,658530,0.742758854
4460,314,502,50,23,0.00245098,658580,0.742815249
4501,674,170,49,23,0.002401961,658629,0.742870517
3790,32,674,49,23,0.002401961,658678,0.742925784
10906,535,90,48,23,0.002352941,658726,0.742979923
4341,2,310,48,23,0.002352941,658774,0.743034063
6934,230,274,47,23,0.002303922,658821,0.743087074
5089,250,11,47,23,0.002303922,658868,0.743140086
4860,367,558,47,23,0.002303922,658915,0.743193097
6210,353,196,47,23,0.002303922,658962,0.743246109
4863,674,535,47,23,0.002303922,659009,0.74329912
4641,479,638,47,23,0.002303922,659056,0.743352132
5871,80,427,47,23,0.002303922,659103,0.743405143
3847,609,16,47,23,0.002303922,659150,0.743458155
6500,479,250,47,23,0.002303922,659197,0.743511166
5191,295,48,46,23,0.002254902,659243,0.74356305
5048,588,532,46,23,0.002254902,659289,0.743614933
3738,529,25,46,23,0.002254902,659335,0.743666817
5502,354,307,46,23,0.002254902,659381,0.743718701
4369,397,609,46,23,0.002254902,659427,0.743770584
4561,498,397,46,23,0.002254902,659473,0.743822468
6460,48,348,46,23,0.002254902,659519,0.743874351
6333,502,353,46,23,0.002254902,659565,0.743926235
3050,123,393,45,23,0.002205882,659610,0.743976991
5165,479,394,45,23,0.002205882,659655,0.744027746
5377,6,2,45,23,0.002205882,659700,0.744078502
7264,6,517,45,23,0.002205882,659745,0.744129258
4817,250,529,45,23,0.002205882,659790,0.744180014
3713,310,158,45,23,0.002205882,659835,0.744230769
4653,84,32,45,23,0.002205882,659880,0.744281525
3563,196,9,44,23,0.002156863,659924,0.744331153
4962,640,33,44,23,0.002156863,659968,0.744380781
1751,640,20,44,23,0.002156863,660012,0.744430408
5035,33,30,44,23,0.002156863,660056,0.744480036
3161,532,354,44,23,0.002156863,660100,0.744529664
5537,34,638,44,23,0.002156863,660144,0.744579292
4513,497,353,44,23,0.002156863,660188,0.744628919
6819,15,145,43,23,0.002107843,660231,0.744677419
5962,16,170,43,23,0.002107843,660274,0.744725919
5700,12,11,43,23,0.002107843,660317,0.744774419
6366,56,414,43,23,0.002107843,660360,0.744822919
5484,243,609,43,23,0.002107843,660403,0.744871419
6187,314,85,43,23,0.002107843,660446,0.744919919
3282,243,77,43,23,0.002107843,660489,0.744968419
2613,26,9,43,23,0.002107843,660532,0.745016919
5014,265,224,43,23,0.002107843,660575,0.745065418
3029,640,32,43,23,0.002107843,660618,0.745113918
4386,558,311,43,23,0.002107843,660661,0.745162418
4336,204,105,43,23,0.002107843,660704,0.745210918
3109,311,145,43,23,0.002107843,660747,0.745259418
4617,443,264,43,23,0.002107843,660790,0.745307918
6872,558,97,42,23,0.002058824,660832,0.74535529
5072,95,33,42,23,0.002058824,660874,0.745402662
5619,20,171,42,23,0.002058824,660916,0.745450034
5648,479,280,42,23,0.002058824,660958,0.745497406
3680,307,32,42,23,0.002058824,661000,0.745544778
5991,155,27,42,23,0.002058824,661042,0.74559215
2503,638,302,42,23,0.002058824,661084,0.745639522
5214,414,107,42,23,0.002058824,661126,0.745686894
6176,394,609,42,23,0.002058824,661168,0.745734266
4705,334,314,42,23,0.002058824,661210,0.745781638
898,529,80,42,23,0.002058824,661252,0.74582901
6649,56,84,42,23,0.002058824,661294,0.745876382
6035,2,471,42,23,0.002058824,661336,0.745923754
8587,124,224,41,23,0.002009804,661377,0.745969998
7089,348,586,41,23,0.002009804,661418,0.746016242
6836,354,689,41,23,0.002009804,661459,0.746062486
6797,171,105,41,23,0.002009804,661500,0.74610873
4921,404,77,41,23,0.002009804,661541,0.746154974
7270,535,674,41,23,0.002009804,661582,0.746201218
4585,397,50,41,23,0.002009804,661623,0.746247462
5405,1,471,41,23,0.002009804,661664,0.746293706
5083,609,393,41,23,0.002009804,661705,0.74633995
4846,274,335,41,23,0.002009804,661746,0.746386194
7899,230,502,41,23,0.002009804,661787,0.746432439
4820,26,242,41,23,0.002009804,661828,0.746478683
5513,593,353,41,23,0.002009804,661869,0.746524927
6006,596,558,41,23,0.002009804,661910,0.746571171
7643,588,404,41,23,0.002009804,661951,0.746617415
6418,131,562,41,23,0.002009804,661992,0.746663659
6539,529,367,40,23,0.001960784,662032,0.746708775
10468,348,560,40,23,0.001960784,662072,0.746753891
3890,674,77,40,23,0.001960784,662112,0.746799007
5055,475,95,40,23,0.001960784,662152,0.746844124
5833,32,501,40,23,0.001960784,662192,0.74688924
5821,614,586,40,23,0.001960784,662232,0.746934356
6675,310,54,40,23,0.001960784,662272,0.746979472
6645,130,48,40,23,0.001960784,662312,0.747024588
7295,80,605,40,23,0.001960784,662352,0.747069704
3393,379,123,40,23,0.001960784,662392,0.747114821
6762,535,498,40,23,0.001960784,662432,0.747159937
5203,105,508,40,23,0.001960784,662472,0.747205053
5861,443,15,39,23,0.001911765,662511,0.747249041
6853,582,207,39,23,0.001911765,662550,0.74729303
4804,655,310,39,23,0.001911765,662589,0.747337018
6063,34,379,39,23,0.001911765,662628,0.747381006
7642,655,242,39,23,0.001911765,662667,0.747424994
7606,107,97,39,23,0.001911765,662706,0.747468983
6303,13,224,39,23,0.001911765,662745,0.747512971
7453,11,31,39,23,0.001911765,662784,0.747556959
5549,68,1,39,23,0.001911765,662823,0.747600947
5380,123,609,39,23,0.001911765,662862,0.747644936
8527,479,708,39,23,0.001911765,662901,0.747688924
5160,473,29,39,23,0.001911765,662940,0.747732912
4530,673,335,39,23,0.001911765,662979,0.747776901
4342,12,26,39,23,0.001911765,663018,0.747820889
5670,674,26,39,23,0.001911765,663057,0.747864877
5963,514,529,39,23,0.001911765,663096,0.747908865
4621,379,398,39,23,0.001911765,663135,0.747952854
5315,307,302,39,23,0.001911765,663174,0.747996842
4205,105,22,39,23,0.001911765,663213,0.74804083
4462,14,68,39,23,0.001911765,663252,0.748084818
6147,30,708,38,23,0.001862745,663290,0.748127679
6156,528,224,38,23,0.001862745,663328,0.748170539
6177,230,543,38,23,0.001862745,663366,0.7482134
6498,12,280,38,23,0.001862745,663404,0.74825626
6254,443,414,38,23,0.001862745,663442,0.74829912
4349,280,68,38,23,0.001862745,663480,0.748341981
6589,380,204,38,23,0.001862745,663518,0.748384841
7568,385,335,38,23,0.001862745,663556,0.748427701
7325,131,30,38,23,0.001862745,663594,0.748470562
8612,689,31,38,23,0.001862745,663632,0.748513422
9882,427,663,38,23,0.001862745,663670,0.748556282
5244,20,314,38,23,0.001862745,663708,0.748599143
2678,9,196,38,23,0.001862745,663746,0.748642003
6098,107,25,38,23,0.001862745,663784,0.748684864
3979,313,30,38,23,0.001862745,663822,0.748727724
7048,131,614,38,23,0.001862745,663860,0.748770584
4727,501,331,38,23,0.001862745,663898,0.748813445
10174,77,493,37,23,0.001813725,663935,0.748855177
3972,95,479,37,23,0.001813725,663972,0.74889691
8353,107,121,37,23,0.001813725,664009,0.748938642
4482,295,334,37,23,0.001813725,664046,0.748980374
9156,463,347,37,23,0.001813725,664083,0.749022107
2136,4,331,37,23,0.001813725,664120,0.749063839
8644,582,652,37,23,0.001813725,664157,0.749105572
6689,471,311,37,23,0.001813725,664194,0.749147304
6945,522,265,37,23,0.001813725,664231,0.749189037
7263,114,77,37,23,0.001813725,664268,0.749230769
7469,544,31,37,23,0.001813725,664305,0.749272502
7176,335,12,37,23,0.001813725,664342,0.749314234
3682,498,311,37,23,0.001813725,664379,0.749355967
3645,243,314,37,23,0.001813725,664416,0.749397699
7097,11,280,37,23,0.001813725,664453,0.749439432
7459,48,11,37,23,0.001813725,664490,0.749481164
3933,498,335,37,23,0.001813725,664527,0.749522896
7941,354,14,37,23,0.001813725,664564,0.749564629
6244,331,364,37,23,0.001813725,664601,0.749606361
7696,354,26,37,23,0.001813725,664638,0.749648094
6869,22,16,37,23,0.001813725,664675,0.749689826
7518,80,274,37,23,0.001813725,664712,0.749731559
5689,20,195,37,23,0.001813725,664749,0.749773291
5200,379,558,37,23,0.001813725,664786,0.749815024
4570,16,535,37,23,0.001813725,664823,0.749856756
4518,274,532,37,23,0.001813725,664860,0.749898489
5180,498,11,37,23,0.001813725,664897,0.749940221
6081,544,105,37,23,0.001813725,664934,0.749981954
5943,50,473,37,23,0.001813725,664971,0.750023686
4624,638,33,36,23,0.001764706,665007,0.750064291
8302,354,640,36,23,0.001764706,665043,0.750104895
6408,353,348,36,23,0.001764706,665079,0.7501455
4100,280,311,36,23,0.001764706,665115,0.750186104
4979,32,562,36,23,0.001764706,665151,0.750226709
6598,443,404,36,23,0.001764706,665187,0.750267313
8809,596,392,36,23,0.001764706,665223,0.750307918
6009,250,398,36,23,0.001764706,665259,0.750348522
5663,394,302,36,23,0.001764706,665295,0.750389127
3584,331,158,36,23,0.001764706,665331,0.750429732
4234,302,443,36,23,0.001764706,665367,0.750470336
4898,618,32,36,23,0.001764706,665403,0.750510941
6321,552,31,36,23,0.001764706,665439,0.750551545
5289,331,34,36,23,0.001764706,665475,0.75059215
5916,16,674,36,23,0.001764706,665511,0.750632754
4286,638,10,36,23,0.001764706,665547,0.750673359
8430,328,385,36,23,0.001764706,665583,0.750713963
6903,302,14,36,23,0.001764706,665619,0.750754568
7816,250,528,36,23,0.001764706,665655,0.750795173
2889,26,123,36,23,0.001764706,665691,0.750835777
6954,414,250,36,23,0.001764706,665727,0.750876382
5471,663,443,36,23,0.001764706,665763,0.750916986
6719,618,31,36,23,0.001764706,665799,0.750957591
6923,48,655,36,23,0.001764706,665835,0.750998195
8092,348,501,36,23,0.001764706,665871,0.7510388
5476,582,1,36,23,0.001764706,665907,0.751079404
7248,13,314,36,23,0.001764706,665943,0.751120009
7362,558,394,36,23,0.001764706,665979,0.751160614
8890,463,307,36,23,0.001764706,666015,0.751201218
5432,708,473,36,23,0.001764706,666051,0.751241823
7788,334,224,35,23,0.001715686,666086,0.751281299
5935,596,114,35,23,0.001715686,666121,0.751320776
6895,529,274,35,23,0.001715686,666156,0.751360253
4838,498,586,35,23,0.001715686,666191,0.751399729
6687,475,131,35,23,0.001715686,666226,0.751439206
6642,385,311,35,23,0.001715686,666261,0.751478683
6640,354,54,35,23,0.001715686,666296,0.751518159
6753,280,674,35,23,0.001715686,666331,0.751557636
7608,80,56,35,23,0.001715686,666366,0.751597113
7026,562,347,35,23,0.001715686,666401,0.751636589
5258,632,6,35,23,0.001715686,666436,0.751676066
4498,398,379,35,23,0.001715686,666471,0.751715543
7128,354,385,35,23,0.001715686,666506,0.751755019
3405,586,582,35,23,0.001715686,666541,0.751794496
4268,97,479,35,23,0.001715686,666576,0.751833972
8801,471,397,35,23,0.001715686,666611,0.751873449
7164,354,529,35,23,0.001715686,666646,0.751912926
5355,77,30,35,23,0.001715686,666681,0.751952402
6043,674,15,35,23,0.001715686,666716,0.751991879
5653,367,114,35,23,0.001715686,666751,0.752031356
7228,535,689,35,23,0.001715686,666786,0.752070832
6270,674,397,35,23,0.001715686,666821,0.752110309
6300,522,130,35,23,0.001715686,666856,0.752149786
8690,171,380,35,23,0.001715686,666891,0.752189262
10630,68,624,35,23,0.001715686,666926,0.752228739
7479,250,131,35,23,0.001715686,666961,0.752268216
8877,543,367,35,23,0.001715686,666996,0.752307692
10589,133,250,35,23,0.001715686,667031,0.752347169
8572,535,663,35,23,0.001715686,667066,0.752386646
7505,15,522,35,23,0.001715686,667101,0.752426122
6268,582,364,34,23,0.001666667,667135,0.752464471
6279,532,295,34,23,0.001666667,667169,0.75250282
7769,15,663,34,23,0.001666667,667203,0.752541169
6955,354,479,34,23,0.001666667,667237,0.752579517
4856,280,522,34,23,0.001666667,667271,0.752617866
9784,224,332,34,23,0.001666667,667305,0.752656215
5546,6,307,34,23,0.001666667,667339,0.752694564
4964,558,354,34,23,0.001666667,667373,0.752732912
6638,535,655,34,23,0.001666667,667407,0.752771261
8211,475,5,34,23,0.001666667,667441,0.75280961
6620,230,708,34,23,0.001666667,667475,0.752847958
6178,6,280,34,23,0.001666667,667509,0.752886307
5268,443,250,34,23,0.001666667,667543,0.752924656
6332,529,514,34,23,0.001666667,667577,0.752963005
5685,543,353,34,23,0.001666667,667611,0.753001353
8668,236,34,34,23,0.001666667,667645,0.753039702
5448,353,307,34,23,0.001666667,667679,0.753078051
7273,302,632,34,23,0.001666667,667713,0.7531164
5466,264,27,34,23,0.001666667,667747,0.753154748
6868,48,498,34,23,0.001666667,667781,0.753193097
6282,522,560,34,23,0.001666667,667815,0.753231446
6756,562,498,34,23,0.001666667,667849,0.753269795
6914,15,313,34,23,0.001666667,667883,0.753308143
6515,380,723,34,23,0.001666667,667917,0.753346492
9112,522,385,33,23,0.001617647,667950,0.753383713
6699,501,558,33,23,0.001617647,667983,0.753420934
8897,479,674,33,23,0.001617647,668016,0.753458155
10817,224,195,33,23,0.001617647,668049,0.753495376
8094,56,558,33,23,0.001617647,668082,0.753532596
10239,471,640,33,23,0.001617647,668115,0.753569817
6069,261,393,33,23,0.001617647,668148,0.753607038
10245,347,348,33,23,0.001617647,668181,0.753644259
5814,596,313,33,23,0.001617647,668214,0.75368148
6384,243,379,33,23,0.001617647,668247,0.753718701
7006,522,640,33,23,0.001617647,668280,0.753755921
7544,353,543,33,23,0.001617647,668313,0.753793142
5524,638,68,33,23,0.001617647,668346,0.753830363
5899,313,4,33,23,0.001617647,668379,0.753867584
4171,397,68,33,23,0.001617647,668412,0.753904805
9809,29,31,33,23,0.001617647,668445,0.753942026
6497,131,77,33,23,0.001617647,668478,0.753979247
6336,385,582,33,23,0.001617647,668511,0.754016467
8635,310,560,33,23,0.001617647,668544,0.754053688
5688,367,6,33,23,0.001617647,668577,0.754090909
6485,582,4,33,23,0.001617647,668610,0.75412813
6429,56,6,33,23,0.001617647,668643,0.754165351
8503,479,528,33,23,0.001617647,668676,0.754202572
5565,295,353,33,23,0.001617647,668709,0.754239792
8202,13,204,33,23,0.001617647,668742,0.754277013
5867,532,535,33,23,0.001617647,668775,0.754314234
5493,443,614,33,23,0.001617647,668808,0.754351455
7185,544,558,33,23,0.001617647,668841,0.754388676
4985,295,354,33,23,0.001617647,668874,0.754425897
5715,313,1,33,23,0.001617647,668907,0.754463118
6870,250,532,32,23,0.001568627,668939,0.75449921
5022,367,532,32,23,0.001568627,668971,0.754535303
7194,1,97,32,23,0.001568627,669003,0.754571396
7403,2,302,32,23,0.001568627,669035,0.754607489
6942,552,9,32,23,0.001568627,669067,0.754643582
7448,535,50,32,23,0.001568627,669099,0.754679675
6633,398,609,32,23,0.001568627,669131,0.754715768
10970,471,652,32,23,0.001568627,669163,0.754751861
6591,280,50,32,23,0.001568627,669195,0.754787954
6693,398,219,32,23,0.001568627,669227,0.754824047
6691,196,31,32,23,0.001568627,669259,0.75486014
9310,230,661,32,23,0.001568627,669291,0.754896233
5411,30,224,32,23,0.001568627,669323,0.754932326
4659,105,246,32,23,0.001568627,669355,0.754968419
8515,243,497,32,23,0.001568627,669387,0.755004512
6501,219,145,32,23,0.001568627,669419,0.755040605
6564,280,274,32,23,0.001568627,669451,0.755076697
8864,13,347,32,23,0.001568627,669483,0.75511279
4643,673,379,32,23,0.001568627,669515,0.755148883
6040,379,463,32,23,0.001568627,669547,0.755184976
3833,586,9,32,23,0.001568627,669579,0.755221069
8970,16,614,32,23,0.001568627,669611,0.755257162
9246,335,613,32,23,0.001568627,669643,0.755293255
6341,43,310,31,23,0.001519608,669674,0.75532822
6360,385,310,31,23,0.001519608,669705,0.755363185
5980,674,588,31,23,0.001519608,669736,0.75539815
6374,274,558,31,23,0.001519608,669767,0.755433115
6092,529,250,31,23,0.001519608,669798,0.75546808
3269,638,9,31,23,0.001519608,669829,0.755503045
8675,1,689,31,23,0.001519608,669860,0.75553801
8829,3,328,31,23,0.001519608,669891,0.755572975
7406,614,16,31,23,0.001519608,669922,0.75560794
7354,131,543,31,23,0.001519608,669953,0.755642905
10574,158,708,31,23,0.001519608,669984,0.755677871
4971,347,80,31,23,0.001519608,670015,0.755712836
10711,427,236,31,23,0.001519608,670046,0.755747801
8762,2,131,31,23,0.001519608,670077,0.755782766
8689,145,708,31,23,0.001519608,670108,0.755817731
7139,10,274,31,23,0.001519608,670139,0.755852696
6052,397,114,31,23,0.001519608,670170,0.755887661
8250,16,560,31,23,0.001519608,670201,0.755922626
11935,348,517,31,23,0.001519608,670232,0.755957591
8311,219,14,31,23,0.001519608,670263,0.755992556
8265,156,562,31,23,0.001519608,670294,0.756027521
7828,50,68,31,23,0.001519608,670325,0.756062486
5512,367,414,31,23,0.001519608,670356,0.756097451
6650,242,532,31,23,0.001519608,670387,0.756132416
5410,33,708,31,23,0.001519608,670418,0.756167381
8118,393,398,31,23,0.001519608,670449,0.756202346
8043,439,302,31,23,0.001519608,670480,0.756237311
8385,34,689,31,23,0.001519608,670511,0.756272276
3823,31,335,31,23,0.001519608,670542,0.756307241
7900,367,15,31,23,0.001519608,670573,0.756342206
5190,398,311,31,23,0.001519608,670604,0.756377171
10607,367,514,30,23,0.001470588,670634,0.756411008
9193,353,593,30,23,0.001470588,670664,0.756444845
7846,10,2,30,23,0.001470588,670694,0.756478683
8465,502,311,30,23,0.001470588,670724,0.75651252
7359,15,353,30,23,0.001470588,670754,0.756546357
8732,380,708,30,23,0.001470588,670784,0.756580194
6096,588,56,30,23,0.001470588,670814,0.756614031
4523,502,105,30,23,0.001470588,670844,0.756647868
6289,12,335,30,23,0.001470588,670874,0.756681705
6885,473,404,30,23,0.001470588,670904,0.756715543
4582,609,9,30,23,0.001470588,670934,0.75674938
6615,522,543,30,23,0.001470588,670964,0.756783217
7719,471,3,29,23,0.001421569,670993,0.756815926
10793,409,16,29,23,0.001421569,671022,0.756848635
6021,353,562,29,23,0.001421569,671051,0.756881344
11868,379,90,29,23,0.001421569,671080,0.756914054
3095,265,80,29,23,0.001421569,671109,0.756946763
8090,347,588,29,23,0.001421569,671138,0.756979472
10924,543,347,29,23,0.001421569,671167,0.757012181
6363,84,3,29,23,0.001421569,671196,0.757044891
7830,107,274,29,23,0.001421569,671225,0.7570776
7826,655,130,29,23,0.001421569,671254,0.757110309
6420,334,582,29,23,0.001421569,671283,0.757143018
6838,14,582,29,23,0.001421569,671312,0.757175727
4522,107,158,29,23,0.001421569,671341,0.757208437
7345,404,335,29,23,0.001421569,671370,0.757241146
5627,543,354,29,23,0.001421569,671399,0.757273855
10563,335,448,29,23,0.001421569,671428,0.757306564
6124,673,334,28,23,0.001372549,671456,0.757338146
5731,302,528,28,23,0.001372549,671484,0.757369727
9013,250,514,28,23,0.001372549,671512,0.757401308
7113,596,663,28,23,0.001372549,671540,0.75743289
13309,90,367,28,23,0.001372549,671568,0.757464471
6739,379,385,27,23,0.001323529,671595,0.757494924
12512,348,684,27,23,0.001323529,671622,0.757525378
4973,498,379,27,23,0.001323529,671649,0.757555831
7242,397,313,27,23,0.001323529,671676,0.757586285
5790,353,313,27,23,0.001323529,671703,0.757616738
8718,219,6,27,23,0.001323529,671730,0.757647192
6211,30,29,27,23,0.001323529,671757,0.757677645
11758,48,593,27,23,0.001323529,671784,0.757708098
9743,68,502,26,23,0.00127451,671810,0.757737424
7563,156,68,26,23,0.00127451,671836,0.757766749
9197,56,535,26,23,0.00127451,671862,0.757796075
14093,471,1,25,23,0.00122549,671887,0.757824273
1536,156,158,49,22,0.002401961,671936,0.75787954
2624,313,723,49,22,0.002401961,671985,0.757934807
3079,171,170,49,22,0.002401961,672034,0.757990074
3848,313,54,48,22,0.002352941,672082,0.758044214
5982,471,307,48,22,0.002352941,672130,0.758098353
5157,3,498,48,22,0.002352941,672178,0.758152493
5153,596,95,47,22,0.002303922,672225,0.758205504
6355,107,439,47,22,0.002303922,672272,0.758258516
4043,310,655,46,22,0.002254902,672318,0.758310399
6012,295,463,46,22,0.002254902,672364,0.758362283
5852,502,224,46,22,0.002254902,672410,0.758414166
3947,394,230,45,22,0.002205882,672455,0.758464922
7446,517,219,45,22,0.002205882,672500,0.758515678
3442,331,638,44,22,0.002156863,672544,0.758565306
4787,12,16,44,22,0.002156863,672588,0.758614933
5664,609,397,44,22,0.002156863,672632,0.758664561
6438,404,353,44,22,0.002156863,672676,0.758714189
3357,32,84,44,22,0.002156863,672720,0.758763817
5755,264,353,43,22,0.002107843,672763,0.758812317
7977,130,605,43,22,0.002107843,672806,0.758860817
4636,3,6,43,22,0.002107843,672849,0.758909316
4824,414,224,42,22,0.002058824,672891,0.758956688
3438,562,105,42,22,0.002058824,672933,0.75900406
4887,310,586,42,22,0.002058824,672975,0.759051432
3963,721,26,42,22,0.002058824,673017,0.759098804
4097,614,77,42,22,0.002058824,673059,0.759146176
6657,114,353,42,22,0.002058824,673101,0.759193548
6065,224,587,42,22,0.002058824,673143,0.75924092
6179,29,6,42,22,0.002058824,673185,0.759288292
8562,43,33,42,22,0.002058824,673227,0.759335664
7398,673,11,41,22,0.002009804,673268,0.759381908
4969,498,141,41,22,0.002009804,673309,0.759428152
9325,80,383,41,22,0.002009804,673350,0.759474397
7317,243,11,41,22,0.002009804,673391,0.759520641
4938,77,640,41,22,0.002009804,673432,0.759566885
7153,204,562,41,22,0.002009804,673473,0.759613129
7226,236,328,41,22,0.002009804,673514,0.759659373
8713,348,502,41,22,0.002009804,673555,0.759705617
5074,16,164,41,22,0.002009804,673596,0.759751861
6004,463,313,41,22,0.002009804,673637,0.759798105
5387,443,68,41,22,0.002009804,673678,0.759844349
6166,22,280,41,22,0.002009804,673719,0.759890593
3869,689,230,40,22,0.001960784,673759,0.759935709
1949,582,532,40,22,0.001960784,673799,0.759980826
5679,674,48,40,22,0.001960784,673839,0.760025942
9230,6,571,40,22,0.001960784,673879,0.760071058
5396,586,443,40,22,0.001960784,673919,0.760116174
6049,380,392,40,22,0.001960784,673959,0.76016129
6054,593,314,40,22,0.001960784,673999,0.760206406
5975,532,674,40,22,0.001960784,674039,0.760251523
7720,335,652,40,22,0.001960784,674079,0.760296639
7735,48,131,40,22,0.001960784,674119,0.760341755
4551,310,243,40,22,0.001960784,674159,0.760386871
6264,632,196,40,22,0.001960784,674199,0.760431987
6057,25,242,40,22,0.001960784,674239,0.760477104
5224,562,353,40,22,0.001960784,674279,0.76052222
4434,380,130,40,22,0.001960784,674319,0.760567336
8534,204,11,40,22,0.001960784,674359,0.760612452
3232,302,6,40,22,0.001960784,674399,0.760657568
4131,397,473,39,22,0.001911765,674438,0.760701557
6774,582,552,39,22,0.001911765,674477,0.760745545
4978,522,114,39,22,0.001911765,674516,0.760789533
6274,34,219,39,22,0.001911765,674555,0.760833521
6152,48,219,39,22,0.001911765,674594,0.76087751
9131,124,31,39,22,0.001911765,674633,0.760921498
6007,558,34,39,22,0.001911765,674672,0.760965486
3136,26,393,39,22,0.001911765,674711,0.761009474
6013,463,68,39,22,0.001911765,674750,0.761053463
2999,593,80,39,22,0.001911765,674789,0.761097451
7823,562,141,39,22,0.001911765,674828,0.761141439
7792,80,30,39,22,0.001911765,674867,0.761185427
7779,43,95,39,22,0.001911765,674906,0.761229416
6055,398,393,39,22,0.001911765,674945,0.761273404
3257,302,475,39,22,0.001911765,674984,0.761317392
7346,107,475,39,22,0.001911765,675023,0.761361381
7241,219,463,39,22,0.001911765,675062,0.761405369
5903,230,501,38,22,0.001862745,675100,0.761448229
5955,302,236,38,22,0.001862745,675138,0.76149109
6230,219,280,38,22,0.001862745,675176,0.76153395
4876,674,544,38,22,0.001862745,675214,0.76157681
3110,394,354,38,22,0.001862745,675252,0.761619671
5538,334,331,38,22,0.001862745,675290,0.761662531
7422,171,219,38,22,0.001862745,675328,0.761705391
7142,674,517,38,22,0.001862745,675366,0.761748252
8005,314,673,38,22,0.001862745,675404,0.761791112
9401,663,587,38,22,0.001862745,675442,0.761833972
5310,335,511,38,22,0.001862745,675480,0.761876833
8721,15,2,38,22,0.001862745,675518,0.761919693
8561,236,714,38,22,0.001862745,675556,0.761962554
5401,84,50,38,22,0.001862745,675594,0.762005414
8182,31,347,38,22,0.001862745,675632,0.762048274
5161,558,498,38,22,0.001862745,675670,0.762091135
7418,48,84,38,22,0.001862745,675708,0.762133995
6710,1,380,38,22,0.001862745,675746,0.762176855
4751,673,310,38,22,0.001862745,675784,0.762219716
3969,532,334,38,22,0.001862745,675822,0.762262576
3618,274,25,38,22,0.001862745,675860,0.762305436
10446,517,471,37,22,0.001813725,675897,0.762347169
6734,562,280,37,22,0.001813725,675934,0.762388901
8401,348,632,37,22,0.001813725,675971,0.762430634
9076,43,313,37,22,0.001813725,676008,0.762472366
8698,130,439,37,22,0.001813725,676045,0.762514099
4184,552,80,37,22,0.001813725,676082,0.762555831
7389,596,497,37,22,0.001813725,676119,0.762597564
3386,196,335,37,22,0.001813725,676156,0.762639296
7111,204,302,37,22,0.001813725,676193,0.762681029
6844,380,593,37,22,0.001813725,676230,0.762722761
6212,280,3,37,22,0.001813725,676267,0.762764494
7990,502,529,37,22,0.001813725,676304,0.762806226
6843,25,397,37,22,0.001813725,676341,0.762847958
7768,543,674,37,22,0.001813725,676378,0.762889691
4881,398,310,37,22,0.001813725,676415,0.762931423
5804,674,295,37,22,0.001813725,676452,0.762973156
4577,80,117,37,22,0.001813725,676489,0.763014888
5940,632,204,37,22,0.001813725,676526,0.763056621
4747,171,20,37,22,0.001813725,676563,0.763098353
4682,77,543,37,22,0.001813725,676600,0.763140086
5849,398,236,37,22,0.001813725,676637,0.763181818
4851,25,219,37,22,0.001813725,676674,0.763223551
5146,274,77,37,22,0.001813725,676711,0.763265283
5363,84,394,37,22,0.001813725,676748,0.763307016
5669,475,68,37,22,0.001813725,676785,0.763348748
6543,193,27,36,22,0.001764706,676821,0.763389353
4711,158,80,36,22,0.001764706,676857,0.763429957
8794,27,103,36,22,0.001764706,676893,0.763470562
7093,348,1,36,22,0.001764706,676929,0.763511166
5341,32,29,36,22,0.001764706,676965,0.763551771
8259,328,236,36,22,0.001764706,677001,0.763592375
6584,274,131,36,22,0.001764706,677037,0.76363298
6580,532,463,36,22,0.001764706,677073,0.763673584
5009,586,609,36,22,0.001764706,677109,0.763714189
8354,328,663,36,22,0.001764706,677145,0.763754794
7571,674,204,36,22,0.001764706,677181,0.763795398
9485,528,107,36,22,0.001764706,677217,0.763836003
7465,663,50,36,22,0.001764706,677253,0.763876607
6440,501,68,36,22,0.001764706,677289,0.763917212
10448,80,90,36,22,0.001764706,677325,0.763957816
4667,331,501,36,22,0.001764706,677361,0.763998421
5925,558,397,36,22,0.001764706,677397,0.764039025
5598,367,33,36,22,0.001764706,677433,0.76407963
6948,77,587,36,22,0.001764706,677469,0.764120235
8129,311,29,36,22,0.001764706,677505,0.764160839
9238,131,250,36,22,0.001764706,677541,0.764201444
5842,331,708,36,22,0.001764706,677577,0.764242048
7331,131,196,36,22,0.001764706,677613,0.764282653
9066,348,543,36,22,0.001764706,677649,0.764323257
6671,353,463,36,22,0.001764706,677685,0.764363862
6674,130,475,36,22,0.001764706,677721,0.764404467
6627,145,34,36,22,0.001764706,677757,0.764445071
4937,97,335,36,22,0.001764706,677793,0.764485676
5025,163,27,35,22,0.001715686,677828,0.764525152
7524,236,605,35,22,0.001715686,677863,0.764564629
6436,562,31,35,22,0.001715686,677898,0.764604106
7862,552,588,35,22,0.001715686,677933,0.764643582
2760,655,80,35,22,0.001715686,677968,0.764683059
6603,230,30,35,22,0.001715686,678003,0.764722536
11421,107,613,35,22,0.001715686,678038,0.764762012
8114,230,56,35,22,0.001715686,678073,0.764801489
5252,498,236,35,22,0.001715686,678108,0.764840965
7314,473,385,35,22,0.001715686,678143,0.764880442
2493,313,280,35,22,0.001715686,678178,0.764919919
3209,638,473,35,22,0.001715686,678213,0.764959395
8727,10,514,35,22,0.001715686,678248,0.764998872
5629,331,14,35,22,0.001715686,678283,0.765038349
6207,529,310,35,22,0.001715686,678318,0.765077825
6214,20,16,35,22,0.001715686,678353,0.765117302
6107,529,11,35,22,0.001715686,678388,0.765156779
5304,498,354,35,22,0.001715686,678423,0.765196255
8607,219,640,35,22,0.001715686,678458,0.765235732
7636,295,443,34,22,0.001666667,678492,0.765274081
6575,535,427,34,22,0.001666667,678526,0.76531243
6738,10,560,34,22,0.001666667,678560,0.765350778
7683,26,23,34,22,0.001666667,678594,0.765389127
8173,114,123,34,22,0.001666667,678628,0.765427476
5699,80,348,34,22,0.001666667,678662,0.765465824
6277,532,22,34,22,0.001666667,678696,0.765504173
6579,1,29,34,22,0.001666667,678730,0.765542522
9280,43,348,34,22,0.001666667,678764,0.765580871
6239,674,84,34,22,0.001666667,678798,0.765619219
9217,522,605,34,22,0.001666667,678832,0.765657568
9848,230,364,34,22,0.001666667,678866,0.765695917
6236,31,380,34,22,0.001666667,678900,0.765734266
8112,56,609,34,22,0.001666667,678934,0.765772614
7090,335,1,34,22,0.001666667,678968,0.765810963
4718,295,479,34,22,0.001666667,679002,0.765849312
7707,31,64,34,22,0.001666667,679036,0.765887661
8234,130,97,34,22,0.001666667,679070,0.765926009
6280,398,443,34,22,0.001666667,679104,0.765964358
4033,593,380,34,22,0.001666667,679138,0.766002707
8958,335,294,34,22,0.001666667,679172,0.766041056
10549,121,380,34,22,0.001666667,679206,0.766079404
7747,334,123,34,22,0.001666667,679240,0.766117753
7207,596,31,34,22,0.001666667,679274,0.766156102
7245,145,663,34,22,0.001666667,679308,0.766194451
6337,50,331,34,22,0.001666667,679342,0.766232799
3174,586,314,34,22,0.001666667,679376,0.766271148
4177,498,77,34,22,0.001666667,679410,0.766309497
6376,347,32,34,22,0.001666667,679444,0.766347846
6431,558,479,34,22,0.001666667,679478,0.766386194
7781,310,501,34,22,0.001666667,679512,0.766424543
6768,475,15,34,22,0.001666667,679546,0.766462892
4101,638,311,34,22,0.001666667,679580,0.766501241
8395,655,107,34,22,0.001666667,679614,0.766539589
6488,614,243,34,22,0.001666667,679648,0.766577938
10138,471,30,33,22,0.001617647,679681,0.766615159
7305,15,335,33,22,0.001617647,679714,0.76665238
5750,26,502,33,22,0.001617647,679747,0.766689601
8151,394,404,33,22,0.001617647,679780,0.766726822
5417,393,588,33,22,0.001617647,679813,0.766764042
6059,497,9,33,22,0.001617647,679846,0.766801263
5844,302,107,33,22,0.001617647,679879,0.766838484
5846,614,10,33,22,0.001617647,679912,0.766875705
5798,80,414,33,22,0.001617647,679945,0.766912926
5609,196,131,33,22,0.001617647,679978,0.766950147
6769,404,596,33,22,0.001617647,680011,0.766987367
4783,475,9,33,22,0.001617647,680044,0.767024588
4934,97,9,33,22,0.001617647,680077,0.767061809
9148,562,663,33,22,0.001617647,680110,0.76709903
6752,130,64,33,22,0.001617647,680143,0.767136251
8167,443,130,33,22,0.001617647,680176,0.767173472
5907,33,114,33,22,0.001617647,680209,0.767210693
6288,334,380,33,22,0.001617647,680242,0.767247913
8519,11,4,33,22,0.001617647,680275,0.767285134
7018,543,558,33,22,0.001617647,680308,0.767322355
9804,348,242,33,22,0.001617647,680341,0.767359576
5372,16,348,33,22,0.001617647,680374,0.767396797
5930,558,708,33,22,0.001617647,680407,0.767434018
7054,663,141,33,22,0.001617647,680440,0.767471238
7562,34,353,33,22,0.001617647,680473,0.767508459
4296,558,379,33,22,0.001617647,680506,0.76754568
9697,332,16,33,22,0.001617647,680539,0.767582901
8269,16,723,33,22,0.001617647,680572,0.767620122
5368,514,236,33,22,0.001617647,680605,0.767657343
4046,32,77,33,22,0.001617647,680638,0.767694564
7364,250,48,33,22,0.001617647,680671,0.767731784
5249,6,193,33,22,0.001617647,680704,0.767769005
6646,22,558,33,22,0.001617647,680737,0.767806226
6663,302,640,33,22,0.001617647,680770,0.767843447
9366,196,347,33,22,0.001617647,680803,0.767880668
6965,84,117,33,22,0.001617647,680836,0.767917889
9335,497,596,33,22,0.001617647,680869,0.767955109
8880,588,587,33,22,0.001617647,680902,0.76799233
7837,219,33,32,22,0.001568627,680934,0.768028423
6881,130,20,32,22,0.001568627,680966,0.768064516
7534,56,11,32,22,0.001568627,680998,0.768100609
5458,25,380,32,22,0.001568627,681030,0.768136702
3365,26,334,32,22,0.001568627,681062,0.768172795
7256,130,164,32,22,0.001568627,681094,0.768208888
7106,11,398,32,22,0.001568627,681126,0.768244981
5743,16,97,32,22,0.001568627,681158,0.768281074
7152,463,295,32,22,0.001568627,681190,0.768317167
7399,501,265,32,22,0.001568627,681222,0.76835326
7365,10,385,32,22,0.001568627,681254,0.768389353
7628,393,68,32,22,0.001568627,681286,0.768425446
7801,588,482,32,22,0.001568627,681318,0.768461538
4950,302,689,32,22,0.001568627,681350,0.768497631
7886,95,204,32,22,0.001568627,681382,0.768533724
8184,114,535,32,22,0.001568627,681414,0.768569817
6634,501,393,32,22,0.001568627,681446,0.76860591
9378,492,380,32,22,0.001568627,681478,0.768642003
4323,97,313,32,22,0.001568627,681510,0.768678096
8176,479,640,32,22,0.001568627,681542,0.768714189
8107,158,529,32,22,0.001568627,681574,0.768750282
5317,302,196,32,22,0.001568627,681606,0.768786375
6225,596,117,32,22,0.001568627,681638,0.768822468
4748,34,123,32,22,0.001568627,681670,0.768858561
4541,638,471,32,22,0.001568627,681702,0.768894654
8701,131,34,32,22,0.001568627,681734,0.768930747
6726,398,532,32,22,0.001568627,681766,0.76896684
5300,250,123,32,22,0.001568627,681798,0.769002933
8266,158,236,32,22,0.001568627,681830,0.769039025
5393,379,475,32,22,0.001568627,681862,0.769075118
8324,250,33,32,22,0.001568627,681894,0.769111211
6776,689,131,32,22,0.001568627,681926,0.769147304
9160,552,236,32,22,0.001568627,681958,0.769183397
7973,77,20,32,22,0.001568627,681990,0.76921949
8917,156,204,32,22,0.001568627,682022,0.769255583
6777,311,25,32,22,0.001568627,682054,0.769291676
6215,107,307,32,22,0.001568627,682086,0.769327769
9096,328,439,32,22,0.001568627,682118,0.769363862
7473,56,280,31,22,0.001519608,682149,0.769398827
7265,385,9,31,22,0.001519608,682180,0.769433792
8620,77,269,31,22,0.001519608,682211,0.769468757
9163,16,30,31,22,0.001519608,682242,0.769503722
10516,552,558,31,22,0.001519608,682273,0.769538687
9115,502,443,31,22,0.001519608,682304,0.769573652
9036,204,236,31,22,0.001519608,682335,0.769608617
9440,68,552,31,22,0.001519608,682366,0.769643582
9031,29,347,31,22,0.001519608,682397,0.769678547
9345,243,398,31,22,0.001519608,682428,0.769713512
5564,544,32,31,22,0.001519608,682459,0.769748477
7334,295,50,31,22,0.001519608,682490,0.769783442
5650,307,638,31,22,0.001519608,682521,0.769818407
9256,11,348,31,22,0.001519608,682552,0.769853372
8702,156,655,31,22,0.001519608,682583,0.769888337
6173,655,131,31,22,0.001519608,682614,0.769923303
5621,171,224,31,22,0.001519608,682645,0.769958268
7820,443,114,31,22,0.001519608,682676,0.769993233
6801,614,532,31,22,0.001519608,682707,0.770028198
6998,3,439,31,22,0.001519608,682738,0.770063163
6749,33,280,31,22,0.001519608,682769,0.770098128
6574,310,427,31,22,0.001519608,682800,0.770133093
6751,593,224,31,22,0.001519608,682831,0.770168058
5806,673,131,31,22,0.001519608,682862,0.770203023
3798,114,80,31,22,0.001519608,682893,0.770237988
5288,397,529,31,22,0.001519608,682924,0.770272953
4137,295,311,31,22,0.001519608,682955,0.770307918
6824,471,354,31,22,0.001519608,682986,0.770342883
6862,3,655,31,22,0.001519608,683017,0.770377848
5779,498,302,31,22,0.001519608,683048,0.770412813
3865,609,582,31,22,0.001519608,683079,0.770447778
10115,522,646,31,22,0.001519608,683110,0.770482743
7838,56,131,31,22,0.001519608,683141,0.770517708
10008,353,328,30,22,0.001470588,683171,0.770551545
7827,379,242,30,22,0.001470588,683201,0.770585382
5333,502,394,30,22,0.001470588,683231,0.770619219
8030,219,34,30,22,0.001470588,683261,0.770653057
9479,310,552,30,22,0.001470588,683291,0.770686894
8403,84,463,30,22,0.001470588,683321,0.770720731
8405,158,302,30,22,0.001470588,683351,0.770754568
9684,544,348,30,22,0.001470588,683381,0.770788405
8551,552,663,30,22,0.001470588,683411,0.770822242
8257,50,16,30,22,0.001470588,683441,0.770856079
8231,224,632,30,22,0.001470588,683471,0.770889917
7656,588,514,30,22,0.001470588,683501,0.770923754
8091,514,532,30,22,0.001470588,683531,0.770957591
9395,48,170,30,22,0.001470588,683561,0.770991428
7438,475,663,30,22,0.001470588,683591,0.771025265
6974,544,522,30,22,0.001470588,683621,0.771059102
3712,30,80,30,22,0.001470588,683651,0.771092939
4348,261,394,30,22,0.001470588,683681,0.771126776
6899,614,22,30,22,0.001470588,683711,0.771160614
5676,123,141,30,22,0.001470588,683741,0.771194451
6361,479,609,30,22,0.001470588,683771,0.771228288
6091,311,30,30,22,0.001470588,683801,0.771262125
7231,558,674,30,22,0.001470588,683831,0.771295962
7073,280,155,30,22,0.001470588,683861,0.771329799
6197,463,311,30,22,0.001470588,683891,0.771363636
5087,605,353,29,22,0.001421569,683920,0.771396346
6032,588,158,29,22,0.001421569,683949,0.771429055
7085,14,196,29,22,0.001421569,683978,0.771461764
6204,596,588,29,22,0.001421569,684007,0.771494473
7629,394,26,29,22,0.001421569,684036,0.771527182
5697,532,302,29,22,0.001421569,684065,0.771559892
7586,310,170,29,22,0.001421569,684094,0.771592601
7676,473,482,29,22,0.001421569,684123,0.77162531
9352,479,682,29,22,0.001421569,684152,0.771658019
10049,131,560,29,22,0.001421569,684181,0.771690729
8004,2,558,29,22,0.001421569,684210,0.771723438
8132,682,397,29,22,0.001421569,684239,0.771756147
6865,16,514,29,22,0.001421569,684268,0.771788856
7810,638,236,29,22,0.001421569,684297,0.771821566
8575,131,475,29,22,0.001421569,684326,0.771854275
4638,9,130,29,22,0.001421569,684355,0.771886984
8531,6,398,29,22,0.001421569,684384,0.771919693
7928,6,439,29,22,0.001421569,684413,0.771952402
4611,313,264,29,22,0.001421569,684442,0.771985112
6045,16,479,29,22,0.001421569,684471,0.772017821
9218,250,280,29,22,0.001421569,684500,0.77205053
6066,501,10,29,22,0.001421569,684529,0.772083239
7098,689,33,29,22,0.001421569,684558,0.772115949
6126,397,588,29,22,0.001421569,684587,0.772148658
10333,328,31,28,22,0.001372549,684615,0.772180239
8072,673,475,28,22,0.001372549,684643,0.77221182
8422,34,475,28,22,0.001372549,684671,0.772243402
8427,380,64,28,22,0.001372549,684699,0.772274983
6257,501,236,28,22,0.001372549,684727,0.772306564
8445,158,663,28,22,0.001372549,684755,0.772338146
6464,274,367,28,22,0.001372549,684783,0.772369727
7433,528,367,28,22,0.001372549,684811,0.772401308
6373,280,609,28,22,0.001372549,684839,0.77243289
7848,609,131,28,22,0.001372549,684867,0.772464471
8784,145,674,28,22,0.001372549,684895,0.772496052
8695,204,663,28,22,0.001372549,684923,0.772527634
3238,638,80,28,22,0.001372549,684951,0.772559215
8851,56,50,28,22,0.001372549,684979,0.772590796
8204,708,10,28,22,0.001372549,685007,0.772622378
7039,12,310,28,22,0.001372549,685035,0.772653959
6677,9,121,28,22,0.001372549,685063,0.77268554
8273,522,562,28,22,0.001372549,685091,0.772717122
8888,535,439,28,22,0.001372549,685119,0.772748703
8246,334,393,28,22,0.001372549,685147,0.772780284
9845,427,479,28,22,0.001372549,685175,0.772811866
9902,56,196,28,22,0.001372549,685203,0.772843447
9725,528,397,28,22,0.001372549,685231,0.772875028
8393,204,335,28,22,0.001372549,685259,0.77290661
10593,22,514,27,22,0.001323529,685286,0.772937063
7873,224,117,27,22,0.001323529,685313,0.772967516
2709,475,80,27,22,0.001323529,685340,0.77299797
6516,353,48,27,22,0.001323529,685367,0.773028423
11009,427,347,27,22,0.001323529,685394,0.773058877
9208,14,219,27,22,0.001323529,685421,0.77308933
7759,409,105,27,22,0.001323529,685448,0.773119783
10523,145,397,27,22,0.001323529,685475,0.773150237
10499,68,404,27,22,0.001323529,685502,0.77318069
5662,30,471,27,22,0.001323529,685529,0.773211144
6041,532,31,27,22,0.001323529,685556,0.773241597
8907,674,264,27,22,0.001323529,685583,0.773272051
9119,596,164,26,22,0.00127451,685609,0.773301376
10222,347,663,26,22,0.00127451,685635,0.773330702
8300,219,638,26,22,0.00127451,685661,0.773360027
7083,145,141,26,22,0.00127451,685687,0.773389353
10261,514,404,26,22,0.00127451,685713,0.773418678
6730,264,26,25,22,0.00122549,685738,0.773446876
10741,593,11,25,22,0.00122549,685763,0.773475073
11465,130,163,25,22,0.00122549,685788,0.773503271
10328,34,443,25,22,0.00122549,685813,0.773531469
10909,155,131,25,22,0.00122549,685838,0.773559666
10698,552,313,24,22,0.001176471,685862,0.773586736
6558,507,380,24,22,0.001176471,685886,0.773613806
5514,609,586,54,21,0.002647059,685940,0.773674712
1343,25,158,46,21,0.002254902,685986,0.773726596
5992,335,22,45,21,0.002205882,686031,0.773777352
5608,131,497,45,21,0.002205882,686076,0.773828107
5013,302,674,45,21,0.002205882,686121,0.773878863
4842,236,274,45,21,0.002205882,686166,0.773929619
4532,614,331,44,21,0.002156863,686210,0.773979247
4686,1,479,44,21,0.002156863,686254,0.774028874
9128,380,90,43,21,0.002107843,686297,0.774077374
5830,414,11,43,21,0.002107843,686340,0.774125874
7075,27,571,43,21,0.002107843,686383,0.774174374
5220,10,404,43,21,0.002107843,686426,0.774222874
5678,310,15,42,21,0.002058824,686468,0.774270246
6343,97,471,42,21,0.002058824,686510,0.774317618
6625,614,33,42,21,0.002058824,686552,0.77436499
5886,77,140,41,21,0.002009804,686593,0.774411234
5620,588,30,41,21,0.002009804,686634,0.774457478
4706,30,15,40,21,0.001960784,686674,0.774502594
9382,414,385,40,21,0.001960784,686714,0.77454771
4163,11,473,40,21,0.001960784,686754,0.774592827
8410,348,195,40,21,0.001960784,686794,0.774637943
7829,68,193,40,21,0.001960784,686834,0.774683059
3457,302,97,40,21,0.001960784,686874,0.774728175
5568,219,84,40,21,0.001960784,686914,0.774773291
3893,514,105,39,21,0.001911765,686953,0.774817279
5005,33,397,39,21,0.001911765,686992,0.774861268
7409,348,171,39,21,0.001911765,687031,0.774905256
6133,33,427,39,21,0.001911765,687070,0.774949244
7020,34,280,39,21,0.001911765,687109,0.774993233
5633,77,64,39,21,0.001911765,687148,0.775037221
6481,219,295,38,21,0.001862745,687186,0.775080081
6235,50,367,38,21,0.001862745,687224,0.775122942
7982,13,14,38,21,0.001862745,687262,0.775165802
5594,107,4,38,21,0.001862745,687300,0.775208662
4879,295,14,38,21,0.001862745,687338,0.775251523
7055,56,107,38,21,0.001862745,687376,0.775294383
9315,708,624,38,21,0.001862745,687414,0.775337243
5385,30,558,38,21,0.001862745,687452,0.775380104
8283,427,379,38,21,0.001862745,687490,0.775422964
8282,328,131,38,21,0.001862745,687528,0.775465824
5832,3,15,38,21,0.001862745,687566,0.775508685
6733,171,353,38,21,0.001862745,687604,0.775551545
4152,158,26,37,21,0.001813725,687641,0.775593278
6606,280,250,37,21,0.001813725,687678,0.77563501
6106,10,708,37,21,0.001813725,687715,0.775676743
4408,379,532,37,21,0.001813725,687752,0.775718475
7217,588,117,37,21,0.001813725,687789,0.775760208
7223,398,10,37,21,0.001813725,687826,0.77580194
7017,56,54,37,21,0.001813725,687863,0.775843672
7537,295,674,37,21,0.001813725,687900,0.775885405
7532,48,427,37,21,0.001813725,687937,0.775927137
5423,196,380,37,21,0.001813725,687974,0.77596887
5566,586,230,37,21,0.001813725,688011,0.776010602
4635,475,380,37,21,0.001813725,688048,0.776052335
5965,674,562,37,21,0.001813725,688085,0.776094067
6569,56,498,36,21,0.001764706,688121,0.776134672
6565,302,204,36,21,0.001764706,688157,0.776175276
5367,544,219,36,21,0.001764706,688193,0.776215881
3145,558,511,36,21,0.001764706,688229,0.776256485
3529,582,414,36,21,0.001764706,688265,0.77629709
7053,107,348,36,21,0.001764706,688301,0.776337695
6490,280,15,36,21,0.001764706,688337,0.776378299
8518,427,230,36,21,0.001764706,688373,0.776418904
9079,471,348,36,21,0.001764706,688409,0.776459508
5735,204,145,36,21,0.001764706,688445,0.776500113
7243,353,14,36,21,0.001764706,688481,0.776540717
6148,475,6,36,21,0.001764706,688517,0.776581322
9029,427,354,36,21,0.001764706,688553,0.776621926
5810,204,170,36,21,0.001764706,688589,0.776662531
6771,9,552,36,21,0.001764706,688625,0.776703136
5824,33,543,36,21,0.001764706,688661,0.77674374
5452,20,158,36,21,0.001764706,688697,0.776784345
9900,158,347,36,21,0.001764706,688733,0.776824949
4802,614,123,35,21,0.001715686,688768,0.776864426
4781,11,334,35,21,0.001715686,688803,0.776903903
8480,348,167,35,21,0.001715686,688838,0.776943379
7545,314,167,35,21,0.001715686,688873,0.776982856
7857,261,609,35,21,0.001715686,688908,0.777022333
6409,107,674,35,21,0.001715686,688943,0.777061809
5293,3,532,35,21,0.001715686,688978,0.777101286
5525,12,393,35,21,0.001715686,689013,0.777140762
8047,689,219,35,21,0.001715686,689048,0.777180239
5407,95,311,35,21,0.001715686,689083,0.777219716
8239,588,242,35,21,0.001715686,689118,0.777259192
5163,196,230,35,21,0.001715686,689153,0.777298669
6982,131,708,35,21,0.001715686,689188,0.777338146
4708,397,498,35,21,0.001715686,689223,0.777377622
5189,12,107,35,21,0.001715686,689258,0.777417099
5490,193,32,35,21,0.001715686,689293,0.777456576
6530,107,295,35,21,0.001715686,689328,0.777496052
8645,80,54,35,21,0.001715686,689363,0.777535529
7118,463,379,35,21,0.001715686,689398,0.777575006
6285,614,473,35,21,0.001715686,689433,0.777614482
7297,130,131,35,21,0.001715686,689468,0.777653959
5575,558,170,35,21,0.001715686,689503,0.777693436
6354,274,11,35,21,0.001715686,689538,0.777732912
6570,114,393,34,21,0.001666667,689572,0.777771261
6927,11,26,34,21,0.001666667,689606,0.77780961
6276,302,596,34,21,0.001666667,689640,0.777847958
5602,3,586,34,21,0.001666667,689674,0.777886307
7699,16,156,34,21,0.001666667,689708,0.777924656
5483,196,68,34,21,0.001666667,689742,0.777963005
5168,13,20,34,21,0.001666667,689776,0.778001353
5343,95,348,34,21,0.001666667,689810,0.778039702
8253,123,517,34,21,0.001666667,689844,0.778078051
4986,164,353,34,21,0.001666667,689878,0.7781164
5164,331,265,34,21,0.001666667,689912,0.778154748
9632,163,331,34,21,0.001666667,689946,0.778193097
5942,77,511,34,21,0.001666667,689980,0.778231446
7995,280,204,34,21,0.001666667,690014,0.778269795
7284,596,328,34,21,0.001666667,690048,0.778308143
6452,32,170,34,21,0.001666667,690082,0.778346492
6160,56,313,34,21,0.001666667,690116,0.778384841
5442,30,475,34,21,0.001666667,690150,0.77842319
7944,632,219,34,21,0.001666667,690184,0.778461538
7130,310,328,34,21,0.001666667,690218,0.778499887
6528,632,14,34,21,0.001666667,690252,0.778538236
7236,1,204,34,21,0.001666667,690286,0.778576585
4315,552,158,34,21,0.001666667,690320,0.778614933
6505,335,593,34,21,0.001666667,690354,0.778653282
4870,30,9,34,21,0.001666667,690388,0.778691631
7208,280,33,33,21,0.001617647,690421,0.778728852
5444,145,353,33,21,0.001617647,690454,0.778766073
6681,310,414,33,21,0.001617647,690487,0.778803293
5065,640,295,33,21,0.001617647,690520,0.778840514
6199,32,274,33,21,0.001617647,690553,0.778877735
3804,502,80,33,21,0.001617647,690586,0.778914956
5816,158,582,33,21,0.001617647,690619,0.778952177
5823,314,246,33,21,0.001617647,690652,0.778989398
9235,347,302,33,21,0.001617647,690685,0.779026619
2996,497,158,33,21,0.001617647,690718,0.779063839
6118,310,141,33,21,0.001617647,690751,0.77910106
6512,34,10,33,21,0.001617647,690784,0.779138281
6424,196,379,33,21,0.001617647,690817,0.779175502
8505,158,141,33,21,0.001617647,690850,0.779212723
6356,311,170,33,21,0.001617647,690883,0.779249944
7024,586,68,33,21,0.001617647,690916,0.779287164
9396,48,497,33,21,0.001617647,690949,0.779324385
8397,243,236,33,21,0.001617647,690982,0.779361606
7451,311,661,33,21,0.001617647,691015,0.779398827
6439,230,632,33,21,0.001617647,691048,0.779436048
5933,443,385,33,21,0.001617647,691081,0.779473269
9674,552,367,33,21,0.001617647,691114,0.77951049
6309,130,543,33,21,0.001617647,691147,0.77954771
4044,638,32,33,21,0.001617647,691180,0.779584931
7004,34,311,33,21,0.001617647,691213,0.779622152
6644,310,264,33,21,0.001617647,691246,0.779659373
6660,32,427,33,21,0.001617647,691279,0.779696594
6259,158,32,33,21,0.001617647,691312,0.779733815
6033,414,334,33,21,0.001617647,691345,0.779771035
6647,302,708,33,21,0.001617647,691378,0.779808256
10643,427,219,32,21,0.001568627,691410,0.779844349
10220,117,230,32,21,0.001568627,691442,0.779880442
7112,236,163,32,21,0.001568627,691474,0.779916535
5720,20,723,32,21,0.001568627,691506,0.779952628
7202,230,164,32,21,0.001568627,691538,0.779988721
5727,586,236,32,21,0.001568627,691570,0.780024814
7010,314,392,32,21,0.001568627,691602,0.780060907
5625,558,84,32,21,0.001568627,691634,0.780097
3801,689,313,32,21,0.001568627,691666,0.780133093
4871,586,11,32,21,0.001568627,691698,0.780169186
5656,596,50,32,21,0.001568627,691730,0.780205279
7040,107,479,32,21,0.001568627,691762,0.780241372
4865,302,397,32,21,0.001568627,691794,0.780277464
7030,15,95,32,21,0.001568627,691826,0.780313557
7300,708,15,32,21,0.001568627,691858,0.78034965
7619,158,562,32,21,0.001568627,691890,0.780385743
6629,26,674,32,21,0.001568627,691922,0.780421836
6655,331,274,32,21,0.001568627,691954,0.780457929
8190,673,497,32,21,0.001568627,691986,0.780494022
9367,385,529,32,21,0.001568627,692018,0.780530115
5892,535,586,32,21,0.001568627,692050,0.780566208
6291,158,443,32,21,0.001568627,692082,0.780602301
8170,130,265,32,21,0.001568627,692114,0.780638394
9812,171,145,32,21,0.001568627,692146,0.780674487
8113,230,508,32,21,0.001568627,692178,0.78071058
9309,348,294,32,21,0.001568627,692210,0.780746673
4644,145,123,32,21,0.001568627,692242,0.780782766
6228,56,250,32,21,0.001568627,692274,0.780818859
2047,9,264,32,21,0.001568627,692306,0.780854952
4599,26,22,32,21,0.001568627,692338,0.780891044
6401,25,501,32,21,0.001568627,692370,0.780927137
6435,158,497,32,21,0.001568627,692402,0.78096323
6563,443,663,32,21,0.001568627,692434,0.780999323
5392,655,586,32,21,0.001568627,692466,0.781035416
8654,313,552,32,21,0.001568627,692498,0.781071509
5356,397,32,32,21,0.001568627,692530,0.781107602
8039,26,204,32,21,0.001568627,692562,0.781143695
6175,475,354,32,21,0.001568627,692594,0.781179788
8949,393,347,32,21,0.001568627,692626,0.781215881
9143,348,141,32,21,0.001568627,692658,0.781251974
8014,230,265,32,21,0.001568627,692690,0.781288067
8985,347,379,32,21,0.001568627,692722,0.78132416
5431,156,511,32,21,0.001568627,692754,0.781360253
6760,219,397,32,21,0.001568627,692786,0.781396346
6196,236,121,32,21,0.001568627,692818,0.781432439
7920,105,12,32,21,0.001568627,692850,0.781468531
9086,230,85,31,21,0.001519608,692881,0.781503497
9098,131,398,31,21,0.001519608,692912,0.781538462
4588,543,105,31,21,0.001519608,692943,0.781573427
7475,14,15,31,21,0.001519608,692974,0.781608392
7517,328,48,31,21,0.001519608,693005,0.781643357
5020,5,20,31,21,0.001519608,693036,0.781678322
8556,158,11,31,21,0.001519608,693067,0.781713287
9566,236,156,31,21,0.001519608,693098,0.781748252
9181,3,517,31,21,0.001519608,693129,0.781783217
8802,230,552,31,21,0.001519608,693160,0.781818182
7162,3,54,31,21,0.001519608,693191,0.781853147
9255,64,473,31,21,0.001519608,693222,0.781888112
4354,605,105,31,21,0.001519608,693253,0.781923077
7306,302,26,31,21,0.001519608,693284,0.781958042
6144,158,331,31,21,0.001519608,693315,0.781993007
7292,558,22,31,21,0.001519608,693346,0.782027972
5320,414,230,31,21,0.001519608,693377,0.782062937
4520,586,532,31,21,0.001519608,693408,0.782097902
4335,596,302,31,21,0.001519608,693439,0.782132867
7141,379,348,31,21,0.001519608,693470,0.782167832
6890,310,640,31,21,0.001519608,693501,0.782202797
7648,219,313,31,21,0.001519608,693532,0.782237762
7008,32,107,31,21,0.001519608,693563,0.782272727
7019,302,141,31,21,0.001519608,693594,0.782307692
8034,34,307,31,21,0.001519608,693625,0.782342657
4750,473,158,31,21,0.001519608,693656,0.782377622
6765,532,15,31,21,0.001519608,693687,0.782412587
9895,131,501,31,21,0.001519608,693718,0.782447552
6812,219,354,31,21,0.001519608,693749,0.782482517
5508,280,663,31,21,0.001519608,693780,0.782517483
5914,274,230,31,21,0.001519608,693811,0.782552448
9653,204,280,31,21,0.001519608,693842,0.782587413
4666,708,314,31,21,0.001519608,693873,0.782622378
7959,105,207,31,21,0.001519608,693904,0.782657343
10871,80,5,31,21,0.001519608,693935,0.782692308
7549,1,295,31,21,0.001519608,693966,0.782727273
6475,379,663,31,21,0.001519608,693997,0.782762238
7841,674,689,30,21,0.001470588,694027,0.782796075
5319,674,3,30,21,0.001470588,694057,0.782829912
7282,204,34,30,21,0.001470588,694087,0.782863749
9405,558,126,30,21,0.001470588,694117,0.782897586
9424,552,95,30,21,0.001470588,694147,0.782931423
8661,171,131,30,21,0.001470588,694177,0.782965261
7576,439,335,30,21,0.001470588,694207,0.782999098
9557,107,170,30,21,0.001470588,694237,0.783032935
8567,502,236,30,21,0.001470588,694267,0.783066772
8449,236,170,30,21,0.001470588,694297,0.783100609
9636,107,714,30,21,0.001470588,694327,0.783134446
9933,328,265,30,21,0.001470588,694357,0.783168283
7405,84,348,30,21,0.001470588,694387,0.78320212
8793,473,446,30,21,0.001470588,694417,0.783235958
8785,618,347,30,21,0.001470588,694447,0.783269795
5058,501,586,30,21,0.001470588,694477,0.783303632
8471,280,347,30,21,0.001470588,694507,0.783337469
4852,640,380,30,21,0.001470588,694537,0.783371306
4855,32,544,30,21,0.001470588,694567,0.783405143
7015,1,588,30,21,0.001470588,694597,0.78343898
6453,6,13,30,21,0.001470588,694627,0.783472818
6338,502,26,30,21,0.001470588,694657,0.783506655
6877,50,9,30,21,0.001470588,694687,0.783540492
6708,133,314,30,21,0.001470588,694717,0.783574329
6578,582,22,30,21,0.001470588,694747,0.783608166
6519,1,123,30,21,0.001470588,694777,0.783642003
8870,463,596,29,21,0.001421569,694806,0.783674712
11260,56,12,29,21,0.001421569,694835,0.783707422
7590,280,14,29,21,0.001421569,694864,0.783740131
7794,80,15,29,21,0.001421569,694893,0.78377284
7527,242,224,29,21,0.001421569,694922,0.783805549
6929,84,497,29,21,0.001421569,694951,0.783838259
7061,498,663,29,21,0.001421569,694980,0.783870968
9317,497,10,29,21,0.001421569,695009,0.783903677
8812,552,532,29,21,0.001421569,695038,0.783936386
6989,34,196,29,21,0.001421569,695067,0.783969095
6250,632,33,29,21,0.001421569,695096,0.784001805
8868,11,242,29,21,0.001421569,695125,0.784034514
5344,335,20,29,21,0.001421569,695154,0.784067223
5722,501,141,29,21,0.001421569,695183,0.784099932
9357,84,674,29,21,0.001421569,695212,0.784132642
3910,4,310,29,21,0.001421569,695241,0.784165351
7999,219,596,29,21,0.001421569,695270,0.78419806
2681,196,582,29,21,0.001421569,695299,0.784230769
7804,219,48,29,21,0.001421569,695328,0.784263478
7888,498,501,29,21,0.001421569,695357,0.784296188
8626,77,126,29,21,0.001421569,695386,0.784328897
6344,543,33,29,21,0.001421569,695415,0.784361606
8525,105,503,29,21,0.001421569,695444,0.784394315
7984,26,31,29,21,0.001421569,695473,0.784427025
5782,596,535,29,21,0.001421569,695502,0.784459734
5964,663,26,29,21,0.001421569,695531,0.784492443
6930,471,394,29,21,0.001421569,695560,0.784525152
7156,219,511,29,21,0.001421569,695589,0.784557861
4450,313,501,29,21,0.001421569,695618,0.784590571
7268,33,107,29,21,0.001421569,695647,0.78462328
7117,15,479,29,21,0.001421569,695676,0.784655989
9084,517,33,29,21,0.001421569,695705,0.784688698
6038,558,532,29,21,0.001421569,695734,0.784721408
8712,25,596,28,21,0.001372549,695762,0.784752989
10322,160,16,28,21,0.001372549,695790,0.78478457
7729,497,394,28,21,0.001372549,695818,0.784816152
6941,302,544,28,21,0.001372549,695846,0.784847733
2326,529,158,28,21,0.001372549,695874,0.784879314
8048,114,84,28,21,0.001372549,695902,0.784910896
6976,475,674,28,21,0.001372549,695930,0.784942477
9666,348,618,28,21,0.001372549,695958,0.784974058
8451,156,353,28,21,0.001372549,695986,0.78500564
6779,708,558,28,21,0.001372549,696014,0.785037221
7698,20,80,28,21,0.001372549,696042,0.785068802
10805,43,3,28,21,0.001372549,696070,0.785100383
7798,15,471,28,21,0.001372549,696098,0.785131965
9462,311,646,28,21,0.001372549,696126,0.785163546
7187,528,16,28,21,0.001372549,696154,0.785195127
8631,56,427,28,21,0.001372549,696182,0.785226709
6935,302,280,28,21,0.001372549,696210,0.78525829
7985,479,632,28,21,0.001372549,696238,0.785289871
7967,307,97,28,21,0.001372549,696266,0.785321453
4967,33,64,28,21,0.001372549,696294,0.785353034
12220,131,661,28,21,0.001372549,696322,0.785384615
7350,367,614,28,21,0.001372549,696350,0.785416197
8536,593,131,28,21,0.001372549,696378,0.785447778
10665,348,13,28,21,0.001372549,696406,0.785479359
7110,16,640,28,21,0.001372549,696434,0.785510941
7064,32,5,28,21,0.001372549,696462,0.785542522
6546,158,123,28,21,0.001372549,696490,0.785574103
5383,265,26,28,21,0.001372549,696518,0.785605685
8830,32,661,28,21,0.001372549,696546,0.785637266
8166,473,117,28,21,0.001372549,696574,0.785668847
10652,380,409,28,21,0.001372549,696602,0.785700429
7513,588,501,28,21,0.001372549,696630,0.78573201
8247,347,95,28,21,0.001372549,696658,0.785763591
7274,84,328,28,21,0.001372549,696686,0.785795173
8387,123,328,28,21,0.001372549,696714,0.785826754
12590,473,613,28,21,0.001372549,696742,0.785858335
6022,158,280,28,21,0.001372549,696770,0.785889917
11912,624,347,28,21,0.001372549,696798,0.785921498
7132,313,22,28,21,0.001372549,696826,0.785953079
8818,596,274,28,21,0.001372549,696854,0.785984661
8287,443,145,27,21,0.001323529,696881,0.786015114
5815,393,586,27,21,0.001323529,696908,0.786045567
9092,3,364,27,21,0.001323529,696935,0.786076021
8627,15,708,27,21,0.001323529,696962,0.786106474
8319,354,264,27,21,0.001323529,696989,0.786136928
7215,311,544,27,21,0.001323529,697016,0.786167381
8164,663,501,27,21,0.001323529,697043,0.786197834
8349,33,5,27,21,0.001323529,697070,0.786228288
10020,77,156,27,21,0.001323529,697097,0.786258741
8526,25,11,27,21,0.001323529,697124,0.786289195
10405,552,498,27,21,0.001323529,697151,0.786319648
5085,682,80,27,21,0.001323529,697178,0.786350102
5042,582,385,27,21,0.001323529,697205,0.786380555
7594,609,26,27,21,0.001323529,697232,0.786411008
10852,114,313,27,21,0.001323529,697259,0.786441462
9043,311,5,26,21,0.00127451,697285,0.786470787
9687,354,661,26,21,0.00127451,697311,0.786500113
9245,68,13,26,21,0.00127451,697337,0.786529438
8215,367,529,26,21,0.00127451,697363,0.786558764
10979,593,501,26,21,0.00127451,697389,0.786588089
7509,562,532,26,21,0.00127451,697415,0.786617415
7564,646,380,26,21,0.00127451,697441,0.78664674
10628,230,652,26,21,0.00127451,697467,0.786676066
9867,498,23,26,21,0.00127451,697493,0.786705391
8318,393,385,26,21,0.00127451,697519,0.786734717
9010,673,97,26,21,0.00127451,697545,0.786764042
10251,2,126,26,21,0.00127451,697571,0.786793368
10709,196,624,26,21,0.00127451,697597,0.786822693
12274,427,522,26,21,0.00127451,697623,0.786852019
8961,302,29,26,21,0.00127451,697649,0.786881344
9350,347,311,25,21,0.00122549,697674,0.786909542
8659,25,331,25,21,0.00122549,697699,0.78693774
9004,20,353,25,21,0.00122549,697724,0.786965937
8891,56,243,25,21,0.00122549,697749,0.786994135
8916,230,25,25,21,0.00122549,697774,0.787022333
8938,133,26,25,21,0.00122549,697799,0.78705053
11280,353,332,25,21,0.00122549,697824,0.787078728
5952,31,302,25,21,0.00122549,697849,0.787106925
11557,193,167,25,21,0.00122549,697874,0.787135123
12046,517,689,25,21,0.00122549,697899,0.787163321
14941,34,85,25,21,0.00122549,697924,0.787191518
8175,663,632,25,21,0.00122549,697949,0.787219716
10966,269,224,25,21,0.00122549,697974,0.787247913
9545,114,236,24,21,0.001176471,697998,0.787274983
8573,219,141,24,21,0.001176471,698022,0.787302053
8683,13,123,24,21,0.001176471,698046,0.787329122
7355,219,95,24,21,0.001176471,698070,0.787356192
7312,25,502,24,21,0.001176471,698094,0.787383262
13116,27,684,24,21,0.001176471,698118,0.787410332
7084,261,380,24,21,0.001176471,698142,0.787437401
9273,502,131,24,21,0.001176471,698166,0.787464471
11357,236,23,24,21,0.001176471,698190,0.787491541
8028,562,379,24,21,0.001176471,698214,0.78751861
8214,95,640,24,21,0.001176471,698238,0.78754568
8858,219,204,23,21,0.001127451,698261,0.787571622
10597,517,77,23,21,0.001127451,698284,0.787597564
4290,586,379,23,21,0.001127451,698307,0.787623506
11509,155,195,23,21,0.001127451,698330,0.787649447
13019,64,588,23,21,0.001127451,698353,0.787675389
13283,84,342,22,21,0.001078431,698375,0.787700203
11121,471,171,22,21,0.001078431,698397,0.787725017
13900,1,569,22,21,0.001078431,698419,0.787749831
5829,562,68,49,20,0.002401961,698468,0.787805098
8749,562,130,44,20,0.002156863,698512,0.787854726
4923,471,335,44,20,0.002156863,698556,0.787904354
6607,614,367,43,20,0.002107843,698599,0.787952854
5061,3,443,42,20,0.002058824,698641,0.788000226
7932,498,313,42,20,0.002058824,698683,0.788047598
6466,353,295,41,20,0.002009804,698724,0.788093842
6379,507,224,41,20,0.002009804,698765,0.788140086
6295,614,11,41,20,0.002009804,698806,0.78818633
7155,498,609,40,20,0.001960784,698846,0.788231446
6981,663,307,40,20,0.001960784,698886,0.788276562
4760,31,32,40,20,0.001960784,698926,0.788321678
6966,367,497,39,20,0.001911765,698965,0.788365667
4225,130,511,39,20,0.001911765,699004,0.788409655
6377,582,587,38,20,0.001862745,699042,0.788452515
7147,471,479,38,20,0.001862745,699080,0.788495376
9289,230,544,38,20,0.001862745,699118,0.788538236
6933,145,195,38,20,0.001862745,699156,0.788581096
8728,6,385,37,20,0.001813725,699193,0.788622829
8077,394,33,37,20,0.001813725,699230,0.788664561
7126,25,236,37,20,0.001813725,699267,0.788706294
7775,427,33,37,20,0.001813725,699304,0.788748026
3114,689,479,37,20,0.001813725,699341,0.788789759
5932,145,331,37,20,0.001813725,699378,0.788831491
4562,609,379,37,20,0.001813725,699415,0.788873224
5865,552,10,37,20,0.001813725,699452,0.788914956
6597,280,502,36,20,0.001764706,699488,0.788955561
4333,443,11,36,20,0.001764706,699524,0.788996165
4648,33,394,36,20,0.001764706,699560,0.78903677
5032,475,379,36,20,0.001764706,699596,0.789077374
8692,328,243,36,20,0.001764706,699632,0.789117979
5283,596,48,36,20,0.001764706,699668,0.789158583
3772,265,84,36,20,0.001764706,699704,0.789199188
5820,311,708,36,20,0.001764706,699740,0.789239792
5781,353,145,36,20,0.001764706,699776,0.789280397
5799,196,95,35,20,0.001715686,699811,0.789319874
6973,33,596,35,20,0.001715686,699846,0.78935935
7583,3,64,35,20,0.001715686,699881,0.789398827
4129,383,105,35,20,0.001715686,699916,0.789438304
8124,31,708,35,20,0.001715686,699951,0.78947778
8896,3,2,35,20,0.001715686,699986,0.789517257
7288,609,498,35,20,0.001715686,700021,0.789556734
8708,471,689,35,20,0.001715686,700056,0.78959621
9404,204,367,35,20,0.001715686,700091,0.789635687
4371,30,335,35,20,0.001715686,700126,0.789675164
7499,12,84,35,20,0.001715686,700161,0.78971464
6547,404,354,34,20,0.001666667,700195,0.789752989
3946,302,723,34,20,0.001666667,700229,0.789791338
8103,29,196,34,20,0.001666667,700263,0.789829686
9369,174,708,34,20,0.001666667,700297,0.789868035
6701,632,310,34,20,0.001666667,700331,0.789906384
7569,414,131,34,20,0.001666667,700365,0.789944733
6484,393,655,34,20,0.001666667,700399,0.789983081
9166,522,439,34,20,0.001666667,700433,0.79002143
5112,394,311,34,20,0.001666667,700467,0.790059779
10450,348,193,34,20,0.001666667,700501,0.790098128
6527,80,475,34,20,0.001666667,700535,0.790136476
7795,171,196,34,20,0.001666667,700569,0.790174825
9236,471,328,33,20,0.001617647,700602,0.790212046
7298,27,13,33,20,0.001617647,700635,0.790249267
6833,354,532,33,20,0.001617647,700668,0.790286488
7341,145,11,33,20,0.001617647,700701,0.790323709
4490,9,404,33,20,0.001617647,700734,0.790360929
6940,204,522,33,20,0.001617647,700767,0.79039815
3920,9,414,33,20,0.001617647,700800,0.790435371
3419,674,158,33,20,0.001617647,700833,0.790472592
7326,663,280,33,20,0.001617647,700866,0.790509813
7796,427,9,33,20,0.001617647,700899,0.790547034
6079,123,385,33,20,0.001617647,700932,0.790584254
8380,174,348,33,20,0.001617647,700965,0.790621475
6005,640,196,33,20,0.001617647,700998,0.790658696
8340,156,141,33,20,0.001617647,701031,0.790695917
6536,497,219,33,20,0.001617647,701064,0.790733138
6014,171,562,33,20,0.001617647,701097,0.790770359
7630,145,379,33,20,0.001617647,701130,0.79080758
7477,6,618,33,20,0.001617647,701163,0.7908448
4572,9,632,33,20,0.001617647,701196,0.790882021
6618,6,34,33,20,0.001617647,701229,0.790919242
5870,311,64,33,20,0.001617647,701262,0.790956463
8837,473,448,33,20,0.001617647,701295,0.790993684
7661,27,409,33,20,0.001617647,701328,0.791030905
4930,532,145,33,20,0.001617647,701361,0.791068125
7104,16,385,33,20,0.001617647,701394,0.791105346
7081,532,502,32,20,0.001568627,701426,0.791141439
7077,614,529,32,20,0.001568627,701458,0.791177532
5120,310,638,32,20,0.001568627,701490,0.791213625
7567,250,68,32,20,0.001568627,701522,0.791249718
7553,514,586,32,20,0.001568627,701554,0.791285811
7257,501,313,32,20,0.001568627,701586,0.791321904
7740,219,11,32,20,0.001568627,701618,0.791357997
7419,646,27,32,20,0.001568627,701650,0.79139409
7431,471,219,32,20,0.001568627,701682,0.791430183
4932,586,311,32,20,0.001568627,701714,0.791466276
5477,394,655,32,20,0.001568627,701746,0.791502369
7579,640,463,32,20,0.001568627,701778,0.791538462
8192,1,2,32,20,0.001568627,701810,0.791574554
6370,507,353,32,20,0.001568627,701842,0.791610647
9571,517,367,32,20,0.001568627,701874,0.79164674
6365,638,145,32,20,0.001568627,701906,0.791682833
5369,32,2,32,20,0.001568627,701938,0.791718926
4563,34,80,32,20,0.001568627,701970,0.791755019
8684,145,640,32,20,0.001568627,702002,0.791791112
8642,11,558,32,20,0.001568627,702034,0.791827205
6800,353,114,32,20,0.001568627,702066,0.791863298
7942,43,105,32,20,0.001568627,702098,0.791899391
6830,596,3,32,20,0.001568627,702130,0.791935484
8036,380,683,32,20,0.001568627,702162,0.791971577
9019,3,242,32,20,0.001568627,702194,0.79200767
6807,1,302,32,20,0.001568627,702226,0.792043763
7978,3,14,32,20,0.001568627,702258,0.792079856
8869,114,367,32,20,0.001568627,702290,0.792115949
7539,674,529,31,20,0.001519608,702321,0.792150914
6359,242,655,31,20,0.001519608,702352,0.792185879
5202,243,9,31,20,0.001519608,702383,0.792220844
6080,80,145,31,20,0.001519608,702414,0.792255809
6078,243,264,31,20,0.001519608,702445,0.792290774
5529,9,56,31,20,0.001519608,702476,0.792325739
6185,196,475,31,20,0.001519608,702507,0.792360704
8967,171,708,31,20,0.001519608,702538,0.792395669
5332,532,50,31,20,0.001519608,702569,0.792430634
6164,95,475,31,20,0.001519608,702600,0.792465599
6010,397,4,31,20,0.001519608,702631,0.792500564
6238,673,498,31,20,0.001519608,702662,0.792535529
7988,674,560,31,20,0.001519608,702693,0.792570494
7679,123,544,31,20,0.001519608,702724,0.792605459
6728,673,558,31,20,0.001519608,702755,0.792640424
7708,522,22,31,20,0.001519608,702786,0.792675389
7689,105,618,31,20,0.001519608,702817,0.792710354
9779,498,463,31,20,0.001519608,702848,0.792745319
8467,535,295,31,20,0.001519608,702879,0.792780284
8323,114,68,31,20,0.001519608,702910,0.792815249
8329,25,131,31,20,0.001519608,702941,0.792850214
10425,230,140,31,20,0.001519608,702972,0.792885179
8909,414,328,30,20,0.001470588,703002,0.792919016
5618,614,497,30,20,0.001470588,703032,0.792952854
9094,528,243,30,20,0.001470588,703062,0.792986691
8040,385,393,30,20,0.001470588,703092,0.793020528
9058,130,502,30,20,0.001470588,703122,0.793054365
10258,48,145,30,20,0.001470588,703152,0.793088202
12326,683,498,30,20,0.001470588,703182,0.793122039
8933,348,174,30,20,0.001470588,703212,0.793155876
10284,117,310,30,20,0.001470588,703242,0.793189714
8501,77,29,30,20,0.001470588,703272,0.793223551
11872,15,443,30,20,0.001470588,703302,0.793257388
10442,427,10,30,20,0.001470588,703332,0.793291225
5303,97,380,30,20,0.001470588,703362,0.793325062
7515,443,502,30,20,0.001470588,703392,0.793358899
8550,114,473,30,20,0.001470588,703422,0.793392736
8497,414,117,30,20,0.001470588,703452,0.793426573
11734,427,95,30,20,0.001470588,703482,0.793460411
7262,310,439,30,20,0.001470588,703512,0.793494248
8169,6,107,30,20,0.001470588,703542,0.793528085
7682,673,26,30,20,0.001470588,703572,0.793561922
6667,558,243,30,20,0.001470588,703602,0.793595759
5651,379,638,30,20,0.001470588,703632,0.793629596
6413,609,230,30,20,0.001470588,703662,0.793663433
6798,393,131,30,20,0.001470588,703692,0.79369727
6790,614,379,30,20,0.001470588,703722,0.793731108
4806,479,393,30,20,0.001470588,703752,0.793764945
6342,354,638,30,20,0.001470588,703782,0.793798782
6936,684,27,30,20,0.001470588,703812,0.793832619
6928,243,107,30,20,0.001470588,703842,0.793866456
6861,1,224,30,20,0.001470588,703872,0.793900293
7099,367,348,30,20,0.001470588,703902,0.79393413
6195,588,544,30,20,0.001470588,703932,0.793967968
6206,95,15,30,20,0.001470588,703962,0.794001805
6222,50,354,30,20,0.001470588,703992,0.794035642
6680,479,498,30,20,0.001470588,704022,0.794069479
6683,1,335,30,20,0.001470588,704052,0.794103316
10761,204,243,30,20,0.001470588,704082,0.794137153
7076,250,522,29,20,0.001421569,704111,0.794169862
5318,302,114,29,20,0.001421569,704140,0.794202572
6323,131,393,29,20,0.001421569,704169,0.794235281
6916,25,224,29,20,0.001421569,704198,0.79426799
10279,43,522,29,20,0.001421569,704227,0.794300699
8849,48,596,29,20,0.001421569,704256,0.794333409
7560,1,9,29,20,0.001421569,704285,0.794366118
7036,473,328,29,20,0.001421569,704314,0.794398827
8867,348,265,29,20,0.001421569,704343,0.794431536
7550,582,618,29,20,0.001421569,704372,0.794464245
7674,689,32,29,20,0.001421569,704401,0.794496955
8492,10,502,29,20,0.001421569,704430,0.794529664
12331,124,558,29,20,0.001421569,704459,0.794562373
11036,140,514,29,20,0.001421569,704488,0.794595082
6588,443,33,29,20,0.001421569,704517,0.794627792
9806,544,131,29,20,0.001421569,704546,0.794660501
8292,68,274,29,20,0.001421569,704575,0.79469321
8205,479,141,29,20,0.001421569,704604,0.794725919
6525,638,479,29,20,0.001421569,704633,0.794758628
6806,310,535,29,20,0.001421569,704662,0.794791338
7895,335,409,29,20,0.001421569,704691,0.794824047
8615,529,502,29,20,0.001421569,704720,0.794856756
5987,605,16,29,20,0.001421569,704749,0.794889465
6339,274,397,29,20,0.001421569,704778,0.794922175
4808,529,582,29,20,0.001421569,704807,0.794954884
5976,145,307,29,20,0.001421569,704836,0.794987593
9609,353,502,29,20,0.001421569,704865,0.795020302
7945,498,50,29,20,0.001421569,704894,0.795053012
7503,31,471,29,20,0.001421569,704923,0.795085721
6082,295,3,29,20,0.001421569,704952,0.79511843
9117,280,269,29,20,0.001421569,704981,0.795151139
8488,708,33,28,20,0.001372549,705009,0.795182721
10810,219,114,28,20,0.001372549,705037,0.795214302
10338,171,498,28,20,0.001372549,705065,0.795245883
10325,131,114,28,20,0.001372549,705093,0.795277464
11286,68,661,28,20,0.001372549,705121,0.795309046
6060,295,508,28,20,0.001372549,705149,0.795340627
5749,682,105,28,20,0.001372549,705177,0.795372208
9460,475,632,28,20,0.001372549,705205,0.79540379
6860,30,219,28,20,0.001372549,705233,0.795435371
6358,640,307,28,20,0.001372549,705261,0.795466952
4805,689,588,28,20,0.001372549,705289,0.795498534
7840,219,497,28,20,0.001372549,705317,0.795530115
3240,280,123,28,20,0.001372549,705345,0.795561696
6391,544,158,28,20,0.001372549,705373,0.795593278
8524,236,708,28,20,0.001372549,705401,0.795624859
7750,380,482,28,20,0.001372549,705429,0.79565644
8516,511,380,28,20,0.001372549,705457,0.795688022
6419,250,302,28,20,0.001372549,705485,0.795719603
6412,196,295,28,20,0.001372549,705513,0.795751184
6924,624,196,28,20,0.001372549,705541,0.795782766
6410,274,68,28,20,0.001372549,705569,0.795814347
5096,265,532,28,20,0.001372549,705597,0.795845928
5263,394,334,28,20,0.001372549,705625,0.79587751
5898,95,295,28,20,0.001372549,705653,0.795909091
9111,295,280,28,20,0.001372549,705681,0.795940672
5328,517,80,28,20,0.001372549,705709,0.795972254
8159,414,219,28,20,0.001372549,705737,0.796003835
5874,638,219,28,20,0.001372549,705765,0.796035416
3162,562,80,28,20,0.001372549,705793,0.796066998
6581,558,562,28,20,0.001372549,705821,0.796098579
8213,618,68,28,20,0.001372549,705849,0.79613016
6216,26,535,28,20,0.001372549,705877,0.796161741
4049,638,331,28,20,0.001372549,705905,0.796193323
9795,674,427,28,20,0.001372549,705933,0.796224904
7303,31,295,27,20,0.001323529,705960,0.796255358
5420,655,394,27,20,0.001323529,705987,0.796285811
7220,532,614,27,20,0.001323529,706014,0.796316264
8610,230,503,27,20,0.001323529,706041,0.796346718
10620,261,522,27,20,0.001323529,706068,0.796377171
6866,14,473,27,20,0.001323529,706095,0.796407625
7180,25,265,27,20,0.001323529,706122,0.796438078
6495,414,9,27,20,0.001323529,706149,0.796468531
11171,668,68,27,20,0.001323529,706176,0.796498985
8538,385,236,27,20,0.001323529,706203,0.796529438
8365,43,471,27,20,0.001323529,706230,0.796559892
9157,655,23,27,20,0.001323529,706257,0.796590345
8362,269,27,27,20,0.001323529,706284,0.796620799
8146,562,33,27,20,0.001323529,706311,0.796651252
6684,311,274,27,20,0.001323529,706338,0.796681705
6622,501,473,27,20,0.001323529,706365,0.796712159
7343,674,141,27,20,0.001323529,706392,0.796742612
9061,302,439,27,20,0.001323529,706419,0.796773066
10393,243,385,27,20,0.001323529,706446,0.796803519
9458,535,529,27,20,0.001323529,706473,0.796833972
7401,558,26,27,20,0.001323529,706500,0.796864426
8783,593,310,27,20,0.001323529,706527,0.796894879
7411,663,497,27,20,0.001323529,706554,0.796925333
7783,131,130,27,20,0.001323529,706581,0.796955786
10331,117,84,27,20,0.001323529,706608,0.79698624
8925,596,15,27,20,0.001323529,706635,0.797016693
5311,379,529,27,20,0.001323529,706662,0.797047146
7512,475,10,27,20,0.001323529,706689,0.7970776
8773,354,130,27,20,0.001323529,706716,0.797108053
6335,674,130,27,20,0.001323529,706743,0.797138507
10249,535,246,27,20,0.001323529,706770,0.79716896
7016,12,264,26,20,0.00127451,706796,0.797198286
7449,473,170,26,20,0.00127451,706822,0.797227611
10621,11,274,26,20,0.00127451,706848,0.797256937
6993,30,379,26,20,0.00127451,706874,0.797286262
7645,632,311,26,20,0.00127451,706900,0.797315588
11011,364,310,26,20,0.00127451,706926,0.797344913
6508,353,6,26,20,0.00127451,706952,0.797374239
5281,50,80,26,20,0.00127451,706978,0.797403564
9938,331,552,26,20,0.00127451,707004,0.79743289
10229,528,219,26,20,0.00127451,707030,0.797462215
7249,397,3,26,20,0.00127451,707056,0.797491541
8288,614,313,26,20,0.00127451,707082,0.797520866
7103,145,10,26,20,0.00127451,707108,0.797550192
10954,348,164,26,20,0.00127451,707134,0.797579517
10495,48,529,26,20,0.00127451,707160,0.797608843
4064,32,535,26,20,0.00127451,707186,0.797638168
9755,334,3,26,20,0.00127451,707212,0.797667494
8178,80,170,26,20,0.00127451,707238,0.797696819
5860,123,398,26,20,0.00127451,707264,0.797726145
7050,353,170,26,20,0.00127451,707290,0.79775547
9438,335,503,26,20,0.00127451,707316,0.797784796
6395,397,535,26,20,0.00127451,707342,0.797814121
9183,517,302,26,20,0.00127451,707368,0.797843447
10856,171,302,26,20,0.00127451,707394,0.797872772
7382,196,522,26,20,0.00127451,707420,0.797902098
11612,22,586,26,20,0.00127451,707446,0.797931423
5129,498,334,26,20,0.00127451,707472,0.797960749
11458,502,274,26,20,0.00127451,707498,0.797990074
10310,130,117,26,20,0.00127451,707524,0.7980194
7737,33,130,26,20,0.00127451,707550,0.798048725
9634,632,97,26,20,0.00127451,707576,0.798078051
6552,32,552,25,20,0.00122549,707601,0.798106249
6269,33,586,25,20,0.00122549,707626,0.798134446
8754,498,15,25,20,0.00122549,707651,0.798162644
6252,307,219,25,20,0.00122549,707676,0.798190841
9189,133,131,25,20,0.00122549,707701,0.798219039
9529,558,114,25,20,0.00122549,707726,0.798247237
8361,522,274,25,20,0.00122549,707751,0.798275434
9649,609,313,25,20,0.00122549,707776,0.798303632
9227,582,195,25,20,0.00122549,707801,0.798331829
8791,68,117,25,20,0.00122549,707826,0.798360027
8674,682,394,25,20,0.00122549,707851,0.798388225
9313,43,16,25,20,0.00122549,707876,0.798416422
7049,10,30,25,20,0.00122549,707901,0.79844462
10513,427,471,25,20,0.00122549,707926,0.798472818
7979,6,674,25,20,0.00122549,707951,0.798501015
7970,77,507,25,20,0.00122549,707976,0.798529213
10837,105,90,25,20,0.00122549,708001,0.79855741
7124,609,558,25,20,0.00122549,708026,0.798585608
7765,123,34,25,20,0.00122549,708051,0.798613806
10471,471,609,25,20,0.00122549,708076,0.798642003
6978,16,121,25,20,0.00122549,708101,0.798670201
6775,158,379,25,20,0.00122549,708126,0.798698398
9975,544,313,25,20,0.00122549,708151,0.798726596
7611,682,224,25,20,0.00122549,708176,0.798754794
8237,552,471,25,20,0.00122549,708201,0.798782991
7884,10,22,25,20,0.00122549,708226,0.798811189
7234,529,131,25,20,0.00122549,708251,0.798839386
7357,5,302,25,20,0.00122549,708276,0.798867584
4928,632,80,25,20,0.00122549,708301,0.798895782
7417,302,398,25,20,0.00122549,708326,0.798923979
8569,394,265,24,20,0.001176471,708350,0.798951049
10350,498,682,24,20,0.001176471,708374,0.798978119
7770,313,85,24,20,0.001176471,708398,0.799005188
7800,394,242,24,20,0.001176471,708422,0.799032258
6329,532,6,24,20,0.001176471,708446,0.799059328
9450,250,3,24,20,0.001176471,708470,0.799086397
9441,243,663,24,20,0.001176471,708494,0.799113467
8680,334,379,24,20,0.001176471,708518,0.799140537
10272,25,32,24,20,0.001176471,708542,0.799167607
10267,105,269,24,20,0.001176471,708566,0.799194676
11740,224,392,24,20,0.001176471,708590,0.799221746
11756,50,501,24,20,0.001176471,708614,0.799248816
10736,632,689,24,20,0.001176471,708638,0.799275885
7440,334,16,24,20,0.001176471,708662,0.799302955
9222,131,632,24,20,0.001176471,708686,0.799330025
7134,265,498,24,20,0.001176471,708710,0.799357095
9077,84,97,24,20,0.001176471,708734,0.799384164
6087,532,114,24,20,0.001176471,708758,0.799411234
9144,313,507,24,20,0.001176471,708782,0.799438304
10360,250,535,24,20,0.001176471,708806,0.799465373
10749,1,397,24,20,0.001176471,708830,0.799492443
8826,264,16,24,20,0.001176471,708854,0.799519513
7600,12,230,24,20,0.001176471,708878,0.799546582
9336,528,522,24,20,0.001176471,708902,0.799573652
6247,9,560,24,20,0.001176471,708926,0.799600722
8919,230,507,24,20,0.001176471,708950,0.799627792
6190,497,105,24,20,0.001176471,708974,0.799654861
9275,632,379,24,20,0.001176471,708998,0.799681931
11459,543,596,24,20,0.001176471,709022,0.799709001
10112,171,640,24,20,0.001176471,709046,0.79973607
5414,689,224,24,20,0.001176471,709070,0.79976314
10978,204,618,24,20,0.001176471,709094,0.79979021
9327,163,280,23,20,0.001127451,709117,0.799816152
9300,10,364,23,20,0.001127451,709140,0.799842093
9752,261,84,23,20,0.001127451,709163,0.799868035
7593,535,6,23,20,0.001127451,709186,0.799893977
8730,535,414,23,20,0.001127451,709209,0.799919919
9454,544,353,23,20,0.001127451,709232,0.799945861
7836,473,587,23,20,0.001127451,709255,0.799971802
11232,479,562,23,20,0.001127451,709278,0.799997744
9339,593,311,23,20,0.001127451,709301,0.800023686
9180,48,26,22,20,0.001078431,709323,0.8000485
12508,446,310,22,20,0.001078431,709345,0.800073314
10356,34,532,22,20,0.001078431,709367,0.800098128
9252,20,498,22,20,0.001078431,709389,0.800122942
12453,331,269,22,20,0.001078431,709411,0.800147755
7721,353,22,22,20,0.001078431,709433,0.800172569
8927,532,605,22,20,0.001078431,709455,0.800197383
8085,242,331,22,20,0.001078431,709477,0.800222197
8161,586,265,22,20,0.001078431,709499,0.800247011
15040,342,97,21,20,0.001029412,709520,0.800270697
11857,4,482,21,20,0.001029412,709541,0.800294383
9072,409,380,21,20,0.001029412,709562,0.800318069
6317,471,379,45,19,0.002205882,709607,0.800368825
7802,158,204,41,19,0.002009804,709648,0.800415069
5652,13,6,40,19,0.001960784,709688,0.800460185
6111,596,502,40,19,0.001960784,709728,0.800505301
5841,475,558,39,19,0.001911765,709767,0.800549289
4654,532,522,38,19,0.001862745,709805,0.80059215
6465,6,126,38,19,0.001862745,709843,0.80063501
7319,335,507,38,19,0.001862745,709881,0.800677871
5613,145,14,38,19,0.001862745,709919,0.800720731
8206,335,383,37,19,0.001813725,709956,0.800762463
8413,328,33,37,19,0.001813725,709993,0.800804196
5719,274,32,37,19,0.001813725,710030,0.800845928
4734,295,471,37,19,0.001813725,710067,0.800887661
4637,16,295,36,19,0.001764706,710103,0.800928265
5370,310,196,36,19,0.001764706,710139,0.80096887
5693,397,414,36,19,0.001764706,710175,0.801009474
5091,48,15,36,19,0.001764706,710211,0.801050079
6637,588,130,36,19,0.001764706,710247,0.801090684
7507,117,582,35,19,0.001715686,710282,0.80113016
5098,131,511,35,19,0.001715686,710317,0.801169637
4186,708,6,35,19,0.001715686,710352,0.801209113
7625,280,471,35,19,0.001715686,710387,0.80124859
5890,123,535,35,19,0.001715686,710422,0.801288067
4862,6,77,35,19,0.001715686,710457,0.801327543
7161,427,313,35,19,0.001715686,710492,0.80136702
7396,105,409,35,19,0.001715686,710527,0.801406497
7484,80,502,35,19,0.001715686,710562,0.801445973
4890,514,224,35,19,0.001715686,710597,0.80148545
8298,95,463,34,19,0.001666667,710631,0.801523799
9328,348,552,34,19,0.001666667,710665,0.801562148
6260,314,714,34,19,0.001666667,710699,0.801600496
4399,514,394,34,19,0.001666667,710733,0.801638845
5649,414,393,34,19,0.001666667,710767,0.801677194
4251,582,274,34,19,0.001666667,710801,0.801715543
7878,3,674,34,19,0.001666667,710835,0.801753891
5902,397,264,34,19,0.001666667,710869,0.80179224
9761,618,708,34,19,0.001666667,710903,0.801830589
6306,32,171,34,19,0.001666667,710937,0.801868938
7347,582,661,33,19,0.001617647,710970,0.801906158
5796,16,501,33,19,0.001617647,711003,0.801943379
8628,295,517,33,19,0.001617647,711036,0.8019806
8446,140,529,33,19,0.001617647,711069,0.802017821
5201,140,380,33,19,0.001617647,711102,0.802055042
5039,274,9,33,19,0.001617647,711135,0.802092263
7485,663,529,33,19,0.001617647,711168,0.802129483
7086,6,26,33,19,0.001617647,711201,0.802166704
7496,250,471,32,19,0.001568627,711233,0.802202797
3753,655,380,32,19,0.001568627,711265,0.80223889
5724,558,20,32,19,0.001568627,711297,0.802274983
7052,614,107,32,19,0.001568627,711329,0.802311076
7047,219,586,32,19,0.001568627,711361,0.802347169
8805,2,95,32,19,0.001568627,711393,0.802383262
6696,250,328,32,19,0.001568627,711425,0.802419355
8099,16,502,32,19,0.001568627,711457,0.802455448
8258,48,5,32,19,0.001568627,711489,0.802491541
9709,364,582,32,19,0.001568627,711521,0.802527634
6364,479,723,32,19,0.001568627,711553,0.802563727
8278,380,30,32,19,0.001568627,711585,0.80259982
8619,501,347,32,19,0.001568627,711617,0.802635912
9213,354,64,32,19,0.001568627,711649,0.802672005
8993,427,310,32,19,0.001568627,711681,0.802708098
9264,348,130,32,19,0.001568627,711713,0.802744191
6039,596,471,32,19,0.001568627,711745,0.802780284
6110,123,674,32,19,0.001568627,711777,0.802816377
4208,196,588,31,19,0.001519608,711808,0.802851342
4568,84,25,31,19,0.001519608,711839,0.802886307
9433,236,560,31,19,0.001519608,711870,0.802921272
6298,673,68,31,19,0.001519608,711901,0.802956237
5210,26,302,31,19,0.001519608,711932,0.802991202
8200,532,560,31,19,0.001519608,711963,0.803026167
6617,655,501,31,19,0.001519608,711994,0.803061132
7658,236,479,31,19,0.001519608,712025,0.803096097
5394,497,380,31,19,0.001519608,712056,0.803131062
4088,9,170,31,19,0.001519608,712087,0.803166028
5737,663,586,31,19,0.001519608,712118,0.803200993
3119,4,314,31,19,0.001519608,712149,0.803235958
8335,552,443,31,19,0.001519608,712180,0.803270923
10999,261,11,31,19,0.001519608,712211,0.803305888
7832,25,164,30,19,0.001470588,712241,0.803339725
12251,11,204,30,19,0.001470588,712271,0.803373562
3338,2,80,30,19,0.001470588,712301,0.803407399
8966,347,558,30,19,0.001470588,712331,0.803441236
8023,517,68,30,19,0.001470588,712361,0.803475073
7815,328,655,30,19,0.001470588,712391,0.80350891
9050,14,224,30,19,0.001470588,712421,0.803542748
8886,479,328,30,19,0.001470588,712451,0.803576585
2550,196,80,30,19,0.001470588,712481,0.803610422
8866,34,674,30,19,0.001470588,712511,0.803644259
8120,588,543,30,19,0.001470588,712541,0.803678096
8130,80,723,30,19,0.001470588,712571,0.803711933
8764,33,661,30,19,0.001470588,712601,0.80374577
5500,529,107,30,19,0.001470588,712631,0.803779607
8734,204,463,30,19,0.001470588,712661,0.803813445
8226,133,655,30,19,0.001470588,712691,0.803847282
7657,250,498,30,19,0.001470588,712721,0.803881119
6385,20,582,30,19,0.001470588,712751,0.803914956
10872,34,5,30,19,0.001470588,712781,0.803948793
3859,31,479,30,19,0.001470588,712811,0.80398263
5791,473,543,30,19,0.001470588,712841,0.804016467
4797,196,302,30,19,0.001470588,712871,0.804050305
4252,394,9,30,19,0.001470588,712901,0.804084142
4803,507,158,30,19,0.001470588,712931,0.804117979
4429,32,394,30,19,0.001470588,712961,0.804151816
3760,32,121,30,19,0.001470588,712991,0.804185653
6524,514,498,30,19,0.001470588,713021,0.80421949
6652,673,397,30,19,0.001470588,713051,0.804253327
4729,543,123,30,19,0.001470588,713081,0.804287164
6592,11,302,30,19,0.001470588,713111,0.804321002
10305,502,497,29,19,0.001421569,713140,0.804353711
7521,261,331,29,19,0.001421569,713169,0.80438642
7782,20,95,29,19,0.001421569,713198,0.804419129
9403,596,130,29,19,0.001421569,713227,0.804451838
7531,34,588,29,19,0.001421569,713256,0.804484548
7561,532,95,29,19,0.001421569,713285,0.804517257
7584,479,497,29,19,0.001421569,713314,0.804549966
9321,367,646,29,19,0.001421569,713343,0.804582675
5215,5,314,29,19,0.001421569,713372,0.804615385
8747,3,614,29,19,0.001421569,713401,0.804648094
5767,34,158,29,19,0.001421569,713430,0.804680803
5817,379,674,29,19,0.001421569,713459,0.804713512
5813,196,33,29,19,0.001421569,713488,0.804746222
9995,414,398,29,19,0.001421569,713517,0.804778931
5802,2,311,29,19,0.001421569,713546,0.80481164
5424,196,354,29,19,0.001421569,713575,0.804844349
8466,130,414,29,19,0.001421569,713604,0.804877058
9655,117,394,29,19,0.001421569,713633,0.804909768
6722,302,535,29,19,0.001421569,713662,0.804942477
9719,11,404,29,19,0.001421569,713691,0.804975186
4693,265,105,29,19,0.001421569,713720,0.805007895
9786,385,11,29,19,0.001421569,713749,0.805040605
8310,5,471,29,19,0.001421569,713778,0.805073314
9777,427,48,29,19,0.001421569,713807,0.805106023
8148,475,522,29,19,0.001421569,713836,0.805138732
6803,95,397,29,19,0.001421569,713865,0.805171441
6852,204,174,29,19,0.001421569,713894,0.805204151
8592,517,9,29,19,0.001421569,713923,0.80523686
6867,265,219,29,19,0.001421569,713952,0.805269569
7964,97,463,29,19,0.001421569,713981,0.805302278
7963,475,307,29,19,0.001421569,714010,0.805334988
8528,404,398,29,19,0.001421569,714039,0.805367697
11276,124,348,29,19,0.001421569,714068,0.805400406
6394,596,141,29,19,0.001421569,714097,0.805433115
8960,10,170,29,19,0.001421569,714126,0.805465824
9172,130,364,29,19,0.001421569,714155,0.805498534
7491,224,439,29,19,0.001421569,714184,0.805531243
10609,121,107,28,19,0.001372549,714212,0.805562824
8707,242,243,28,19,0.001372549,714240,0.805594406
5591,33,532,28,19,0.001372549,714268,0.805625987
8441,394,50,28,19,0.001372549,714296,0.805657568
10742,68,507,28,19,0.001372549,714324,0.80568915
6761,404,16,28,19,0.001372549,714352,0.805720731
9380,280,167,28,19,0.001372549,714380,0.805752312
8704,498,348,28,19,0.001372549,714408,0.805783894
7360,2,3,28,19,0.001372549,714436,0.805815475
8578,532,714,28,19,0.001372549,714464,0.805847056
6328,6,1,28,19,0.001372549,714492,0.805878637
8591,501,130,28,19,0.001372549,714520,0.805910219
7824,204,230,28,19,0.001372549,714548,0.8059418
10713,471,15,28,19,0.001372549,714576,0.805973381
12108,114,385,28,19,0.001372549,714604,0.806004963
7972,219,674,28,19,0.001372549,714632,0.806036544
8971,397,347,28,19,0.001372549,714660,0.806068125
5582,532,398,28,19,0.001372549,714688,0.806099707
7452,528,123,28,19,0.001372549,714716,0.806131288
8351,586,242,28,19,0.001372549,714744,0.806162869
8852,20,230,28,19,0.001372549,714772,0.806194451
9785,3,170,28,19,0.001372549,714800,0.806226032
7244,250,558,28,19,0.001372549,714828,0.806257613
9110,295,167,28,19,0.001372549,714856,0.806289195
5036,250,334,28,19,0.001372549,714884,0.806320776
9754,15,243,28,19,0.001372549,714912,0.806352357
6233,243,250,28,19,0.001372549,714940,0.806383939
9855,13,34,28,19,0.001372549,714968,0.80641552
7487,33,2,28,19,0.001372549,714996,0.806447101
9797,522,2,28,19,0.001372549,715024,0.806478683
5506,638,588,28,19,0.001372549,715052,0.806510264
7614,77,22,28,19,0.001372549,715080,0.806541845
8096,33,1,28,19,0.001372549,715108,0.806573427
3190,501,77,28,19,0.001372549,715136,0.806605008
5827,295,20,28,19,0.001372549,715164,0.806636589
7905,6,655,27,19,0.001323529,715191,0.806667043
8582,26,663,27,19,0.001323529,715218,0.806697496
7191,655,335,27,19,0.001323529,715245,0.806727949
7196,12,514,27,19,0.001323529,715272,0.806758403
6084,1,30,27,19,0.001323529,715299,0.806788856
8407,204,30,27,19,0.001323529,715326,0.80681931
4143,529,331,27,19,0.001323529,715353,0.806849763
8089,663,463,27,19,0.001323529,715380,0.806880217
11160,97,158,27,19,0.001323529,715407,0.80691067
6737,10,562,27,19,0.001323529,715434,0.806941123
6754,242,84,27,19,0.001323529,715461,0.806971577
9847,552,497,27,19,0.001323529,715488,0.80700203
5978,552,353,27,19,0.001323529,715515,0.807032484
11635,131,427,27,19,0.001323529,715542,0.807062937
7353,558,529,27,19,0.001323529,715569,0.80709339
8002,673,532,27,19,0.001323529,715596,0.807123844
9892,56,347,27,19,0.001323529,715623,0.807154297
11702,471,674,27,19,0.001323529,715650,0.807184751
6697,310,404,27,19,0.001323529,715677,0.807215204
9979,614,130,27,19,0.001323529,715704,0.807245658
12201,68,571,27,19,0.001323529,715731,0.807276111
8546,131,535,27,19,0.001323529,715758,0.807306564
6407,31,313,27,19,0.001323529,715785,0.807337018
6511,393,26,27,19,0.001323529,715812,0.807367471
9722,335,167,27,19,0.001323529,715839,0.807397925
7951,80,328,27,19,0.001323529,715866,0.807428378
7198,398,26,27,19,0.001323529,715893,0.807458831
6782,393,250,27,19,0.001323529,715920,0.807489285
7201,479,11,27,19,0.001323529,715947,0.807519738
4089,4,9,27,19,0.001323529,715974,0.807550192
7216,196,29,27,19,0.001323529,716001,0.807580645
4738,4,353,27,19,0.001323529,716028,0.807611099
7565,404,586,27,19,0.001323529,716055,0.807641552
9295,13,582,27,19,0.001323529,716082,0.807672005
4263,6,174,27,19,0.001323529,716109,0.807702459
7573,354,158,27,19,0.001323529,716136,0.807732912
6311,514,26,27,19,0.001323529,716163,0.807763366
8822,479,517,27,19,0.001323529,716190,0.807793819
7574,502,532,27,19,0.001323529,716217,0.807824273
10488,552,130,27,19,0.001323529,716244,0.807854726
5241,25,84,27,19,0.001323529,716271,0.807885179
8983,131,552,27,19,0.001323529,716298,0.807915633
7025,242,498,27,19,0.001323529,716325,0.807946086
6044,586,354,27,19,0.001323529,716352,0.80797654
8817,107,646,27,19,0.001323529,716379,0.808006993
5277,302,11,27,19,0.001323529,716406,0.808037446
8751,632,31,27,19,0.001323529,716433,0.8080679
8944,614,295,27,19,0.001323529,716460,0.808098353
7755,26,145,27,19,0.001323529,716487,0.808128807
7536,397,398,27,19,0.001323529,716514,0.80815926
8367,84,204,26,19,0.00127451,716540,0.808188586
8128,97,33,26,19,0.00127451,716566,0.808217911
12414,535,163,26,19,0.00127451,716592,0.808247237
8771,163,655,26,19,0.00127451,716618,0.808276562
9989,117,379,26,19,0.00127451,716644,0.808305888
9225,535,497,26,19,0.00127451,716670,0.808335213
7482,640,689,26,19,0.00127451,716696,0.808364539
9745,552,295,26,19,0.00127451,716722,0.808393864
10521,14,532,26,19,0.00127451,716748,0.80842319
6232,307,331,26,19,0.00127451,716774,0.808452515
6692,614,141,26,19,0.00127451,716800,0.808481841
9746,393,242,26,19,0.00127451,716826,0.808511166
8152,10,25,26,19,0.00127451,716852,0.808540492
11154,5,204,26,19,0.00127451,716878,0.808569817
9053,314,383,26,19,0.00127451,716904,0.808599143
10366,348,661,26,19,0.00127451,716930,0.808628468
7587,243,32,26,19,0.00127451,716956,0.808657794
9307,367,328,26,19,0.00127451,716982,0.808687119
4108,640,123,26,19,0.00127451,717008,0.808716445
9311,114,354,26,19,0.00127451,717034,0.80874577
9037,5,16,26,19,0.00127451,717060,0.808775096
9437,543,655,26,19,0.00127451,717086,0.808804421
7351,498,614,26,19,0.00127451,717112,0.808833747
6415,609,311,26,19,0.00127451,717138,0.808863072
3070,95,80,26,19,0.00127451,717164,0.808892398
10101,328,475,26,19,0.00127451,717190,0.808921723
8700,475,367,26,19,0.00127451,717216,0.808951049
10300,501,31,26,19,0.00127451,717242,0.808980374
10095,5,295,26,19,0.00127451,717268,0.8090097
7749,334,310,26,19,0.00127451,717294,0.809039025
5948,156,314,26,19,0.00127451,717320,0.809068351
7420,613,379,26,19,0.00127451,717346,0.809097677
7745,328,32,26,19,0.00127451,717372,0.809127002
7791,145,443,26,19,0.00127451,717398,0.809156328
7379,689,204,26,19,0.00127451,717424,0.809185653
7797,13,196,26,19,0.00127451,717450,0.809214979
6841,9,64,26,19,0.00127451,717476,0.809244304
7914,64,314,26,19,0.00127451,717502,0.80927363
5364,397,26,26,19,0.00127451,717528,0.809302955
9135,632,15,26,19,0.00127451,717554,0.809332281
10617,543,15,26,19,0.00127451,717580,0.809361606
9133,331,587,26,19,0.00127451,717606,0.809390932
4655,280,302,26,19,0.00127451,717632,0.809420257
5929,582,682,25,19,0.00122549,717657,0.809448455
8859,1,48,25,19,0.00122549,717682,0.809476652
11283,10,167,25,19,0.00122549,717707,0.80950485
6456,501,311,25,19,0.00122549,717732,0.809533048
9343,471,131,25,19,0.00122549,717757,0.809561245
9277,552,522,25,19,0.00122549,717782,0.809589443
9182,2,33,25,19,0.00122549,717807,0.80961764
6068,12,265,25,19,0.00122549,717832,0.809645838
8768,543,475,25,19,0.00122549,717857,0.809674036
9679,463,723,25,19,0.00122549,717882,0.809702233
6573,25,77,25,19,0.00122549,717907,0.809730431
9249,364,27,25,19,0.00122549,717932,0.809758628
8452,171,314,25,19,0.00122549,717957,0.809786826
8913,354,4,25,19,0.00122549,717982,0.809815024
12796,471,446,25,19,0.00122549,718007,0.809843221
8719,140,105,25,19,0.00122549,718032,0.809871419
5342,31,9,25,19,0.00122549,718057,0.809899617
8509,84,307,25,19,0.00122549,718082,0.809927814
9620,596,170,25,19,0.00122549,718107,0.809956012
6130,313,404,25,19,0.00122549,718132,0.809984209
8368,145,26,25,19,0.00122549,718157,0.810012407
8928,514,367,25,19,0.00122549,718182,0.810040605
9631,84,196,25,19,0.00122549,718207,0.810068802
6002,307,353,25,19,0.00122549,718232,0.810097
6077,501,354,25,19,0.00122549,718257,0.810125197
6135,31,230,25,19,0.00122549,718282,0.810153395
8549,379,640,25,19,0.00122549,718307,0.810181593
9314,56,655,25,19,0.00122549,718332,0.81020979
8331,84,121,25,19,0.00122549,718357,0.810237988
8537,14,558,25,19,0.00122549,718382,0.810266185
9585,25,68,25,19,0.00122549,718407,0.810294383
5223,689,380,25,19,0.00122549,718432,0.810322581
7261,689,3,25,19,0.00122549,718457,0.810350778
7430,379,158,25,19,0.00122549,718482,0.810378976
10512,1,294,25,19,0.00122549,718507,0.810407173
11818,27,90,25,19,0.00122549,718532,0.810435371
10079,502,141,25,19,0.00122549,718557,0.810463569
7100,243,123,25,19,0.00122549,718582,0.810491766
7454,394,32,25,19,0.00122549,718607,0.810519964
8127,219,427,25,19,0.00122549,718632,0.810548162
9917,596,723,25,19,0.00122549,718657,0.810576359
7714,123,242,25,19,0.00122549,718682,0.810604557
5295,427,80,25,19,0.00122549,718707,0.810632754
7647,26,130,25,19,0.00122549,718732,0.810660952
12349,427,558,25,19,0.00122549,718757,0.81068915
4848,334,80,25,19,0.00122549,718782,0.810717347
7701,543,335,25,19,0.00122549,718807,0.810745545
6961,242,16,25,19,0.00122549,718832,0.810773742
4875,313,242,25,19,0.00122549,718857,0.81080194
7738,314,503,25,19,0.00122549,718882,0.810830138
14400,471,117,25,19,0.00122549,718907,0.810858335
7612,164,26,25,19,0.00122549,718932,0.810886533
7633,498,33,25,19,0.00122549,718957,0.81091473
7715,535,26,25,19,0.00122549,718982,0.810942928
8065,56,31,25,19,0.00122549,719007,0.810971126
7921,443,674,25,19,0.00122549,719032,0.810999323
10952,313,618,25,19,0.00122549,719057,0.811027521
7333,543,31,25,19,0.00122549,719082,0.811055718
10662,204,397,25,19,0.00122549,719107,0.811083916
10554,543,34,25,19,0.00122549,719132,0.811112114
7276,497,26,25,19,0.00122549,719157,0.811140311
4957,609,123,25,19,0.00122549,719182,0.811168509
9873,383,11,25,19,0.00122549,719207,0.811196707
7864,280,562,25,19,0.00122549,719232,0.811224904
7395,30,354,25,19,0.00122549,719257,0.811253102
10197,544,15,24,19,0.001176471,719281,0.811280171
11072,196,348,24,19,0.001176471,719305,0.811307241
12074,544,614,24,19,0.001176471,719329,0.811334311
7692,558,475,24,19,0.001176471,719353,0.811361381
8664,10,605,24,19,0.001176471,719377,0.81138845
8614,310,164,24,19,0.001176471,719401,0.81141552
7850,107,117,24,19,0.001176471,719425,0.81144259
7754,385,224,24,19,0.001176471,719449,0.811469659
6874,535,280,24,19,0.001176471,719473,0.811496729
7181,274,236,24,19,0.001176471,719497,0.811523799
7421,164,224,24,19,0.001176471,719521,0.811550868
11676,507,522,24,19,0.001176471,719545,0.811577938
7286,77,1,24,19,0.001176471,719569,0.811605008
11661,427,655,24,19,0.001176471,719593,0.811632078
8825,145,532,24,19,0.001176471,719617,0.811659147
10408,427,131,24,19,0.001176471,719641,0.811686217
10774,501,23,24,19,0.001176471,719665,0.811713287
11583,708,618,24,19,0.001176471,719689,0.811740356
10505,471,84,24,19,0.001176471,719713,0.811767426
8338,30,463,24,19,0.001176471,719737,0.811794496
8517,123,682,24,19,0.001176471,719761,0.811821566
9926,5,9,24,19,0.001176471,719785,0.811848635
9737,236,543,24,19,0.001176471,719809,0.811875705
8369,295,596,24,19,0.001176471,719833,0.811902775
8131,313,482,24,19,0.001176471,719857,0.811929844
6713,20,295,24,19,0.001176471,719881,0.811956914
9718,5,475,24,19,0.001176471,719905,0.811983984
6742,532,204,24,19,0.001176471,719929,0.812011053
10157,145,655,24,19,0.001176471,719953,0.812038123
6758,16,398,24,19,0.001176471,719977,0.812065193
5266,638,6,24,19,0.001176471,720001,0.812092263
9824,498,250,24,19,0.001176471,720025,0.812119332
11806,130,2,23,19,0.001127451,720048,0.812145274
13575,354,605,23,19,0.001127451,720071,0.812171216
10455,632,463,23,19,0.001127451,720094,0.812197158
13119,473,290,23,19,0.001127451,720117,0.812223099
11297,219,30,23,19,0.001127451,720140,0.812249041
9293,6,544,23,19,0.001127451,720163,0.812274983
5909,394,264,23,19,0.001127451,720186,0.812300925
5235,14,314,23,19,0.001127451,720209,0.812326867
9781,558,64,23,19,0.001127451,720232,0.812352808
5174,6,158,23,19,0.001127451,720255,0.81237875
9108,158,25,23,19,0.001127451,720278,0.812404692
9052,114,219,23,19,0.001127451,720301,0.812430634
11380,471,5,23,19,0.001127451,720324,0.812456576
10572,243,114,23,19,0.001127451,720347,0.812482517
9228,380,652,23,19,0.001127451,720370,0.812508459
15085,204,5,23,19,0.001127451,720393,0.812534401
8337,3,497,23,19,0.001127451,720416,0.812560343
12016,84,163,23,19,0.001127451,720439,0.812586285
9635,31,97,23,19,0.001127451,720462,0.812612226
12120,117,131,23,19,0.001127451,720485,0.812638168
11469,50,219,23,19,0.001127451,720508,0.81266411
8523,10,543,23,19,0.001127451,720531,0.812690052
10074,522,25,23,19,0.001127451,720554,0.812715994
10277,380,587,23,19,0.001127451,720577,0.812741935
5997,640,588,23,19,0.001127451,720600,0.812767877
12833,27,124,23,19,0.001127451,720623,0.812793819
8750,640,97,23,19,0.001127451,720646,0.812819761
5800,2,123,23,19,0.001127451,720669,0.812845703
5713,33,20,23,19,0.001127451,720692,0.812871644
9365,295,562,23,19,0.001127451,720715,0.812897586
5774,33,121,23,19,0.001127451,720738,0.812923528
5718,15,302,23,19,0.001127451,720761,0.81294947
6991,105,613,23,19,0.001127451,720784,0.812975412
8769,84,689,23,19,0.001127451,720807,0.813001353
9374,29,68,23,19,0.001127451,720830,0.813027295
10009,367,274,23,19,0.001127451,720853,0.813053237
8797,156,26,23,19,0.001127451,720876,0.813079179
10352,471,393,23,19,0.001127451,720899,0.813105121
7003,398,3,23,19,0.001127451,720922,0.813131062
8788,34,2,23,19,0.001127451,720945,0.813157004
10799,27,613,23,19,0.001127451,720968,0.813182946
9819,105,23,22,19,0.001078431,720990,0.81320776
9802,331,593,22,19,0.001078431,721012,0.813232574
10965,334,295,22,19,0.001078431,721034,0.813257388
10636,502,348,22,19,0.001078431,721056,0.813282202
10766,673,15,22,19,0.001078431,721078,0.813307016
11521,156,274,22,19,0.001078431,721100,0.813331829
10945,528,393,22,19,0.001078431,721122,0.813356643
9253,6,156,22,19,0.001078431,721144,0.813381457
10941,689,596,22,19,0.001078431,721166,0.813406271
7662,10,164,22,19,0.001078431,721188,0.813431085
8840,130,156,22,19,0.001078431,721210,0.813455899
7896,163,353,22,19,0.001078431,721232,0.813480713
7938,164,443,22,19,0.001078431,721254,0.813505527
5510,582,605,22,19,0.001078431,721276,0.813530341
7397,243,334,22,19,0.001078431,721298,0.813555155
8366,463,479,22,19,0.001078431,721320,0.813579968
8455,394,535,22,19,0.001078431,721342,0.813604782
8512,84,15,22,19,0.001078431,721364,0.813629596
8050,383,379,22,19,0.001078431,721386,0.81365441
8181,80,85,22,19,0.001078431,721408,0.813679224
8245,269,353,22,19,0.001078431,721430,0.813704038
6949,614,354,22,19,0.001078431,721452,0.813728852
13356,11,163,22,19,0.001078431,721474,0.813753666
4671,280,22,22,19,0.001078431,721496,0.81377848
6090,529,264,22,19,0.001078431,721518,0.813803293
11272,380,269,21,19,0.001029412,721539,0.813826979
8230,84,682,21,19,0.001029412,721560,0.813850665
9840,50,84,21,19,0.001029412,721581,0.813874351
12442,514,23,21,19,0.001029412,721602,0.813898037
8638,673,535,21,19,0.001029412,721623,0.813921723
11083,2,708,21,19,0.001029412,721644,0.813945409
9792,473,552,21,19,0.001029412,721665,0.813969095
12344,167,708,21,19,0.001029412,721686,0.813992781
3407,4,334,21,19,0.001029412,721707,0.814016467
4699,721,158,21,19,0.001029412,721728,0.814040153
7751,140,582,21,19,0.001029412,721749,0.814063839
15918,517,29,20,19,0.000980392,721769,0.814086397
6266,582,164,20,19,0.000980392,721789,0.814108956
8143,32,22,20,19,0.000980392,721809,0.814131514
11146,593,529,20,19,0.000980392,721829,0.814154072
4438,313,56,43,18,0.002107843,721872,0.814202572
6616,295,367,41,18,0.002009804,721913,0.814248816
7867,562,331,38,18,0.001862745,721951,0.814291676
7903,2,689,37,18,0.001813725,721988,0.814333409
7678,385,250,37,18,0.001813725,722025,0.814375141
8415,463,97,35,18,0.001715686,722060,0.814414618
7137,353,95,35,18,0.001715686,722095,0.814454094
5761,638,295,34,18,0.001666667,722129,0.814492443
8989,353,269,33,18,0.001617647,722162,0.814529664
5758,562,123,33,18,0.001617647,722195,0.814566885
9659,114,33,33,18,0.001617647,722228,0.814604106
6315,562,511,33,18,0.001617647,722261,0.814641326
7651,80,204,33,18,0.001617647,722294,0.814678547
5449,502,84,32,18,0.001568627,722326,0.81471464
5769,394,84,32,18,0.001568627,722358,0.814750733
7062,497,529,32,18,0.001568627,722390,0.814786826
6894,439,311,32,18,0.001568627,722422,0.814822919
7125,50,224,32,18,0.001568627,722454,0.814859012
5515,404,582,32,18,0.001568627,722486,0.814895105
6676,32,398,32,18,0.001568627,722518,0.814931198
8411,48,121,32,18,0.001568627,722550,0.814967291
9549,224,507,32,18,0.001568627,722582,0.815003384
8696,174,14,32,18,0.001568627,722614,0.815039477
10024,230,2,32,18,0.001568627,722646,0.81507557
6163,48,638,32,18,0.001568627,722678,0.815111663
10867,121,33,32,18,0.001568627,722710,0.815147755
8637,522,514,31,18,0.001519608,722741,0.815182721
6030,20,294,31,18,0.001519608,722772,0.815217686
6220,674,307,31,18,0.001519608,722803,0.815252651
8770,347,196,31,18,0.001519608,722834,0.815287616
7442,535,158,31,18,0.001519608,722865,0.815322581
6648,5,582,31,18,0.001519608,722896,0.815357546
9977,689,517,31,18,0.001519608,722927,0.815392511
6725,673,280,31,18,0.001519608,722958,0.815427476
8097,562,497,31,18,0.001519608,722989,0.815462441
9660,5,310,31,18,0.001519608,723020,0.815497406
7902,156,32,31,18,0.001519608,723051,0.815532371
7033,3,26,31,18,0.001519608,723082,0.815567336
5786,15,295,31,18,0.001519608,723113,0.815602301
8067,107,689,30,18,0.001470588,723143,0.815636138
10073,11,145,30,18,0.001470588,723173,0.815669975
7976,331,64,30,18,0.001470588,723203,0.815703812
7822,586,514,30,18,0.001470588,723233,0.815737649
7315,663,14,30,18,0.001470588,723263,0.815771487
7460,171,473,30,18,0.001470588,723293,0.815805324
8382,439,367,30,18,0.001470588,723323,0.815839161
8409,552,638,30,18,0.001470588,723353,0.815872998
9982,522,126,30,18,0.001470588,723383,0.815906835
8101,12,141,30,18,0.001470588,723413,0.815940672
7700,367,31,30,18,0.001470588,723443,0.815974509
9857,471,107,30,18,0.001470588,723473,0.816008346
4319,31,105,30,18,0.001470588,723503,0.816042184
5704,32,614,30,18,0.001470588,723533,0.816076021
10841,348,385,30,18,0.001470588,723563,0.816109858
3993,9,385,30,18,0.001470588,723593,0.816143695
5748,84,158,29,18,0.001421569,723622,0.816176404
9312,347,10,29,18,0.001421569,723651,0.816209113
7555,48,609,29,18,0.001421569,723680,0.816241823
6251,674,497,29,18,0.001421569,723709,0.816274532
6971,614,393,29,18,0.001421569,723738,0.816307241
5752,614,394,29,18,0.001421569,723767,0.81633995
8658,13,95,29,18,0.001421569,723796,0.81637266
10916,224,409,29,18,0.001421569,723825,0.816405369
10015,16,328,29,18,0.001421569,723854,0.816438078
8251,674,6,29,18,0.001421569,723883,0.816470787
8296,174,473,29,18,0.001421569,723912,0.816503497
9738,427,588,29,18,0.001421569,723941,0.816536206
5771,655,265,29,18,0.001421569,723970,0.816568915
10216,243,502,29,18,0.001421569,723999,0.816601624
7839,193,347,29,18,0.001421569,724028,0.816634333
7898,204,655,29,18,0.001421569,724057,0.816667043
5967,219,393,29,18,0.001421569,724086,0.816699752
10167,97,558,29,18,0.001421569,724115,0.816732461
10635,552,243,29,18,0.001421569,724144,0.81676517
7466,404,393,29,18,0.001421569,724173,0.81679788
7119,280,145,29,18,0.001421569,724202,0.816830589
5081,393,236,28,18,0.001372549,724230,0.81686217
6944,26,588,28,18,0.001372549,724258,0.816893751
4159,31,123,28,18,0.001372549,724286,0.816925333
5739,11,663,28,18,0.001372549,724314,0.816956914
9678,174,558,28,18,0.001372549,724342,0.816988495
8438,596,689,28,18,0.001372549,724370,0.817020077
8444,311,511,28,18,0.001372549,724398,0.817051658
8022,16,511,28,18,0.001372549,724426,0.817083239
7736,367,121,28,18,0.001372549,724454,0.817114821
7192,473,398,28,18,0.001372549,724482,0.817146402
7833,11,6,28,18,0.001372549,724510,0.817177983
7387,562,473,28,18,0.001372549,724538,0.817209565
9506,414,498,28,18,0.001372549,724566,0.817241146
9008,196,632,28,18,0.001372549,724594,0.817272727
7992,158,33,28,18,0.001372549,724622,0.817304309
8494,204,588,28,18,0.001372549,724650,0.81733589
6423,264,380,28,18,0.001372549,724678,0.817367471
6310,32,130,28,18,0.001372549,724706,0.817399053
7927,158,473,28,18,0.001372549,724734,0.817430634
8198,596,562,28,18,0.001372549,724762,0.817462215
8195,532,250,28,18,0.001372549,724790,0.817493797
11374,11,514,28,18,0.001372549,724818,0.817525378
8347,77,661,28,18,0.001372549,724846,0.817556959
5896,394,586,28,18,0.001372549,724874,0.81758854
6203,20,145,28,18,0.001372549,724902,0.817620122
6583,655,497,28,18,0.001372549,724930,0.817651703
2755,25,80,28,18,0.001372549,724958,0.817683284
8229,367,54,28,18,0.001372549,724986,0.817714866
6559,638,204,28,18,0.001372549,725014,0.817746447
7070,463,522,28,18,0.001372549,725042,0.817778028
6229,193,68,28,18,0.001372549,725070,0.81780961
6707,114,32,28,18,0.001372549,725098,0.817841191
9922,131,264,28,18,0.001372549,725126,0.817872772
8814,158,167,28,18,0.001372549,725154,0.817904354
9333,31,5,28,18,0.001372549,725182,0.817935935
6757,632,335,27,18,0.001323529,725209,0.817966388
6759,84,261,27,18,0.001323529,725236,0.817996842
10196,204,195,27,18,0.001323529,725263,0.818027295
8095,674,348,27,18,0.001323529,725290,0.818057749
8576,414,243,27,18,0.001323529,725317,0.818088202
9095,84,130,27,18,0.001323529,725344,0.818118656
8566,23,27,27,18,0.001323529,725371,0.818149109
8078,117,77,27,18,0.001323529,725398,0.818179562
12116,439,250,27,18,0.001323529,725425,0.818210016
5641,404,9,27,18,0.001323529,725452,0.818240469
6072,609,588,27,18,0.001323529,725479,0.818270923
11304,596,383,27,18,0.001323529,725506,0.818301376
6595,404,311,27,18,0.001323529,725533,0.818331829
9014,2,354,27,18,0.001323529,725560,0.818362283
7974,655,558,27,18,0.001323529,725587,0.818392736
8305,367,392,27,18,0.001323529,725614,0.81842319
7339,380,56,27,18,0.001323529,725641,0.818453643
6926,398,107,27,18,0.001323529,725668,0.818484097
7037,56,33,27,18,0.001323529,725695,0.81851455
7566,56,77,27,18,0.001323529,725722,0.818545003
10776,593,10,27,18,0.001323529,725749,0.818575457
10476,552,15,27,18,0.001323529,725776,0.81860591
7478,522,404,27,18,0.001323529,725803,0.818636364
8792,68,22,27,18,0.001323529,725830,0.818666817
7151,307,295,27,18,0.001323529,725857,0.81869727
7742,479,535,27,18,0.001323529,725884,0.818727724
9233,250,265,27,18,0.001323529,725911,0.818758177
5998,196,16,27,18,0.001323529,725938,0.818788631
7457,310,529,27,18,0.001323529,725965,0.818819084
6168,196,334,27,18,0.001323529,725992,0.818849538
6067,31,475,27,18,0.001323529,726019,0.818879991
8743,502,280,27,18,0.001323529,726046,0.818910444
7171,84,145,27,18,0.001323529,726073,0.818940898
5352,97,123,27,18,0.001323529,726100,0.818971351
8649,314,613,27,18,0.001323529,726127,0.819001805
7129,77,552,26,18,0.00127451,726153,0.81903113
5335,514,77,26,18,0.00127451,726179,0.819060456
10934,347,535,26,18,0.00127451,726205,0.819089781
7617,20,64,26,18,0.00127451,726231,0.819119107
8125,353,414,26,18,0.00127451,726257,0.819148432
8432,34,708,26,18,0.00127451,726283,0.819177758
10382,16,167,26,18,0.00127451,726309,0.819207083
8392,614,250,26,18,0.00127451,726335,0.819236409
5628,224,85,26,18,0.00127451,726361,0.819265734
5606,385,379,26,18,0.00127451,726387,0.81929506
8914,334,397,26,18,0.00127451,726413,0.819324385
9278,204,443,26,18,0.00127451,726439,0.819353711
7105,310,562,26,18,0.00127451,726465,0.819383036
11342,328,427,26,18,0.00127451,726491,0.819412362
8876,492,27,26,18,0.00127451,726517,0.819441687
7520,498,497,26,18,0.00127451,726543,0.819471013
6202,30,380,26,18,0.00127451,726569,0.819500338
3578,640,80,26,18,0.00127451,726595,0.819529664
4861,511,158,26,18,0.00127451,726621,0.819558989
9912,155,20,26,18,0.00127451,726647,0.819588315
8821,663,121,26,18,0.00127451,726673,0.81961764
13328,27,494,26,18,0.00127451,726699,0.819646966
7043,532,170,26,18,0.00127451,726725,0.819676291
8330,552,354,26,18,0.00127451,726751,0.819705617
8054,250,32,26,18,0.00127451,726777,0.819734942
10600,64,582,26,18,0.00127451,726803,0.819764268
7408,479,243,26,18,0.00127451,726829,0.819793594
9582,145,48,26,18,0.00127451,726855,0.819822919
7954,443,22,26,18,0.00127451,726881,0.819852245
7764,20,131,26,18,0.00127451,726907,0.81988157
6132,311,683,26,18,0.00127451,726933,0.819910896
6129,501,25,26,18,0.00127451,726959,0.819940221
7854,22,158,26,18,0.00127451,726985,0.819969547
4505,302,393,26,18,0.00127451,727011,0.819998872
7868,48,532,26,18,0.00127451,727037,0.820028198
7374,80,593,26,18,0.00127451,727063,0.820057523
7806,552,331,26,18,0.00127451,727089,0.820086849
10271,236,552,26,18,0.00127451,727115,0.820116174
11032,311,503,26,18,0.00127451,727141,0.8201455
9214,522,242,26,18,0.00127451,727167,0.820174825
9388,596,97,26,18,0.00127451,727193,0.820204151
8706,655,367,26,18,0.00127451,727219,0.820233476
5634,397,558,26,18,0.00127451,727245,0.820262802
7726,511,314,26,18,0.00127451,727271,0.820292127
8975,48,30,25,18,0.00122549,727296,0.820320325
6093,32,511,25,18,0.00122549,727321,0.820348522
9353,77,618,25,18,0.00122549,727346,0.82037672
9449,552,609,25,18,0.00122549,727371,0.820404918
8606,16,605,25,18,0.00122549,727396,0.820433115
9260,131,22,25,18,0.00122549,727421,0.820461313
8947,140,16,25,18,0.00122549,727446,0.82048951
11269,2,475,25,18,0.00122549,727471,0.820517708
4194,204,158,25,18,0.00122549,727496,0.820545906
9338,614,48,25,18,0.00122549,727521,0.820574103
4127,605,80,25,18,0.00122549,727546,0.820602301
4543,394,123,25,18,0.00122549,727571,0.820630499
8715,117,105,25,18,0.00122549,727596,0.820658696
6426,638,379,25,18,0.00122549,727621,0.820686894
8838,655,311,25,18,0.00122549,727646,0.820715091
11103,158,544,25,18,0.00122549,727671,0.820743289
8320,6,103,25,18,0.00122549,727696,0.820771487
5901,379,31,25,18,0.00122549,727721,0.820799684
4687,689,471,25,18,0.00122549,727746,0.820827882
9042,171,471,25,18,0.00122549,727771,0.820856079
11059,114,95,25,18,0.00122549,727796,0.820884277
4814,558,334,25,18,0.00122549,727821,0.820912475
7540,313,274,25,18,0.00122549,727846,0.820940672
7541,596,295,25,18,0.00122549,727871,0.82096887
8140,562,638,25,18,0.00122549,727896,0.820997067
10388,632,29,25,18,0.00122549,727921,0.821025265
6792,353,588,25,18,0.00122549,727946,0.821053463
10035,114,394,25,18,0.00122549,727971,0.82108166
10032,243,605,25,18,0.00122549,727996,0.821109858
7635,379,682,25,18,0.00122549,728021,0.821138055
8066,158,311,25,18,0.00122549,728046,0.821166253
7432,708,131,25,18,0.00122549,728071,0.821194451
7205,20,224,25,18,0.00122549,728096,0.821222648
7373,532,640,25,18,0.00122549,728121,0.821250846
10678,347,353,25,18,0.00122549,728146,0.821279044
10708,2,50,25,18,0.00122549,728171,0.821307241
6631,2,6,25,18,0.00122549,728196,0.821335439
10686,348,25,25,18,0.00122549,728221,0.821363636
9842,392,367,25,18,0.00122549,728246,0.821391834
6839,673,313,25,18,0.00122549,728271,0.821420032
7425,9,544,25,18,0.00122549,728296,0.821448229
7424,204,475,25,18,0.00122549,728321,0.821476427
5772,20,1,25,18,0.00122549,728346,0.821504624
3043,97,80,25,18,0.00122549,728371,0.821532822
7330,674,586,25,18,0.00122549,728396,0.82156102
9550,514,265,24,18,0.001176471,728420,0.821588089
8583,11,141,24,18,0.001176471,728444,0.821615159
11478,328,97,24,18,0.001176471,728468,0.821642229
12784,348,56,24,18,0.001176471,728492,0.821669298
6273,3,158,24,18,0.001176471,728516,0.821696368
5066,9,502,24,18,0.001176471,728540,0.821723438
9519,219,609,24,18,0.001176471,728564,0.821750508
9518,708,95,24,18,0.001176471,728588,0.821777577
9457,15,655,24,18,0.001176471,728612,0.821804647
7851,543,522,24,18,0.001176471,728636,0.821831717
12850,348,448,24,18,0.001176471,728660,0.821858786
10240,544,655,24,18,0.001176471,728684,0.821885856
8593,163,529,24,18,0.001176471,728708,0.821912926
7883,353,167,24,18,0.001176471,728732,0.821939995
10297,331,5,24,18,0.001176471,728756,0.821967065
7763,522,117,24,18,0.001176471,728780,0.821994135
9423,9,167,24,18,0.001176471,728804,0.822021205
7467,34,95,24,18,0.001176471,728828,0.822048274
11752,117,473,24,18,0.001176471,728852,0.822075344
7400,84,427,24,18,0.001176471,728876,0.822102414
10551,167,348,24,18,0.001176471,728900,0.822129483
11137,328,348,24,18,0.001176471,728924,0.822156553
9158,107,204,24,18,0.001176471,728948,0.822183623
13333,552,708,24,18,0.001176471,728972,0.822210693
9089,673,236,24,18,0.001176471,728996,0.822237762
9091,32,250,24,18,0.001176471,729020,0.822264832
7237,274,379,24,18,0.001176471,729044,0.822291902
7209,397,280,24,18,0.001176471,729068,0.822318971
4894,514,314,24,18,0.001176471,729092,0.822346041
3128,543,158,24,18,0.001176471,729116,0.822373111
12161,243,347,24,18,0.001176471,729140,0.82240018
11848,156,443,24,18,0.001176471,729164,0.82242725
5505,347,20,24,18,0.001176471,729188,0.82245432
8786,398,529,24,18,0.001176471,729212,0.82248139
9373,6,427,24,18,0.001176471,729236,0.822508459
8846,674,97,24,18,0.001176471,729260,0.822535529
9243,204,471,24,18,0.001176471,729284,0.822562599
7094,6,181,24,18,0.001176471,729308,0.822589668
10493,195,347,24,18,0.001176471,729332,0.822616738
9630,404,219,24,18,0.001176471,729356,0.822643808
11410,529,163,24,18,0.001176471,729380,0.822670878
9966,334,473,24,18,0.001176471,729404,0.822697947
8508,502,310,24,18,0.001176471,729428,0.822725017
10025,23,353,24,18,0.001176471,729452,0.822752087
8328,532,544,24,18,0.001176471,729476,0.822779156
8400,471,334,24,18,0.001176471,729500,0.822806226
8378,84,638,24,18,0.001176471,729524,0.822833296
8147,131,307,24,18,0.001176471,729548,0.822860365
11387,463,640,24,18,0.001176471,729572,0.822887435
6802,532,348,24,18,0.001176471,729596,0.822914505
9671,498,398,24,18,0.001176471,729620,0.822941575
10964,50,353,24,18,0.001176471,729644,0.822968644
8294,1,723,24,18,0.001176471,729668,0.822995714
7940,302,64,24,18,0.001176471,729692,0.823022784
8291,393,479,24,18,0.001176471,729716,0.823049853
6560,379,501,24,18,0.001176471,729740,0.823076923
9992,379,117,24,18,0.001176471,729764,0.823103993
5869,14,105,24,18,0.001176471,729788,0.823131062
8309,95,663,24,18,0.001176471,729812,0.823158132
9676,347,33,24,18,0.001176471,729836,0.823185202
6582,196,48,24,18,0.001176471,729860,0.823212272
8419,605,335,24,18,0.001176471,729884,0.823239341
8532,502,9,24,18,0.001176471,729908,0.823266411
6028,689,311,23,18,0.001127451,729931,0.823292353
9285,26,117,23,18,0.001127451,729954,0.823318295
9296,443,348,23,18,0.001127451,729977,0.823344236
10460,48,586,23,18,0.001127451,730000,0.823370178
5376,313,265,23,18,0.001127451,730023,0.82339612
8390,164,314,23,18,0.001127451,730046,0.823422062
8563,43,473,23,18,0.001127451,730069,0.823448004
8203,443,471,23,18,0.001127451,730092,0.823473945
10611,95,586,23,18,0.001127451,730115,0.823499887
11174,443,517,23,18,0.001127451,730138,0.823525829
11168,20,48,23,18,0.001127451,730161,0.823551771
11170,15,114,23,18,0.001127451,730184,0.823577713
12541,155,219,23,18,0.001127451,730207,0.823603654
9831,314,163,23,18,0.001127451,730230,0.823629596
7311,331,562,23,18,0.001127451,730253,0.823655538
5045,638,335,23,18,0.001127451,730276,0.82368148
8155,394,280,23,18,0.001127451,730299,0.823707422
8931,11,33,23,18,0.001127451,730322,0.823733363
9747,529,558,23,18,0.001127451,730345,0.823759305
9242,394,121,23,18,0.001127451,730368,0.823785247
10530,558,587,23,18,0.001127451,730391,0.823811189
8341,353,471,23,18,0.001127451,730414,0.823837131
10564,663,439,23,18,0.001127451,730437,0.823863072
11594,219,385,23,18,0.001127451,730460,0.823889014
10811,473,25,23,18,0.001127451,730483,0.823914956
8484,535,532,23,18,0.001127451,730506,0.823940898
6938,379,114,23,18,0.001127451,730529,0.82396684
10046,385,443,23,18,0.001127451,730552,0.823992781
7702,295,121,23,18,0.001127451,730575,0.824018723
8464,443,588,23,18,0.001127451,730598,0.824044665
6859,582,126,23,18,0.001127451,730621,0.824070607
5138,473,20,23,18,0.001127451,730644,0.824096549
10860,414,4,23,18,0.001127451,730667,0.82412249
10235,443,163,23,18,0.001127451,730690,0.824148432
6880,1,10,23,18,0.001127451,730713,0.824174374
12730,471,170,23,18,0.001127451,730736,0.824200316
10248,123,64,23,18,0.001127451,730759,0.824226258
10840,30,126,23,18,0.001127451,730782,0.824252199
6822,532,23,23,18,0.001127451,730805,0.824278141
7777,562,508,23,18,0.001127451,730828,0.824304083
10855,27,493,23,18,0.001127451,730851,0.824330025
7989,532,638,23,18,0.001127451,730874,0.824355967
7650,331,683,23,18,0.001127451,730897,0.824381908
6262,261,335,23,18,0.001127451,730920,0.82440785
7930,311,164,23,18,0.001127451,730943,0.824433792
4776,586,393,23,18,0.001127451,730966,0.824459734
12789,107,140,23,18,0.001127451,730989,0.824485676
9562,640,632,23,18,0.001127451,731012,0.824511617
11047,404,498,23,18,0.001127451,731035,0.824537559
8458,16,130,23,18,0.001127451,731058,0.824563501
7690,204,9,23,18,0.001127451,731081,0.824589443
7933,31,95,23,18,0.001127451,731104,0.824615385
10190,638,674,22,18,0.001078431,731126,0.824640199
9569,528,335,22,18,0.001078431,731148,0.824665012
9501,77,409,22,18,0.001078431,731170,0.824689826
10139,354,501,22,18,0.001078431,731192,0.82471464
12566,219,439,22,18,0.001078431,731214,0.824739454
10616,364,380,22,18,0.001078431,731236,0.824764268
10997,68,482,22,18,0.001078431,731258,0.824789082
9588,311,682,22,18,0.001078431,731280,0.824813896
12492,207,224,22,18,0.001078431,731302,0.82483871
10629,367,528,22,18,0.001078431,731324,0.824863524
11944,114,280,22,18,0.001078431,731346,0.824888337
9656,140,230,22,18,0.001078431,731368,0.824913151
10399,353,12,22,18,0.001078431,731390,0.824937965
10459,204,84,22,18,0.001078431,731412,0.824962779
9662,544,310,22,18,0.001078431,731434,0.824987593
13113,171,34,22,18,0.001078431,731456,0.825012407
9207,588,29,22,18,0.001078431,731478,0.825037221
9203,219,250,22,18,0.001078431,731500,0.825062035
10263,243,23,22,18,0.001078431,731522,0.825086849
10282,97,663,22,18,0.001078431,731544,0.825111663
12655,204,193,22,18,0.001078431,731566,0.825136476
11572,11,497,22,18,0.001078431,731588,0.82516129
12000,224,661,22,18,0.001078431,731610,0.825186104
9920,250,497,22,18,0.001078431,731632,0.825210918
12010,117,398,22,18,0.001078431,731654,0.825235732
9421,97,394,22,18,0.001078431,731676,0.825260546
8882,543,507,22,18,0.001078431,731698,0.82528536
7687,280,295,22,18,0.001078431,731720,0.825310174
14860,701,632,22,18,0.001078431,731742,0.825334988
8847,219,22,22,18,0.001078431,731764,0.825359801
8832,14,31,22,18,0.001078431,731786,0.825384615
7871,562,354,22,18,0.001078431,731808,0.825409429
7616,30,48,22,18,0.001078431,731830,0.825434243
7221,367,56,22,18,0.001078431,731852,0.825459057
5617,4,50,22,18,0.001078431,731874,0.825483871
5579,393,32,22,18,0.001078431,731896,0.825508685
7445,618,6,22,18,0.001078431,731918,0.825533499
7150,50,10,22,18,0.001078431,731940,0.825558313
8404,475,397,22,18,0.001078431,731962,0.825583127
13834,224,269,22,18,0.001078431,731984,0.82560794
8609,280,307,22,18,0.001078431,732006,0.825632754
8274,380,552,22,18,0.001078431,732028,0.825657568
2983,582,264,22,18,0.001078431,732050,0.825682382
13600,328,364,22,18,0.001078431,732072,0.825707196
8711,498,22,22,18,0.001078431,732094,0.82573201
7693,397,121,22,18,0.001078431,732116,0.825756824
4338,32,543,22,18,0.001078431,732138,0.825781638
15719,342,313,22,18,0.001078431,732160,0.825806452
6102,265,158,22,18,0.001078431,732182,0.825831266
5893,655,236,22,18,0.001078431,732204,0.825856079
9981,380,383,21,18,0.001029412,732225,0.825879765
11268,314,652,21,18,0.001029412,732246,0.825903451
4426,689,335,21,18,0.001029412,732267,0.825927137
11187,593,367,21,18,0.001029412,732288,0.825950823
12745,155,16,21,18,0.001029412,732309,0.825974509
11229,56,204,21,18,0.001029412,732330,0.825998195
9815,682,26,21,18,0.001029412,732351,0.826021881
9767,13,16,21,18,0.001029412,732372,0.826045567
6900,385,394,21,18,0.001029412,732393,0.826069253
7138,655,10,21,18,0.001029412,732414,0.826092939
11648,479,126,21,18,0.001029412,732435,0.826116625
10751,655,33,21,18,0.001029412,732456,0.826140311
11488,588,448,21,18,0.001029412,732477,0.826163997
10175,398,56,21,18,0.001029412,732498,0.826187683
11345,160,219,21,18,0.001029412,732519,0.826211369
7670,562,156,21,18,0.001029412,732540,0.826235055
10353,20,471,21,18,0.001029412,732561,0.826258741
10326,367,640,21,18,0.001029412,732582,0.826282427
10324,243,307,21,18,0.001029412,732603,0.826306113
7774,97,15,21,18,0.001029412,732624,0.826329799
14722,543,5,21,18,0.001029412,732645,0.826353485
9337,50,32,21,18,0.001029412,732666,0.826377171
13280,236,167,21,18,0.001029412,732687,0.826400857
8766,353,404,21,18,0.001029412,732708,0.826424543
8957,380,261,20,18,0.000980392,732728,0.826447101
9963,586,50,20,18,0.000980392,732748,0.826469659
7753,673,354,20,18,0.000980392,732768,0.826492217
9950,280,348,20,18,0.000980392,732788,0.826514776
14904,683,313,20,18,0.000980392,732808,0.826537334
9422,379,164,20,18,0.000980392,732828,0.826559892
14153,80,482,20,18,0.000980392,732848,0.82658245
9863,123,502,20,18,0.000980392,732868,0.826605008
11624,243,68,20,18,0.000980392,732888,0.826627566
12510,274,683,20,18,0.000980392,732908,0.826650124
7172,529,311,20,18,0.000980392,732928,0.826672682
7542,5,123,20,18,0.000980392,732948,0.82669524
11909,347,219,20,18,0.000980392,732968,0.826717798
14352,56,605,20,18,0.000980392,732988,0.826740356
10804,242,310,20,18,0.000980392,733008,0.826762915
9680,20,663,20,18,0.000980392,733028,0.826785473
11128,517,107,20,18,0.000980392,733048,0.826808031
6688,522,85,20,18,0.000980392,733068,0.826830589
9601,517,131,19,18,0.000931373,733087,0.826852019
11289,507,230,19,18,0.000931373,733106,0.826873449
10098,10,587,19,18,0.000931373,733125,0.826894879
8856,443,723,19,18,0.000931373,733144,0.826916309
10302,514,107,19,18,0.000931373,733163,0.82693774
10215,43,379,19,18,0.000931373,733182,0.82695917
9931,501,50,19,18,0.000931373,733201,0.8269806
5616,4,397,19,18,0.000931373,733220,0.82700203
9736,48,130,19,18,0.000931373,733239,0.82702346
9749,131,50,19,18,0.000931373,733258,0.827044891
6557,674,243,36,17,0.001764706,733294,0.827085495
8056,552,131,35,17,0.001715686,733329,0.827124972
8558,56,392,33,17,0.001617647,733362,0.827162193
6246,663,196,33,17,0.001617647,733395,0.827199413
7723,535,479,32,17,0.001568627,733427,0.827235506
5692,243,230,32,17,0.001568627,733459,0.827271599
9162,140,605,31,17,0.001519608,733490,0.827306564
5989,397,56,31,17,0.001519608,733521,0.827341529
5644,614,397,31,17,0.001519608,733552,0.827376494
8710,224,5,31,17,0.001519608,733583,0.82741146
4762,379,280,31,17,0.001519608,733614,0.827446425
7793,638,367,31,17,0.001519608,733645,0.82748139
5775,307,33,31,17,0.001519608,733676,0.827516355
8623,331,2,30,17,0.001470588,733706,0.827550192
8363,380,126,30,17,0.001470588,733736,0.827584029
8604,614,347,30,17,0.001470588,733766,0.827617866
6131,543,380,30,17,0.001470588,733796,0.827651703
5988,84,6,30,17,0.001470588,733826,0.82768554
5747,529,335,30,17,0.001470588,733856,0.827719377
7031,164,16,30,17,0.001470588,733886,0.827753215
3711,9,708,30,17,0.001470588,733916,0.827787052
7224,311,22,30,17,0.001470588,733946,0.827820889
7704,497,655,29,17,0.001421569,733975,0.827853598
9691,171,95,29,17,0.001421569,734004,0.827886307
8453,15,354,29,17,0.001421569,734033,0.827919016
8006,12,596,29,17,0.001421569,734062,0.827951726
8489,34,97,29,17,0.001421569,734091,0.827984435
4071,640,302,29,17,0.001421569,734120,0.828017144
6556,219,15,29,17,0.001421569,734149,0.828049853
8357,84,274,29,17,0.001421569,734178,0.828082563
6350,265,314,29,17,0.001421569,734207,0.828115272
9595,380,673,29,17,0.001421569,734236,0.828147981
4829,379,26,28,17,0.001372549,734264,0.828179562
6937,12,242,28,17,0.001372549,734292,0.828211144
8476,68,364,28,17,0.001372549,734320,0.828242725
4303,33,158,28,17,0.001372549,734348,0.828274306
6799,219,514,28,17,0.001372549,734376,0.828305888
8071,133,353,28,17,0.001372549,734404,0.828337469
6253,640,145,28,17,0.001372549,734432,0.82836905
7681,107,15,28,17,0.001372549,734460,0.828400632
9379,243,558,28,17,0.001372549,734488,0.828432213
10181,3,5,28,17,0.001372549,734516,0.828463794
7906,26,385,28,17,0.001372549,734544,0.828495376
9564,31,394,28,17,0.001372549,734572,0.828526957
13413,348,140,28,17,0.001372549,734600,0.828558538
7847,280,398,28,17,0.001372549,734628,0.82859012
6153,311,543,28,17,0.001372549,734656,0.828621701
6319,15,219,28,17,0.001372549,734684,0.828653282
6404,196,15,28,17,0.001372549,734712,0.828684864
2361,4,80,28,17,0.001372549,734740,0.828716445
8943,507,310,28,17,0.001372549,734768,0.828748026
6567,673,443,28,17,0.001372549,734796,0.828779607
7535,261,354,28,17,0.001372549,734824,0.828811189
6491,77,246,28,17,0.001372549,734852,0.82884277
9734,367,97,28,17,0.001372549,734880,0.828874351
12386,348,156,28,17,0.001372549,734908,0.828905933
10780,558,543,28,17,0.001372549,734936,0.828937514
10192,145,126,27,17,0.001323529,734963,0.828967968
8442,246,27,27,17,0.001323529,734990,0.828998421
6380,367,117,27,17,0.001323529,735017,0.829028874
6590,511,224,27,17,0.001323529,735044,0.829059328
8254,11,414,27,17,0.001323529,735071,0.829089781
6139,43,224,27,17,0.001323529,735098,0.829120235
11447,463,511,27,17,0.001323529,735125,0.829150688
8326,131,25,27,17,0.001323529,735152,0.829181141
6832,204,123,27,17,0.001323529,735179,0.829211595
8119,30,295,27,17,0.001323529,735206,0.829242048
11482,171,230,27,17,0.001323529,735233,0.829272502
7476,130,121,27,17,0.001323529,735260,0.829302955
11606,348,181,27,17,0.001323529,735287,0.829333409
7789,439,331,27,17,0.001323529,735314,0.829363862
7012,230,1,27,17,0.001323529,735341,0.829394315
8739,97,196,27,17,0.001323529,735368,0.829424769
7385,409,394,27,17,0.001323529,735395,0.829455222
10517,114,131,27,17,0.001323529,735422,0.829485676
8979,721,219,27,17,0.001323529,735449,0.829516129
8803,302,427,26,17,0.00127451,735475,0.829545455
11298,131,167,26,17,0.00127451,735501,0.82957478
7444,1,313,26,17,0.00127451,735527,0.829604106
6470,655,230,26,17,0.00127451,735553,0.829633431
9220,674,164,26,17,0.00127451,735579,0.829662757
9224,682,331,26,17,0.00127451,735605,0.829692082
6510,532,3,26,17,0.00127451,735631,0.829721408
8782,663,156,26,17,0.00127451,735657,0.829750733
11886,328,392,26,17,0.00127451,735683,0.829780059
8225,310,4,26,17,0.00127451,735709,0.829809384
9107,353,640,26,17,0.00127451,735735,0.82983871
7552,562,543,26,17,0.00127451,735761,0.829868035
8874,33,398,26,17,0.00127451,735787,0.829897361
5023,613,80,26,17,0.00127451,735813,0.829926686
8885,543,236,26,17,0.00127451,735839,0.829956012
11570,50,522,26,17,0.00127451,735865,0.829985337
7091,33,443,26,17,0.00127451,735891,0.830014663
9913,10,5,26,17,0.00127451,735917,0.830043988
9874,2,107,26,17,0.00127451,735943,0.830073314
10123,380,511,26,17,0.00127451,735969,0.830102639
6127,15,9,26,17,0.00127451,735995,0.830131965
9413,15,498,26,17,0.00127451,736021,0.83016129
10301,354,34,26,17,0.00127451,736047,0.830190616
10179,471,145,26,17,0.00127451,736073,0.830219941
8986,15,311,26,17,0.00127451,736099,0.830249267
5264,475,311,26,17,0.00127451,736125,0.830278592
9002,6,250,26,17,0.00127451,736151,0.830307918
10185,117,10,26,17,0.00127451,736177,0.830337243
8953,12,414,26,17,0.00127451,736203,0.830366569
9152,310,265,26,17,0.00127451,736229,0.830395894
6015,16,25,26,17,0.00127451,736255,0.83042522
9383,27,448,25,17,0.00122549,736280,0.830453418
9706,26,15,25,17,0.00122549,736305,0.830481615
13339,517,463,25,17,0.00122549,736330,0.830509813
8307,130,22,25,17,0.00122549,736355,0.83053801
6388,588,170,25,17,0.00122549,736380,0.830566208
9170,163,224,25,17,0.00122549,736405,0.830594406
9215,11,95,25,17,0.00122549,736430,0.830622603
8878,123,5,25,17,0.00122549,736455,0.830650801
9508,367,463,25,17,0.00122549,736480,0.830678998
9419,219,50,25,17,0.00122549,736505,0.830707196
9715,224,364,25,17,0.00122549,736530,0.830735394
11315,140,219,25,17,0.00122549,736555,0.830763591
9629,131,265,25,17,0.00122549,736580,0.830791789
6245,708,582,25,17,0.00122549,736605,0.830819986
9006,280,114,25,17,0.00122549,736630,0.830848184
8552,673,347,25,17,0.00122549,736655,0.830876382
8789,158,354,25,17,0.00122549,736680,0.830904579
4692,123,84,25,17,0.00122549,736705,0.830932777
9198,463,204,25,17,0.00122549,736730,0.830960975
9583,528,250,25,17,0.00122549,736755,0.830989172
9427,105,163,25,17,0.00122549,736780,0.83101737
8954,380,632,25,17,0.00122549,736805,0.831045567
9586,614,31,25,17,0.00122549,736830,0.831073765
9667,367,145,25,17,0.00122549,736855,0.831101963
7799,708,475,25,17,0.00122549,736880,0.83113016
5144,689,9,25,17,0.00122549,736905,0.831158358
8116,614,588,25,17,0.00122549,736930,0.831186555
10092,11,528,25,17,0.00122549,736955,0.831214753
6720,16,141,25,17,0.00122549,736980,0.831242951
3889,145,80,25,17,0.00122549,737005,0.831271148
7131,353,605,25,17,0.00122549,737030,0.831299346
5548,543,68,25,17,0.00122549,737055,0.831327543
6690,11,264,25,17,0.00122549,737080,0.831355741
6816,479,114,25,17,0.00122549,737105,0.831383939
10004,26,14,25,17,0.00122549,737130,0.831412136
6943,632,9,25,17,0.00122549,737155,0.831440334
7622,123,265,25,17,0.00122549,737180,0.831468531
10129,398,535,25,17,0.00122549,737205,0.831496729
7188,502,331,25,17,0.00122549,737230,0.831524927
10143,10,552,25,17,0.00122549,737255,0.831553124
10700,535,204,25,17,0.00122549,737280,0.831581322
10606,544,34,25,17,0.00122549,737305,0.83160952
7310,682,655,25,17,0.00122549,737330,0.831637717
7917,543,302,25,17,0.00122549,737355,0.831665915
7407,30,64,25,17,0.00122549,737380,0.831694112
7173,280,588,25,17,0.00122549,737405,0.83172231
7393,640,64,25,17,0.00122549,737430,0.831750508
4800,501,123,24,17,0.001176471,737454,0.831777577
9552,473,265,24,17,0.001176471,737478,0.831804647
5305,618,314,24,17,0.001176471,737502,0.831831717
8723,632,145,24,17,0.001176471,737526,0.831858786
10835,463,498,24,17,0.001176471,737550,0.831885856
6347,614,170,24,17,0.001176471,737574,0.831912926
10854,609,25,24,17,0.001176471,737598,0.831939995
9523,114,50,24,17,0.001176471,737622,0.831967065
10303,353,34,24,17,0.001176471,737646,0.831994135
12970,588,392,24,17,0.001176471,737670,0.832021205
6369,16,404,24,17,0.001176471,737694,0.832048274
5474,145,158,24,17,0.001176471,737718,0.832075344
9171,156,522,24,17,0.001176471,737742,0.832102414
7167,11,32,24,17,0.001176471,737766,0.832129483
7159,379,689,24,17,0.001176471,737790,0.832156553
8936,56,532,24,17,0.001176471,737814,0.832183623
6042,123,640,24,17,0.001176471,737838,0.832210693
7456,219,243,24,17,0.001176471,737862,0.832237762
11655,446,219,24,17,0.001176471,737886,0.832264832
9125,354,117,24,17,0.001176471,737910,0.832291902
5229,9,274,24,17,0.001176471,737934,0.832318971
10540,674,14,24,17,0.001176471,737958,0.832346041
11118,558,195,24,17,0.001176471,737982,0.832373111
7572,475,331,24,17,0.001176471,738006,0.83240018
6992,95,367,24,17,0.001176471,738030,0.83242725
7065,280,638,24,17,0.001176471,738054,0.83245432
7488,532,723,24,17,0.001176471,738078,0.83248139
10524,13,708,24,17,0.001176471,738102,0.832508459
6200,558,307,24,17,0.001176471,738126,0.832535529
6036,311,2,24,17,0.001176471,738150,0.832562599
3552,529,77,24,17,0.001176471,738174,0.832589668
11125,501,14,24,17,0.001176471,738198,0.832616738
7548,314,593,24,17,0.001176471,738222,0.832643808
8857,501,107,24,17,0.001176471,738246,0.832670878
14570,117,48,24,17,0.001176471,738270,0.832697947
8426,674,640,24,17,0.001176471,738294,0.832725017
10085,230,167,24,17,0.001176471,738318,0.832752087
7258,313,207,24,17,0.001176471,738342,0.832779156
9614,95,498,24,17,0.001176471,738366,0.832806226
8334,16,475,24,17,0.001176471,738390,0.832833296
8332,158,130,24,17,0.001176471,738414,0.832860365
3879,721,353,24,17,0.001176471,738438,0.832887435
9967,250,141,24,17,0.001176471,738462,0.832914505
6494,33,655,24,17,0.001176471,738486,0.832941575
6493,379,404,24,17,0.001176471,738510,0.832968644
10021,145,723,24,17,0.001176471,738534,0.832995714
8015,473,618,24,17,0.001176471,738558,0.833022784
11453,15,689,24,17,0.001176471,738582,0.833049853
8136,502,219,24,17,0.001176471,738606,0.833076923
6444,156,663,24,17,0.001176471,738630,0.833103993
5381,302,117,24,17,0.001176471,738654,0.833131062
9748,517,95,24,17,0.001176471,738678,0.833158132
9633,84,4,24,17,0.001176471,738702,0.833185202
11401,130,514,24,17,0.001176471,738726,0.833212272
8227,528,473,24,17,0.001176471,738750,0.833239341
8069,383,310,24,17,0.001176471,738774,0.833266411
8303,274,242,24,17,0.001176471,738798,0.833293481
9803,562,313,24,17,0.001176471,738822,0.83332055
6397,397,522,24,17,0.001176471,738846,0.83334762
8263,250,50,24,17,0.001176471,738870,0.83337469
13499,230,163,23,17,0.001127451,738893,0.833400632
13904,124,68,23,17,0.001127451,738916,0.833426573
9942,514,335,23,17,0.001127451,738939,0.833452515
8425,30,95,23,17,0.001127451,738962,0.833478457
11119,535,14,23,17,0.001127451,738985,0.833504399
9291,673,348,23,17,0.001127451,739008,0.833530341
14262,269,605,23,17,0.001127451,739031,0.833556282
9708,230,4,23,17,0.001127451,739054,0.833582224
11303,3,274,23,17,0.001127451,739077,0.833608166
9700,414,56,23,17,0.001127451,739100,0.833634108
7915,307,522,23,17,0.001127451,739123,0.83366005
9701,414,532,23,17,0.001127451,739146,0.833685991
8865,10,544,23,17,0.001127451,739169,0.833711933
10770,117,443,23,17,0.001127451,739192,0.833737875
7067,393,3,23,17,0.001127451,739215,0.833763817
8209,404,522,23,17,0.001127451,739238,0.833789759
10703,174,347,23,17,0.001127451,739261,0.8338157
6075,4,243,23,17,0.001127451,739284,0.833841642
7363,588,682,23,17,0.001127451,739307,0.833867584
8996,280,511,23,17,0.001127451,739330,0.833893526
10586,588,714,23,17,0.001127451,739353,0.833919468
8295,107,85,23,17,0.001127451,739376,0.833945409
6577,295,307,23,17,0.001127451,739399,0.833971351
9105,586,130,23,17,0.001127451,739422,0.833997293
9122,503,27,23,17,0.001127451,739445,0.834023235
8165,414,588,23,17,0.001127451,739468,0.834049177
9221,311,121,23,17,0.001127451,739491,0.834075118
8370,48,243,23,17,0.001127451,739514,0.83410106
6669,4,596,23,17,0.001127451,739537,0.834127002
11613,22,310,23,17,0.001127451,739560,0.834152944
12578,544,497,23,17,0.001127451,739583,0.834178886
9194,582,482,23,17,0.001127451,739606,0.834204827
10556,155,15,23,17,0.001127451,739629,0.834230769
8339,682,335,23,17,0.001127451,739652,0.834256711
11504,532,503,23,17,0.001127451,739675,0.834282653
11038,243,535,23,17,0.001127451,739698,0.834308595
10131,383,219,23,17,0.001127451,739721,0.834334536
3727,655,314,23,17,0.001127451,739744,0.834360478
8463,16,528,23,17,0.001127451,739767,0.83438642
7882,250,114,23,17,0.001127451,739790,0.834412362
12286,353,364,23,17,0.001127451,739813,0.834438304
5435,30,230,23,17,0.001127451,739836,0.834464245
4807,123,264,23,17,0.001127451,739859,0.834490187
7831,463,354,23,17,0.001127451,739882,0.834516129
9488,414,10,23,17,0.001127451,739905,0.834542071
7953,588,4,23,17,0.001127451,739928,0.834568013
9513,404,414,23,17,0.001127451,739951,0.834593954
8618,32,56,23,17,0.001127451,739974,0.834619896
7863,16,14,23,17,0.001127451,739997,0.834645838
11270,543,544,23,17,0.001127451,740020,0.83467178
6809,475,3,23,17,0.001127451,740043,0.834697722
10368,328,280,23,17,0.001127451,740066,0.834723663
8781,97,14,23,17,0.001127451,740089,0.834749605
8780,204,307,23,17,0.001127451,740112,0.834775547
8058,479,130,23,17,0.001127451,740135,0.834801489
8051,280,313,23,17,0.001127451,740158,0.834827431
6849,398,334,23,17,0.001127451,740181,0.834853372
9670,1,632,23,17,0.001127451,740204,0.834879314
10797,380,5,23,17,0.001127451,740227,0.834905256
10191,114,404,22,17,0.001078431,740249,0.83493007
11364,596,463,22,17,0.001078431,740271,0.834954884
9581,404,250,22,17,0.001078431,740293,0.834979698
11150,145,2,22,17,0.001078431,740315,0.835004512
11639,348,274,22,17,0.001078431,740337,0.835029326
10969,34,26,22,17,0.001078431,740359,0.835054139
11641,50,33,22,17,0.001078431,740381,0.835078953
10974,328,514,22,17,0.001078431,740403,0.835103767
9101,689,10,22,17,0.001078431,740425,0.835128581
10130,552,26,22,17,0.001078431,740447,0.835153395
12824,609,130,22,17,0.001078431,740469,0.835178209
9578,473,264,22,17,0.001078431,740491,0.835203023
11090,313,646,22,17,0.001078431,740513,0.835227837
11518,562,14,22,17,0.001078431,740535,0.835252651
11817,427,353,22,17,0.001078431,740557,0.835277464
12596,178,27,22,17,0.001078431,740579,0.835302278
10030,682,311,22,17,0.001078431,740601,0.835327092
10808,632,497,22,17,0.001078431,740623,0.835351906
11318,328,558,22,17,0.001078431,740645,0.83537672
10365,15,29,22,17,0.001078431,740667,0.835401534
11217,385,328,22,17,0.001078431,740689,0.835426348
9348,114,522,22,17,0.001078431,740711,0.835451162
9707,54,84,22,17,0.001078431,740733,0.835475976
10016,163,443,22,17,0.001078431,740755,0.83550079
10467,544,307,22,17,0.001078431,740777,0.835525603
10107,605,107,22,17,0.001078431,740799,0.835550417
10083,11,501,22,17,0.001078431,740821,0.835575231
11130,243,130,22,17,0.001078431,740843,0.835600045
10269,204,674,22,17,0.001078431,740865,0.835624859
12022,471,497,22,17,0.001078431,740887,0.835649673
9247,605,367,22,17,0.001078431,740909,0.835674487
12682,328,674,22,17,0.001078431,740931,0.835699301
7955,379,97,22,17,0.001078431,740953,0.835724115
7621,367,196,22,17,0.001078431,740975,0.835748928
7717,2,204,22,17,0.001078431,740997,0.835773742
8848,674,479,22,17,0.001078431,741019,0.835798556
7904,383,68,22,17,0.001078431,741041,0.83582337
7427,6,171,22,17,0.001078431,741063,0.835848184
8315,473,171,22,17,0.001078431,741085,0.835872998
8322,497,280,22,17,0.001078431,741107,0.835897812
8416,5,105,22,17,0.001078431,741129,0.835922626
8450,196,10,22,17,0.001078431,741151,0.83594744
8543,475,50,22,17,0.001078431,741173,0.835972254
8568,674,543,22,17,0.001078431,741195,0.835997067
8600,544,379,22,17,0.001078431,741217,0.836021881
8800,367,501,22,17,0.001078431,741239,0.836046695
8008,331,511,22,17,0.001078431,741261,0.836071509
8735,84,683,22,17,0.001078431,741283,0.836096323
6198,280,156,22,17,0.001078431,741305,0.836121137
6641,123,274,22,17,0.001078431,741327,0.836145951
6686,310,145,22,17,0.001078431,741349,0.836170765
6261,614,311,22,17,0.001078431,741371,0.836195579
6763,30,638,22,17,0.001078431,741393,0.836220393
4798,9,543,22,17,0.001078431,741415,0.836245206
6112,673,655,22,17,0.001078431,741437,0.83627002
7071,632,638,22,17,0.001078431,741459,0.836294834
5887,655,397,22,17,0.001078431,741481,0.836319648
8081,31,354,21,17,0.001029412,741502,0.836343334
8075,394,48,21,17,0.001029412,741523,0.83636702
9998,204,632,21,17,0.001029412,741544,0.836390706
8073,145,170,21,17,0.001029412,741565,0.836414392
11271,219,242,21,17,0.001029412,741586,0.836438078
6478,95,307,21,17,0.001029412,741607,0.836461764
12469,446,14,21,17,0.001029412,741628,0.83648545
8104,475,334,21,17,0.001029412,741649,0.836509136
12400,26,517,21,17,0.001029412,741670,0.836532822
9943,95,145,21,17,0.001029412,741691,0.836556508
9940,586,398,21,17,0.001029412,741712,0.836580194
5158,9,54,21,17,0.001029412,741733,0.83660388
12438,348,624,21,17,0.001029412,741754,0.836627566
12464,29,310,21,17,0.001029412,741775,0.836651252
9893,593,123,21,17,0.001029412,741796,0.836674938
9598,473,364,21,17,0.001029412,741817,0.836698624
9604,586,501,21,17,0.001029412,741838,0.83672231
9607,33,439,21,17,0.001029412,741859,0.836745996
11145,171,11,21,17,0.001029412,741880,0.836769682
6083,12,532,21,17,0.001029412,741901,0.836793368
8585,280,439,21,17,0.001029412,741922,0.836817054
8586,12,334,21,17,0.001029412,741943,0.83684074
8595,552,123,21,17,0.001029412,741964,0.836864426
5205,313,414,21,17,0.001029412,741985,0.836888112
8625,107,34,21,17,0.001029412,742006,0.836911798
13962,414,463,21,17,0.001029412,742027,0.836935484
6275,668,314,21,17,0.001029412,742048,0.83695917
11080,22,145,21,17,0.001029412,742069,0.836982856
12549,463,689,21,17,0.001029412,742090,0.837006542
14069,14,463,21,17,0.001029412,742111,0.837030228
9757,295,236,21,17,0.001029412,742132,0.837053914
8371,379,196,21,17,0.001029412,742153,0.8370776
10472,511,379,21,17,0.001029412,742174,0.837101286
10441,164,243,21,17,0.001029412,742195,0.837124972
10437,280,34,21,17,0.001029412,742216,0.837148658
10415,588,207,21,17,0.001029412,742237,0.837172344
7450,443,50,21,17,0.001029412,742258,0.83719603
7179,274,522,21,17,0.001029412,742279,0.837219716
4889,439,80,21,17,0.001029412,742300,0.837243402
7225,328,313,21,17,0.001029412,742321,0.837267088
10648,193,145,21,17,0.001029412,742342,0.837290774
7087,383,9,21,17,0.001029412,742363,0.83731446
7059,673,463,21,17,0.001029412,742384,0.837338146
7380,640,532,21,17,0.001029412,742405,0.837361832
4045,498,123,21,17,0.001029412,742426,0.837385518
7937,11,250,21,17,0.001029412,742447,0.837409204
12236,68,392,21,17,0.001029412,742468,0.83743289
5765,689,6,21,17,0.001029412,742489,0.837456576
10371,618,204,21,17,0.001029412,742510,0.837480262
5805,689,302,21,17,0.001029412,742531,0.837503948
9081,167,27,21,17,0.001029412,742552,0.837527634
8887,586,614,21,17,0.001029412,742573,0.83755132
9074,353,117,21,17,0.001029412,742594,0.837575006
9467,596,475,21,17,0.001029412,742615,0.837598692
8833,552,379,21,17,0.001029412,742636,0.837622378
12999,27,701,21,17,0.001029412,742657,0.837646064
8665,280,723,21,17,0.001029412,742678,0.83766975
9384,11,532,21,17,0.001029412,742699,0.837693436
9447,544,33,21,17,0.001029412,742720,0.837717122
8843,501,48,21,17,0.001029412,742741,0.837740808
9030,640,655,21,17,0.001029412,742762,0.837764494
10653,68,155,20,17,0.000980392,742782,0.837787052
9209,511,310,20,17,0.000980392,742802,0.83780961
7267,307,95,20,17,0.000980392,742822,0.837832168
11684,552,11,20,17,0.000980392,742842,0.837854726
9276,385,230,20,17,0.000980392,742862,0.837877284
7375,379,497,20,17,0.000980392,742882,0.837899842
9375,156,335,20,17,0.000980392,742902,0.8379224
9970,682,443,20,17,0.000980392,742922,0.837944958
9964,522,54,20,17,0.000980392,742942,0.837967516
9955,302,2,20,17,0.000980392,742962,0.837990074
14161,348,4,20,17,0.000980392,742982,0.838012633
9190,295,655,20,17,0.000980392,743002,0.838035191
8854,618,558,20,17,0.000980392,743022,0.838057749
7718,443,463,20,17,0.000980392,743042,0.838080307
8272,586,522,20,17,0.000980392,743062,0.838102865
5673,29,20,20,17,0.000980392,743082,0.838125423
12571,383,596,20,17,0.000980392,743102,0.838147981
7079,514,582,20,17,0.000980392,743122,0.838170539
7710,1,708,20,17,0.000980392,743142,0.838193097
11621,204,48,20,17,0.000980392,743162,0.838215655
8717,673,6,20,17,0.000980392,743182,0.838238213
14096,347,5,20,17,0.000980392,743202,0.838260771
12347,219,196,20,17,0.000980392,743222,0.83828333
7931,708,224,20,17,0.000980392,743242,0.838305888
11835,463,609,20,17,0.000980392,743262,0.838328446
8834,15,167,20,17,0.000980392,743282,0.838351004
13319,5,618,20,17,0.000980392,743302,0.838373562
4287,31,80,20,17,0.000980392,743322,0.83839612
12095,609,347,20,17,0.000980392,743342,0.838418678
10221,334,230,20,17,0.000980392,743362,0.838441236
8820,105,493,20,17,0.000980392,743382,0.838463794
5560,514,331,20,17,0.000980392,743402,0.838486352
14338,34,535,20,17,0.000980392,743422,0.83850891
10027,313,446,20,17,0.000980392,743442,0.838531469
10062,394,501,20,17,0.000980392,743462,0.838554027
10064,265,367,20,17,0.000980392,743482,0.838576585
7786,26,463,20,17,0.000980392,743502,0.838599143
11811,54,588,20,17,0.000980392,743522,0.838621701
10097,13,80,20,17,0.000980392,743542,0.838644259
9593,164,498,20,17,0.000980392,743562,0.838666817
8412,624,68,20,17,0.000980392,743582,0.838689375
9534,535,348,20,17,0.000980392,743602,0.838711933
13816,131,714,20,17,0.000980392,743622,0.838734491
8423,674,107,20,17,0.000980392,743642,0.838757049
3787,383,80,20,17,0.000980392,743662,0.838779607
8436,10,439,20,17,0.000980392,743682,0.838802166
8443,593,9,20,17,0.000980392,743702,0.838824724
10890,219,614,20,17,0.000980392,743722,0.838847282
9469,543,11,20,17,0.000980392,743742,0.83886984
11331,364,9,20,17,0.000980392,743762,0.838892398
9153,514,497,20,17,0.000980392,743782,0.838914956
9175,479,614,20,17,0.000980392,743802,0.838937514
9646,674,25,20,17,0.000980392,743822,0.838960072
8678,31,145,20,17,0.000980392,743842,0.83898263
5764,140,80,20,17,0.000980392,743862,0.839005188
13349,230,207,20,17,0.000980392,743882,0.839027746
15455,663,448,20,17,0.000980392,743902,0.839050305
11392,414,121,20,17,0.000980392,743922,0.839072863
9510,397,130,20,17,0.000980392,743942,0.839095421
9075,588,528,19,17,0.000931373,743961,0.839116851
10033,311,560,19,17,0.000931373,743980,0.839138281
13184,663,117,19,17,0.000931373,743999,0.839159711
10982,156,236,19,17,0.000931373,744018,0.839181141
6864,33,29,19,17,0.000931373,744037,0.839202572
10280,20,674,19,17,0.000931373,744056,0.839224002
8872,32,193,19,17,0.000931373,744075,0.839245432
11353,243,33,19,17,0.000931373,744094,0.839266862
17289,140,5,19,17,0.000931373,744113,0.839288292
9087,507,68,19,17,0.000931373,744132,0.839309723
9248,492,105,19,17,0.000931373,744151,0.839331153
12191,68,4,19,17,0.000931373,744170,0.839352583
7604,397,25,19,17,0.000931373,744189,0.839374013
11693,84,493,19,17,0.000931373,744208,0.839395443
15399,16,332,19,17,0.000931373,744227,0.839416873
11192,80,409,19,17,0.000931373,744246,0.839438304
11135,439,48,19,17,0.000931373,744265,0.839459734
7289,302,497,19,17,0.000931373,744284,0.839481164
9704,479,529,19,17,0.000931373,744303,0.839502594
11614,13,353,19,17,0.000931373,744322,0.839524024
8991,558,596,19,17,0.000931373,744341,0.839545455
10604,84,364,19,17,0.000931373,744360,0.839566885
11949,31,517,18,17,0.000882353,744378,0.839587187
11346,29,307,18,17,0.000882353,744396,0.839607489
11802,204,511,18,17,0.000882353,744414,0.839627792
7610,31,663,18,17,0.000882353,744432,0.839648094
5569,163,158,18,17,0.000882353,744450,0.839668396
16856,167,6,18,17,0.000882353,744468,0.839688698
7605,502,77,18,17,0.000882353,744486,0.839709001
11511,145,475,18,17,0.000882353,744504,0.839729303
13831,439,131,18,17,0.000882353,744522,0.839749605
10108,535,265,18,17,0.000882353,744540,0.839769908
12490,331,503,18,17,0.000882353,744558,0.83979021
10149,528,311,18,17,0.000882353,744576,0.839810512
13709,243,31,18,17,0.000882353,744594,0.839830814
11095,514,614,18,17,0.000882353,744612,0.839851117
11133,443,97,18,17,0.000882353,744630,0.839871419
12626,236,54,18,17,0.000882353,744648,0.839891721
10265,535,514,18,17,0.000882353,744666,0.839912023
12846,503,16,18,17,0.000882353,744684,0.839932326
9406,392,27,18,17,0.000882353,744702,0.839952628
13641,140,32,17,17,0.000833333,744719,0.839971802
12216,646,9,17,17,0.000833333,744736,0.839990977
14745,95,446,17,17,0.000833333,744753,0.840010151
8086,394,427,34,16,0.001666667,744787,0.8400485
7377,479,107,32,16,0.001568627,744819,0.840084593
10718,479,385,31,16,0.001519608,744850,0.840119558
6174,655,32,31,16,0.001519608,744881,0.840154523
4835,721,655,31,16,0.001519608,744912,0.840189488
8491,498,204,31,16,0.001519608,744943,0.840224453
9155,593,236,30,16,0.001470588,744973,0.84025829
8555,2,5,30,16,0.001470588,745003,0.840292127
6970,50,393,30,16,0.001470588,745033,0.840325964
6061,498,473,30,16,0.001470588,745063,0.840359801
6863,497,532,30,16,0.001470588,745093,0.840393639
6191,12,250,30,16,0.001470588,745123,0.840427476
6307,196,224,29,16,0.001421569,745152,0.840460185
8737,2,367,29,16,0.001421569,745181,0.840492894
8468,367,295,29,16,0.001421569,745210,0.840525603
4093,77,2,29,16,0.001421569,745239,0.840558313
7994,2,522,29,16,0.001421569,745268,0.840591022
8474,640,11,28,16,0.001372549,745296,0.840622603
5927,302,121,28,16,0.001372549,745324,0.840654185
5638,497,310,28,16,0.001372549,745352,0.840685766
5894,528,582,28,16,0.001372549,745380,0.840717347
8394,26,95,28,16,0.001372549,745408,0.840748928
9528,348,264,27,16,0.001323529,745435,0.840779382
8138,532,14,27,16,0.001323529,745462,0.840809835
11462,535,34,27,16,0.001323529,745489,0.840840289
5931,673,77,27,16,0.001323529,745516,0.840870742
11040,243,501,27,16,0.001323529,745543,0.840901196
7327,123,404,27,16,0.001323529,745570,0.840931649
8358,439,16,27,16,0.001323529,745597,0.840962102
12307,48,517,27,16,0.001323529,745624,0.840992556
8454,26,414,27,16,0.001323529,745651,0.841023009
7730,15,10,27,16,0.001323529,745678,0.841053463
7410,158,335,27,16,0.001323529,745705,0.841083916
9435,498,196,27,16,0.001323529,745732,0.84111437
6231,68,174,27,16,0.001323529,745759,0.841144823
8646,48,34,27,16,0.001323529,745786,0.841175276
12024,502,614,27,16,0.001323529,745813,0.84120573
7229,12,385,26,16,0.00127451,745839,0.841235055
10746,398,347,26,16,0.00127451,745865,0.841264381
11647,614,502,26,16,0.00127451,745891,0.841293706
10622,1,236,26,16,0.00127451,745917,0.841323032
13111,117,596,26,16,0.00127451,745943,0.841352357
10680,230,392,26,16,0.00127451,745969,0.841381683
7596,97,68,26,16,0.00127451,745995,0.841411008
8193,682,310,26,16,0.00127451,746021,0.841440334
8540,332,353,26,16,0.00127451,746047,0.841469659
8682,12,50,26,16,0.00127451,746073,0.841498985
9009,618,14,26,16,0.00127451,746099,0.84152831
8753,107,723,26,16,0.00127451,746125,0.841557636
7748,34,334,26,16,0.00127451,746151,0.841586961
10080,43,479,26,16,0.00127451,746177,0.841616287
12836,427,463,26,16,0.00127451,746203,0.841645612
9174,328,95,26,16,0.00127451,746229,0.841674938
7371,501,242,26,16,0.00127451,746255,0.841704263
6326,640,334,26,16,0.00127451,746281,0.841733589
8893,522,708,26,16,0.00127451,746307,0.841762915
5734,397,48,26,16,0.00127451,746333,0.84179224
6272,307,31,26,16,0.00127451,746359,0.841821566
7212,397,33,26,16,0.00127451,746385,0.841850891
8714,473,414,26,16,0.00127451,746411,0.841880217
7680,243,10,26,16,0.00127451,746437,0.841909542
7441,123,560,26,16,0.00127451,746463,0.841938868
9301,274,313,25,16,0.00122549,746488,0.841967065
8853,114,397,25,16,0.00122549,746513,0.841995263
11087,6,501,25,16,0.00122549,746538,0.84202346
8952,156,230,25,16,0.00122549,746563,0.842051658
8632,193,5,25,16,0.00122549,746588,0.842079856
6476,32,1,25,16,0.00122549,746613,0.842108053
8787,12,614,25,16,0.00122549,746638,0.842136251
8815,145,463,25,16,0.00122549,746663,0.842164448
6432,379,723,25,16,0.00122549,746688,0.842192646
6183,638,48,25,16,0.00122549,746713,0.842220844
12764,156,11,25,16,0.00122549,746738,0.842249041
9773,1,367,25,16,0.00122549,746763,0.842277239
9341,335,618,25,16,0.00122549,746788,0.842305436
3165,9,501,25,16,0.00122549,746813,0.842333634
7116,10,56,25,16,0.00122549,746838,0.842361832
7975,313,511,25,16,0.00122549,746863,0.842390029
7762,558,689,25,16,0.00122549,746888,0.842418227
8041,463,48,25,16,0.00122549,746913,0.842446425
14893,15,569,25,16,0.00122549,746938,0.842474622
10420,588,605,25,16,0.00122549,746963,0.84250282
7716,30,618,25,16,0.00122549,746988,0.842531017
10029,379,517,25,16,0.00122549,747013,0.842559215
12118,348,446,25,16,0.00122549,747038,0.842587413
6604,295,708,25,16,0.00122549,747063,0.84261561
7892,331,117,24,16,0.001176471,747087,0.84264268
8577,498,6,24,16,0.001176471,747111,0.84266975
7897,511,145,24,16,0.001176471,747135,0.842696819
7901,393,33,24,16,0.001176471,747159,0.842723889
10346,552,145,24,16,0.001176471,747183,0.842750959
7731,314,195,24,16,0.001176471,747207,0.842778028
11494,114,250,24,16,0.001176471,747231,0.842805098
9444,380,560,24,16,0.001176471,747255,0.842832168
8597,10,632,24,16,0.001176471,747279,0.842859238
8738,145,84,24,16,0.001176471,747303,0.842886307
4417,32,586,24,16,0.001176471,747327,0.842913377
11731,117,404,24,16,0.001176471,747351,0.842940447
7285,6,178,24,16,0.001176471,747375,0.842967516
5330,164,158,24,16,0.001176471,747399,0.842994586
7318,12,10,24,16,0.001176471,747423,0.843021656
9136,475,204,24,16,0.001176471,747447,0.843048725
9028,354,463,24,16,0.001176471,747471,0.843075795
7322,302,243,24,16,0.001176471,747495,0.843102865
7570,133,224,24,16,0.001176471,747519,0.843129935
7041,331,640,24,16,0.001176471,747543,0.843157004
9330,543,14,24,16,0.001176471,747567,0.843184074
10377,497,522,24,16,0.001176471,747591,0.843211144
7078,638,354,24,16,0.001176471,747615,0.843238213
7588,404,10,24,16,0.001176471,747639,0.843265283
8333,522,398,24,16,0.001176471,747663,0.843292353
9661,463,114,24,16,0.001176471,747687,0.843319423
8457,140,224,24,16,0.001176471,747711,0.843346492
8346,15,48,24,16,0.001176471,747735,0.843373562
9923,528,230,24,16,0.001176471,747759,0.843400632
8483,558,535,24,16,0.001176471,747783,0.843427701
8011,156,145,24,16,0.001176471,747807,0.843454771
11022,517,479,24,16,0.001176471,747831,0.843481841
9850,543,511,24,16,0.001176471,747855,0.84350891
9669,2,219,24,16,0.001176471,747879,0.84353598
10992,463,34,24,16,0.001176471,747903,0.84356305
5811,393,529,24,16,0.001176471,747927,0.84359012
10168,68,414,24,16,0.001176471,747951,0.843617189
9269,397,514,23,16,0.001127451,747974,0.843643131
6715,16,543,23,16,0.001127451,747997,0.843669073
6712,2,379,23,16,0.001127451,748020,0.843695015
7607,379,130,23,16,0.001127451,748043,0.843720956
9702,593,498,23,16,0.001127451,748066,0.843746898
5681,586,10,23,16,0.001127451,748089,0.84377284
12398,588,43,23,16,0.001127451,748112,0.843798782
7074,383,335,23,16,0.001127451,748135,0.843824724
11294,380,507,23,16,0.001127451,748158,0.843850665
9957,673,50,23,16,0.001127451,748181,0.843876607
8861,532,404,23,16,0.001127451,748204,0.843902549
11638,224,56,23,16,0.001127451,748227,0.843928491
10957,348,54,23,16,0.001127451,748250,0.843954433
12485,347,463,23,16,0.001127451,748273,0.843980374
8268,398,131,23,16,0.001127451,748296,0.844006316
9830,243,48,23,16,0.001127451,748319,0.844032258
9046,614,265,23,16,0.001127451,748342,0.8440582
8185,77,683,23,16,0.001127451,748365,0.844084142
8343,609,50,23,16,0.001127451,748388,0.844110083
10735,354,517,23,16,0.001127451,748411,0.844136025
7439,307,471,23,16,0.001127451,748434,0.844161967
10545,558,242,23,16,0.001127451,748457,0.844187909
8951,479,532,23,16,0.001127451,748480,0.844213851
9869,196,640,23,16,0.001127451,748503,0.844239792
11142,158,471,23,16,0.001127451,748526,0.844265734
6535,605,397,23,16,0.001127451,748549,0.844291676
9196,2,295,23,16,0.001127451,748572,0.844317618
5555,674,236,23,16,0.001127451,748595,0.84434356
8350,498,48,23,16,0.001127451,748618,0.844369501
9650,522,632,23,16,0.001127451,748641,0.844395443
10210,26,121,23,16,0.001127451,748664,0.844421385
7870,9,156,23,16,0.001127451,748687,0.844447327
11061,663,364,23,16,0.001127451,748710,0.844473269
6305,313,661,23,16,0.001127451,748733,0.84449921
8541,95,535,23,16,0.001127451,748756,0.844525152
6835,379,50,23,16,0.001127451,748779,0.844551094
11972,114,295,23,16,0.001127451,748802,0.844577036
10146,353,475,23,16,0.001127451,748825,0.844602978
8470,10,117,23,16,0.001127451,748848,0.844628919
10044,219,544,23,16,0.001127451,748871,0.844654861
13668,379,392,23,16,0.001127451,748894,0.844680803
9478,479,158,23,16,0.001127451,748917,0.844706745
7980,33,544,23,16,0.001127451,748940,0.844732687
5247,586,334,23,16,0.001127451,748963,0.844758628
7891,596,479,23,16,0.001127451,748986,0.84478457
9356,123,56,23,16,0.001127451,749009,0.844810512
14302,614,646,23,16,0.001127451,749032,0.844836454
8542,673,84,23,16,0.001127451,749055,0.844862396
9673,552,204,23,16,0.001127451,749078,0.844888337
10788,544,250,23,16,0.001127451,749101,0.844914279
10147,380,543,23,16,0.001127451,749124,0.844940221
10118,164,280,22,16,0.001078431,749146,0.844965035
9507,473,501,22,16,0.001078431,749168,0.844989849
9589,15,543,22,16,0.001078431,749190,0.845014663
10650,3,708,22,16,0.001078431,749212,0.845039477
10694,393,614,22,16,0.001078431,749234,0.845064291
9543,97,77,22,16,0.001078431,749256,0.845089104
9544,50,379,22,16,0.001078431,749278,0.845113918
10601,562,11,22,16,0.001078431,749300,0.845138732
12182,34,640,22,16,0.001078431,749322,0.845163546
9872,130,517,22,16,0.001078431,749344,0.84518836
9712,501,497,22,16,0.001078431,749366,0.845213174
11403,682,77,22,16,0.001078431,749388,0.845237988
10349,471,498,22,16,0.001078431,749410,0.845262802
10498,265,25,22,16,0.001078431,749432,0.845287616
10367,84,640,22,16,0.001078431,749454,0.84531243
12342,219,517,22,16,0.001078431,749476,0.845337243
10779,156,473,22,16,0.001078431,749498,0.845362057
10792,26,269,22,16,0.001078431,749520,0.845386871
11552,5,379,22,16,0.001078431,749542,0.845411685
10794,471,196,22,16,0.001078431,749564,0.845436499
12370,507,463,22,16,0.001078431,749586,0.845461313
11224,640,517,22,16,0.001078431,749608,0.845486127
11513,5,708,22,16,0.001078431,749630,0.845510941
11591,522,661,22,16,0.001078431,749652,0.845535755
10732,145,280,22,16,0.001078431,749674,0.845560568
10830,1,446,22,16,0.001078431,749696,0.845585382
10283,347,522,22,16,0.001078431,749718,0.845610196
9402,48,614,22,16,0.001078431,749740,0.84563501
11987,689,708,22,16,0.001078431,749762,0.845659824
8629,614,348,22,16,0.001078431,749784,0.845684638
7639,1,475,22,16,0.001078431,749806,0.845709452
8871,25,310,22,16,0.001078431,749828,0.845734266
7697,398,328,22,16,0.001078431,749850,0.84575908
7734,26,307,22,16,0.001078431,749872,0.845783894
7790,145,596,22,16,0.001078431,749894,0.845808707
7818,313,126,22,16,0.001078431,749916,0.845833521
5118,443,334,22,16,0.001078431,749938,0.845858335
7595,196,30,22,16,0.001078431,749960,0.845883149
5632,11,85,22,16,0.001078431,749982,0.845907963
8963,682,379,22,16,0.001078431,750004,0.845932777
7308,313,562,22,16,0.001078431,750026,0.845957591
5593,473,682,22,16,0.001078431,750048,0.845982405
11165,588,508,22,16,0.001078431,750070,0.846007219
7348,522,587,22,16,0.001078431,750092,0.846032032
7522,673,638,22,16,0.001078431,750114,0.846056846
7546,609,655,22,16,0.001078431,750136,0.84608166
8912,84,714,22,16,0.001078431,750158,0.846106474
8902,655,68,22,16,0.001078431,750180,0.846131288
7943,385,354,22,16,0.001078431,750202,0.846156102
13973,347,307,22,16,0.001078431,750224,0.846180916
8420,605,532,22,16,0.001078431,750246,0.84620573
8571,311,714,22,16,0.001078431,750268,0.846230544
8289,196,618,22,16,0.001078431,750290,0.846255358
5400,582,560,22,16,0.001078431,750312,0.846280171
13579,130,383,22,16,0.001078431,750334,0.846304985
8032,593,655,22,16,0.001078431,750356,0.846329799
5416,367,158,22,16,0.001078431,750378,0.846354613
2813,673,130,22,16,0.001078431,750400,0.846379427
9020,443,313,22,16,0.001078431,750422,0.846404241
6721,80,196,22,16,0.001078431,750444,0.846429055
9012,204,10,22,16,0.001078431,750466,0.846453869
3849,4,311,22,16,0.001078431,750488,0.846478683
4302,689,123,22,16,0.001078431,750510,0.846503497
4256,393,123,22,16,0.001078431,750532,0.84652831
8997,164,532,22,16,0.001078431,750554,0.846553124
5780,383,353,22,16,0.001078431,750576,0.846577938
6119,529,379,22,16,0.001078431,750598,0.846602752
9032,638,427,22,16,0.001078431,750620,0.846627566
7082,331,246,22,16,0.001078431,750642,0.84665238
5915,95,638,22,16,0.001078431,750664,0.846677194
8197,174,20,21,16,0.001029412,750685,0.84670088
9985,13,30,21,16,0.001029412,750706,0.846724566
8212,236,640,21,16,0.001029412,750727,0.846748252
11049,84,439,21,16,0.001029412,750748,0.846771938
9835,708,9,21,16,0.001029412,750769,0.846795624
12476,204,114,21,16,0.001029412,750790,0.84681931
12404,347,34,21,16,0.001029412,750811,0.846842996
11037,552,307,21,16,0.001029412,750832,0.846866682
9976,497,84,21,16,0.001029412,750853,0.846890368
12455,2,97,21,16,0.001029412,750874,0.846914054
9886,3,640,21,16,0.001029412,750895,0.84693774
11132,609,414,21,16,0.001029412,750916,0.846961426
13899,145,507,21,16,0.001029412,750937,0.846985112
11190,497,367,21,16,0.001029412,750958,0.847008798
4483,264,80,21,16,0.001029412,750979,0.847032484
13929,348,175,21,16,0.001029412,751000,0.84705617
9814,586,95,21,16,0.001029412,751021,0.847079856
14081,668,32,21,16,0.001029412,751042,0.847103542
9783,158,313,21,16,0.001029412,751063,0.847127228
11101,473,246,21,16,0.001029412,751084,0.847150914
9741,1,50,21,16,0.001029412,751105,0.8471746
11212,463,11,21,16,0.001029412,751126,0.847198286
9710,11,347,21,16,0.001029412,751147,0.847221972
11324,335,195,21,16,0.001029412,751168,0.847245658
11843,156,379,21,16,0.001029412,751189,0.847269344
10531,43,123,21,16,0.001029412,751210,0.84729303
7500,624,27,21,16,0.001029412,751231,0.847316716
7501,640,522,21,16,0.001029412,751252,0.847340402
11881,145,196,21,16,0.001029412,751273,0.847364088
7402,133,105,21,16,0.001029412,751294,0.847387774
11587,586,348,21,16,0.001029412,751315,0.84741146
7193,501,514,21,16,0.001029412,751336,0.847435145
7214,463,158,21,16,0.001029412,751357,0.847458831
11699,34,723,21,16,0.001029412,751378,0.847482517
11559,84,562,21,16,0.001029412,751399,0.847506203
7391,632,302,21,16,0.001029412,751420,0.847529889
6882,295,34,21,16,0.001029412,751441,0.847553575
7859,655,141,21,16,0.001029412,751462,0.847577261
11358,335,493,21,16,0.001029412,751483,0.847600947
10173,682,529,21,16,0.001029412,751504,0.847624633
14549,427,97,21,16,0.001029412,751525,0.847648319
10151,107,502,21,16,0.001029412,751546,0.847672005
12287,56,274,21,16,0.001029412,751567,0.847695691
10390,34,29,21,16,0.001029412,751588,0.847719377
10389,174,224,21,16,0.001029412,751609,0.847743063
7641,156,105,21,16,0.001029412,751630,0.847766749
9484,511,105,21,16,0.001029412,751651,0.847790435
12012,609,392,21,16,0.001029412,751672,0.847814121
6698,307,311,21,16,0.001029412,751693,0.847837807
12034,243,50,21,16,0.001029412,751714,0.847861493
11388,56,328,21,16,0.001029412,751735,0.847885179
8776,473,514,21,16,0.001029412,751756,0.847908865
9090,107,364,21,16,0.001029412,751777,0.847932551
9239,586,404,21,16,0.001029412,751798,0.847956237
13479,130,269,21,16,0.001029412,751819,0.847979923
8763,414,443,21,16,0.001029412,751840,0.848003609
13313,354,560,21,16,0.001029412,751861,0.848027295
9434,16,439,21,16,0.001029412,751882,0.848050981
9417,397,385,21,16,0.001029412,751903,0.848074667
9188,1,145,21,16,0.001029412,751924,0.848098353
8722,409,27,21,16,0.001029412,751945,0.848122039
9005,588,265,21,16,0.001029412,751966,0.848145725
9474,20,655,21,16,0.001029412,751987,0.848169411
13072,68,528,21,16,0.001029412,752008,0.848193097
13079,354,482,21,16,0.001029412,752029,0.848216783
13243,475,498,21,16,0.001029412,752050,0.848240469
13731,56,640,21,16,0.001029412,752071,0.848264155
9104,97,95,20,16,0.000980392,752091,0.848286713
7255,243,354,20,16,0.000980392,752111,0.848309271
13005,15,562,20,16,0.000980392,752131,0.848331829
12437,14,367,20,16,0.000980392,752151,0.848354388
7232,274,84,20,16,0.000980392,752171,0.848376946
11692,30,167,20,16,0.000980392,752191,0.848399504
11986,140,397,20,16,0.000980392,752211,0.848422062
11046,10,714,20,16,0.000980392,752231,0.84844462
11977,219,265,20,16,0.000980392,752251,0.848467178
9794,586,313,20,16,0.000980392,752271,0.848489736
7713,219,588,20,16,0.000980392,752291,0.848512294
9774,265,335,20,16,0.000980392,752311,0.848534852
7149,353,3,20,16,0.000980392,752331,0.84855741
9821,3,117,20,16,0.000980392,752351,0.848579968
10689,463,632,20,16,0.000980392,752371,0.848602527
8177,242,367,20,16,0.000980392,752391,0.848625085
11208,393,348,20,16,0.000980392,752411,0.848647643
5937,302,158,20,16,0.000980392,752431,0.848670201
12522,479,683,20,16,0.000980392,752451,0.848692759
8171,383,532,20,16,0.000980392,752471,0.848715317
12154,95,141,20,16,0.000980392,752491,0.848737875
5106,123,26,20,16,0.000980392,752511,0.848760433
10387,97,348,20,16,0.000980392,752531,0.848782991
7929,1,311,20,16,0.000980392,752551,0.848805549
11838,593,443,20,16,0.000980392,752571,0.848828107
7805,295,632,20,16,0.000980392,752591,0.848850665
12160,33,156,20,16,0.000980392,752611,0.848873224
12150,314,493,20,16,0.000980392,752631,0.848895782
10395,674,596,20,16,0.000980392,752651,0.84891834
10417,5,95,20,16,0.000980392,752671,0.848940898
11884,313,167,20,16,0.000980392,752691,0.848963456
9316,328,117,20,16,0.000980392,752711,0.848986014
10494,3,264,20,16,0.000980392,752731,0.849008572
10040,311,652,20,16,0.000980392,752751,0.84903113
10036,34,367,20,16,0.000980392,752771,0.849053688
10566,34,1,20,16,0.000980392,752791,0.849076246
10568,663,508,20,16,0.000980392,752811,0.849098804
8941,517,353,20,16,0.000980392,752831,0.849121363
11742,311,294,20,16,0.000980392,752851,0.849143921
10386,242,379,20,16,0.000980392,752871,0.849166479
10385,121,80,20,16,0.000980392,752891,0.849189037
11810,347,50,20,16,0.000980392,752911,0.849211595
9334,394,497,20,16,0.000980392,752931,0.849234153
12014,29,335,20,16,0.000980392,752951,0.849256711
13880,204,107,20,16,0.000980392,752971,0.849279269
9085,514,310,20,16,0.000980392,752991,0.849301827
6901,9,5,20,16,0.000980392,753011,0.849324385
9657,380,246,20,16,0.000980392,753031,0.849346943
6893,302,5,20,16,0.000980392,753051,0.849369501
6717,295,397,20,16,0.000980392,753071,0.84939206
11519,511,311,20,16,0.000980392,753091,0.849414618
5371,385,314,20,16,0.000980392,753111,0.849437176
10904,114,498,20,16,0.000980392,753131,0.849459734
10905,609,502,20,16,0.000980392,753151,0.849482292
9579,682,230,20,16,0.000980392,753171,0.84950485
8529,501,164,20,16,0.000980392,753191,0.849527408
8584,313,164,20,16,0.000980392,753211,0.849549966
9093,280,95,20,16,0.000980392,753231,0.849572524
11373,219,398,20,16,0.000980392,753251,0.849595082
9739,331,383,20,16,0.000980392,753271,0.84961764
9624,529,501,20,16,0.000980392,753291,0.849640199
9481,609,68,20,16,0.000980392,753311,0.849662757
8660,307,723,20,16,0.000980392,753331,0.849685315
6101,640,331,20,16,0.000980392,753351,0.849707873
5837,274,334,20,16,0.000980392,753371,0.849730431
9512,544,145,20,16,0.000980392,753391,0.849752989
11764,250,439,19,16,0.000931373,753410,0.849774419
10486,156,10,19,16,0.000931373,753429,0.849795849
11073,13,723,19,16,0.000931373,753448,0.849817279
11487,274,15,19,16,0.000931373,753467,0.84983871
11475,528,471,19,16,0.000931373,753486,0.84986014
13839,313,13,19,16,0.000931373,753505,0.84988157
8924,383,131,19,16,0.000931373,753524,0.849903
10532,354,632,19,16,0.000931373,753543,0.84992443
13443,121,473,19,16,0.000931373,753562,0.849945861
11781,171,26,19,16,0.000931373,753581,0.849967291
14517,130,294,19,16,0.000931373,753600,0.849988721
11924,514,10,19,16,0.000931373,753619,0.850010151
10275,443,14,19,16,0.000931373,753638,0.850031581
8601,16,1,19,16,0.000931373,753657,0.850053012
12002,68,446,19,16,0.000931373,753676,0.850074442
8860,95,443,19,16,0.000931373,753695,0.850095872
10950,543,588,19,16,0.000931373,753714,0.850117302
8863,14,33,19,16,0.000931373,753733,0.850138732
11997,158,507,19,16,0.000931373,753752,0.850160162
5496,274,123,19,16,0.000931373,753771,0.850181593
7743,514,264,19,16,0.000931373,753790,0.850203023
5863,196,479,19,16,0.000931373,753809,0.850224453
8905,33,529,19,16,0.000931373,753828,0.850245883
9324,310,56,19,16,0.000931373,753847,0.850267313
10171,164,529,19,16,0.000931373,753866,0.850288744
11027,6,560,19,16,0.000931373,753885,0.850310174
11428,80,22,19,16,0.000931373,753904,0.850331604
9567,14,95,19,16,0.000931373,753923,0.850353034
7598,397,141,19,16,0.000931373,753942,0.850374464
7842,10,414,19,16,0.000931373,753961,0.850395894
8598,15,379,19,16,0.000931373,753980,0.850417325
7858,668,582,19,16,0.000931373,753999,0.850438755
10213,14,64,19,16,0.000931373,754018,0.850460185
10430,522,5,19,16,0.000931373,754037,0.850481615
9146,588,274,19,16,0.000931373,754056,0.850503045
11687,14,443,19,16,0.000931373,754075,0.850524476
7001,32,195,19,16,0.000931373,754094,0.850545906
12409,353,383,19,16,0.000931373,754113,0.850567336
7135,640,479,19,16,0.000931373,754132,0.850588766
8759,171,582,19,16,0.000931373,754151,0.850610196
9787,397,348,19,16,0.000931373,754170,0.850631626
12629,114,307,19,16,0.000931373,754189,0.850653057
6920,160,158,19,16,0.000931373,754208,0.850674487
10677,48,158,19,16,0.000931373,754227,0.850695917
9884,274,348,19,16,0.000931373,754246,0.850717347
12931,14,167,19,16,0.000931373,754265,0.850738777
12977,502,243,19,16,0.000931373,754284,0.850760208
11211,261,16,19,16,0.000931373,754303,0.850781638
9905,158,48,19,16,0.000931373,754322,0.850803068
8376,640,30,19,16,0.000931373,754341,0.850824498
13292,250,170,19,16,0.000931373,754360,0.850845928
5159,1,80,19,16,0.000931373,754379,0.850867358
10671,614,264,19,16,0.000931373,754398,0.850888789
12945,27,181,19,16,0.000931373,754417,0.850910219
9851,25,609,19,16,0.000931373,754436,0.850931649
10594,131,164,19,16,0.000931373,754455,0.850953079
5636,655,84,19,16,0.000931373,754474,0.850974509
10580,20,463,19,16,0.000931373,754493,0.85099594
9843,397,145,19,16,0.000931373,754512,0.85101737
8224,242,314,19,16,0.000931373,754531,0.8510388
9770,145,479,19,16,0.000931373,754550,0.85106023
9361,5,380,19,16,0.000931373,754569,0.85108166
10619,367,265,18,16,0.000882353,754587,0.851101963
10623,404,107,18,16,0.000882353,754605,0.851122265
7510,133,380,18,16,0.000882353,754623,0.851142567
10503,501,535,18,16,0.000882353,754641,0.851162869
9007,443,48,18,16,0.000882353,754659,0.851183172
11801,471,2,18,16,0.000882353,754677,0.851203474
6883,367,264,18,16,0.000882353,754695,0.851223776
13374,479,587,18,16,0.000882353,754713,0.851244079
10544,224,167,18,16,0.000882353,754731,0.851264381
10445,383,529,18,16,0.000882353,754749,0.851284683
9047,32,609,18,16,0.000882353,754767,0.851304985
13428,517,48,18,16,0.000882353,754785,0.851325288
10483,367,242,18,16,0.000882353,754803,0.85134559
10668,471,50,18,16,0.000882353,754821,0.851365892
8910,689,95,18,16,0.000882353,754839,0.851386194
10464,224,126,18,16,0.000882353,754857,0.851406497
11237,498,117,18,16,0.000882353,754875,0.851426799
13307,32,175,18,16,0.000882353,754893,0.851447101
9654,674,34,18,16,0.000882353,754911,0.851467404
8506,673,264,18,16,0.000882353,754929,0.851487706
11250,84,269,18,16,0.000882353,754947,0.851508008
8514,528,85,18,16,0.000882353,754965,0.85152831
12434,243,404,18,16,0.000882353,754983,0.851548613
7948,380,640,18,16,0.000882353,755001,0.851568915
12269,673,596,18,16,0.000882353,755019,0.851589217
8045,250,117,18,16,0.000882353,755037,0.85160952
6265,196,311,18,16,0.000882353,755055,0.851629822
14281,328,34,18,16,0.000882353,755073,0.851650124
13913,354,2,18,16,0.000882353,755091,0.851670426
9355,562,348,18,16,0.000882353,755109,0.851690729
12369,497,514,18,16,0.000882353,755127,0.851711031
8435,107,145,18,16,0.000882353,755145,0.851731333
11123,307,34,18,16,0.000882353,755163,0.851751635
8027,331,543,18,16,0.000882353,755181,0.851771938
9525,544,663,18,16,0.000882353,755199,0.85179224
9828,163,379,18,16,0.000882353,755217,0.851812542
13281,156,334,18,16,0.000882353,755235,0.851832845
9540,562,708,18,16,0.000882353,755253,0.851853147
11063,522,552,18,16,0.000882353,755271,0.851873449
9415,307,397,17,16,0.000833333,755288,0.851892624
7170,367,307,17,16,0.000833333,755305,0.851911798
11446,155,204,17,16,0.000833333,755322,0.851930972
11461,12,48,17,16,0.000833333,755339,0.851950147
10820,250,501,17,16,0.000833333,755356,0.851969321
10818,107,562,17,16,0.000833333,755373,0.851988495
9070,50,397,17,16,0.000833333,755390,0.85200767
11177,532,167,17,16,0.000833333,755407,0.852026844
10165,473,508,17,16,0.000833333,755424,0.852046018
10071,250,95,17,16,0.000833333,755441,0.852065193
8806,26,295,17,16,0.000833333,755458,0.852084367
7966,3,404,17,16,0.000833333,755475,0.852103542
11947,331,507,17,16,0.000833333,755492,0.852122716
13074,646,310,17,16,0.000833333,755509,0.85214189
13089,354,528,17,16,0.000833333,755526,0.852161065
10335,158,348,17,16,0.000833333,755543,0.852180239
12430,708,663,17,16,0.000833333,755560,0.852199413
8964,20,97,17,16,0.000833333,755577,0.852218588
14179,155,26,17,16,0.000833333,755594,0.852237762
13416,609,295,17,16,0.000833333,755611,0.852256937
8189,274,311,17,16,0.000833333,755628,0.852276111
7239,532,307,17,16,0.000833333,755645,0.852295285
7301,683,380,17,16,0.000833333,755662,0.85231446
12333,14,97,17,16,0.000833333,755679,0.852333634
8937,145,394,17,16,0.000833333,755696,0.852352808
10602,307,26,17,16,0.000833333,755713,0.852371983
7337,280,640,17,16,0.000833333,755730,0.852391157
11236,613,394,16,16,0.000784314,755746,0.852409204
12195,274,204,16,16,0.000784314,755762,0.85242725
12694,529,95,16,16,0.000784314,755778,0.852445297
13170,588,167,16,16,0.000784314,755794,0.852463343
14878,364,250,16,16,0.000784314,755810,0.85248139
9685,640,674,16,16,0.000784314,755826,0.852499436
8813,655,354,16,16,0.000784314,755842,0.852517483
9106,97,522,16,16,0.000784314,755858,0.852535529
10202,158,307,16,16,0.000784314,755874,0.852553575
10674,463,393,38,15,0.001862745,755912,0.852596436
8599,328,114,37,15,0.001813725,755949,0.852638168
5716,1,354,35,15,0.001715686,755984,0.852677645
8109,114,302,34,15,0.001666667,756018,0.852715994
6346,562,145,32,15,0.001568627,756050,0.852752087
8835,48,398,30,15,0.001470588,756080,0.852785924
5920,328,77,30,15,0.001470588,756110,0.852819761
9261,295,689,29,15,0.001421569,756139,0.85285247
6025,33,508,29,15,0.001421569,756168,0.852885179
7665,397,242,29,15,0.001421569,756197,0.852917889
9615,328,532,29,15,0.001421569,756226,0.852950598
11041,130,140,28,15,0.001372549,756254,0.852982179
5520,404,84,28,15,0.001372549,756282,0.85301376
7526,522,156,28,15,0.001372549,756310,0.853045342
7251,32,385,28,15,0.001372549,756338,0.853076923
4514,30,123,27,15,0.001323529,756365,0.853107376
7733,156,582,27,15,0.001323529,756392,0.85313783
7102,562,26,27,15,0.001323529,756419,0.853168283
9351,502,609,27,15,0.001323529,756446,0.853198737
10536,471,204,27,15,0.001323529,756473,0.85322919
9925,15,367,26,15,0.00127451,756499,0.853258516
7909,588,562,26,15,0.00127451,756525,0.853287841
8652,529,10,25,15,0.00122549,756550,0.853316039
9199,314,409,25,15,0.00122549,756575,0.853344236
4730,4,379,25,15,0.00122549,756600,0.853372434
5803,404,379,25,15,0.00122549,756625,0.853400632
11892,348,511,25,15,0.00122549,756650,0.853428829
8196,31,48,25,15,0.00122549,756675,0.853457027
7204,15,588,25,15,0.00122549,756700,0.853485224
8733,10,682,24,15,0.001176471,756724,0.853512294
11067,224,503,24,15,0.001176471,756748,0.853539364
9503,497,11,24,15,0.001176471,756772,0.853566434
5981,295,77,24,15,0.001176471,756796,0.853593503
8261,280,170,24,15,0.001176471,756820,0.853620573
11617,689,295,24,15,0.001176471,756844,0.853647643
11783,596,409,24,15,0.001176471,756868,0.853674712
9039,224,646,24,15,0.001176471,756892,0.853701782
9139,605,131,24,15,0.001176471,756916,0.853728852
11117,544,347,24,15,0.001176471,756940,0.853755921
7088,14,295,24,15,0.001176471,756964,0.853782991
7109,307,367,24,15,0.001176471,756988,0.853810061
10473,56,497,24,15,0.001176471,757012,0.853837131
6433,383,331,24,15,0.001176471,757036,0.8538642
6702,593,394,24,15,0.001176471,757060,0.85389127
8000,11,588,24,15,0.001176471,757084,0.85391834
6566,632,313,24,15,0.001176471,757108,0.853945409
10180,582,85,24,15,0.001176471,757132,0.853972479
10506,164,131,23,15,0.001127451,757155,0.853998421
7525,529,354,23,15,0.001127451,757178,0.854024363
10413,20,26,23,15,0.001127451,757201,0.854050305
8894,164,219,23,15,0.001127451,757224,0.854076246
9721,204,689,23,15,0.001127451,757247,0.854102188
10419,43,689,23,15,0.001127451,757270,0.85412813
9283,535,708,23,15,0.001127451,757293,0.854154072
11821,1,207,23,15,0.001127451,757316,0.854180014
7592,313,29,23,15,0.001127451,757339,0.854205955
7591,558,156,23,15,0.001127451,757362,0.854231897
11628,56,307,23,15,0.001127451,757385,0.854257839
8304,586,302,23,15,0.001127451,757408,0.854283781
8201,493,27,23,15,0.001127451,757431,0.854309723
7483,544,311,23,15,0.001127451,757454,0.854335664
10590,313,508,23,15,0.001127451,757477,0.854361606
12482,130,618,23,15,0.001127451,757500,0.854387548
11159,163,596,23,15,0.001127451,757523,0.85441349
10638,140,498,23,15,0.001127451,757546,0.854439432
10626,543,204,23,15,0.001127451,757569,0.854465373
6522,632,123,23,15,0.001127451,757592,0.854491315
2841,307,80,23,15,0.001127451,757615,0.854517257
5859,11,236,23,15,0.001127451,757638,0.854543199
8179,25,141,23,15,0.001127451,757661,0.854569141
8608,397,6,23,15,0.001127451,757684,0.854595082
12816,334,347,23,15,0.001127451,757707,0.854621024
7869,310,204,23,15,0.001127451,757730,0.854646966
8691,43,475,23,15,0.001127451,757753,0.854672908
10319,224,605,23,15,0.001127451,757776,0.85469885
10833,195,204,23,15,0.001127451,757799,0.854724791
8630,463,145,23,15,0.001127451,757822,0.854750733
12944,552,544,23,15,0.001127451,757845,0.854776675
6921,50,123,23,15,0.001127451,757868,0.854802617
8729,224,29,23,15,0.001127451,757891,0.854828559
11940,20,624,23,15,0.001127451,757914,0.8548545
9548,596,196,23,15,0.001127451,757937,0.854880442
10383,43,295,23,15,0.001127451,757960,0.854906384
10656,334,522,22,15,0.001078431,757982,0.854931198
10214,48,501,22,15,0.001078431,758004,0.854956012
11043,27,290,22,15,0.001078431,758026,0.854980826
10846,5,30,22,15,0.001078431,758048,0.85500564
12175,68,569,22,15,0.001078431,758070,0.855030453
10125,473,22,22,15,0.001078431,758092,0.855055267
12206,123,514,22,15,0.001078431,758114,0.855080081
11175,529,522,22,15,0.001078431,758136,0.855104895
9681,393,141,22,15,0.001078431,758158,0.855129709
9949,674,587,22,15,0.001078431,758180,0.855154523
10771,219,723,22,15,0.001078431,758202,0.855179337
11434,164,397,22,15,0.001078431,758224,0.855204151
10037,117,397,22,15,0.001078431,758246,0.855228965
11076,224,4,22,15,0.001078431,758268,0.855253778
10375,2,663,22,15,0.001078431,758290,0.855278592
11936,34,529,22,15,0.001078431,758312,0.855303406
9983,471,535,22,15,0.001078431,758334,0.85532822
9724,558,250,22,15,0.001078431,758356,0.855353034
11265,10,126,22,15,0.001078431,758378,0.855377848
10003,274,596,22,15,0.001078431,758400,0.855402662
11770,29,708,22,15,0.001078431,758422,0.855427476
11611,5,10,22,15,0.001078431,758444,0.85545229
10519,367,204,22,15,0.001078431,758466,0.855477104
12317,155,558,22,15,0.001078431,758488,0.855501917
13507,105,181,22,15,0.001078431,758510,0.855526731
7947,6,586,22,15,0.001078431,758532,0.855551545
8906,398,473,22,15,0.001078431,758554,0.855576359
8810,427,123,22,15,0.001078431,758576,0.855601173
8280,280,6,22,15,0.001078431,758598,0.855625987
8364,314,181,22,15,0.001078431,758620,0.855650801
8381,56,479,22,15,0.001078431,758642,0.855675615
8386,353,714,22,15,0.001078431,758664,0.855700429
8012,655,302,22,15,0.001078431,758686,0.855725242
8042,535,117,22,15,0.001078431,758708,0.855750056
8068,274,473,22,15,0.001078431,758730,0.85577487
5413,379,243,22,15,0.001078431,758752,0.855799684
8194,335,156,22,15,0.001078431,758774,0.855824498
8219,123,632,22,15,0.001078431,758796,0.855849312
8998,473,167,22,15,0.001078431,758818,0.855874126
9068,479,26,22,15,0.001078431,758840,0.85589894
5866,95,354,22,15,0.001078431,758862,0.855923754
13314,719,33,22,15,0.001078431,758884,0.855948568
6892,219,334,22,15,0.001078431,758906,0.855973381
7009,379,439,22,15,0.001078431,758928,0.855998195
6727,12,9,22,15,0.001078431,758950,0.856023009
6789,498,145,22,15,0.001078431,758972,0.856047823
6479,532,588,22,15,0.001078431,758994,0.856072637
9035,353,528,22,15,0.001078431,759016,0.856097451
8208,609,114,21,15,0.001029412,759037,0.856121137
6503,473,560,21,15,0.001029412,759058,0.856144823
11030,56,348,21,15,0.001029412,759079,0.856168509
8088,674,274,21,15,0.001029412,759100,0.856192195
9898,11,479,21,15,0.001029412,759121,0.856215881
6381,397,117,21,15,0.001029412,759142,0.856239567
8084,295,498,21,15,0.001029412,759163,0.856263253
8163,535,4,21,15,0.001029412,759184,0.856286939
8241,31,463,21,15,0.001029412,759205,0.856310625
9600,219,170,21,15,0.001029412,759226,0.856334311
8495,158,638,21,15,0.001029412,759247,0.856357997
5397,4,107,21,15,0.001029412,759268,0.856381683
9558,385,16,21,15,0.001029412,759289,0.856405369
9533,68,140,21,15,0.001029412,759310,0.856429055
12839,479,4,21,15,0.001029412,759331,0.856452741
5908,32,529,21,15,0.001029412,759352,0.856476427
9775,498,31,21,15,0.001029412,759373,0.856500113
6227,4,473,21,15,0.001029412,759394,0.856523799
12580,443,4,21,15,0.001029412,759415,0.856547485
8348,32,242,21,15,0.001029412,759436,0.856571171
12592,34,632,21,15,0.001029412,759457,0.856594857
10795,708,34,21,15,0.001029412,759478,0.856618543
10514,596,56,21,15,0.001029412,759499,0.856642229
7528,393,313,21,15,0.001029412,759520,0.856665915
11495,354,30,21,15,0.001029412,759541,0.856689601
10453,347,97,21,15,0.001029412,759562,0.856713287
10452,34,544,21,15,0.001029412,759583,0.856736973
7455,56,114,21,15,0.001029412,759604,0.856760659
11522,632,34,21,15,0.001029412,759625,0.856784345
10730,463,14,21,15,0.001029412,759646,0.856808031
7163,674,614,21,15,0.001029412,759667,0.856831717
10702,347,48,21,15,0.001029412,759688,0.856855403
10675,33,404,21,15,0.001029412,759709,0.856879089
10763,552,141,21,15,0.001029412,759730,0.856902775
7372,475,33,21,15,0.001029412,759751,0.856926461
11525,20,155,21,15,0.001029412,759772,0.856950147
11921,230,126,21,15,0.001029412,759793,0.856973833
12041,274,562,21,15,0.001029412,759814,0.856997519
10225,558,427,21,15,0.001029412,759835,0.857021205
7907,605,331,21,15,0.001029412,759856,0.857044891
12232,243,588,21,15,0.001029412,759877,0.857068577
10981,558,552,21,15,0.001029412,759898,0.857092263
7998,529,230,21,15,0.001029412,759919,0.857115949
11330,140,26,21,15,0.001029412,759940,0.857139635
6576,640,663,21,15,0.001029412,759961,0.857163321
14705,471,618,21,15,0.001029412,759982,0.857187007
7819,398,498,21,15,0.001029412,760003,0.857210693
10359,314,43,21,15,0.001029412,760024,0.857234379
10357,130,126,21,15,0.001029412,760045,0.857258065
6828,347,479,21,15,0.001029412,760066,0.857281751
10332,295,243,21,15,0.001029412,760087,0.857305436
10273,646,367,21,15,0.001029412,760108,0.857329122
8932,30,34,21,15,0.001029412,760129,0.857352808
8920,34,543,21,15,0.001029412,760150,0.857376494
9258,596,638,21,15,0.001029412,760171,0.85740018
9191,174,196,21,15,0.001029412,760192,0.857423866
8703,310,614,21,15,0.001029412,760213,0.857447552
13405,328,463,21,15,0.001029412,760234,0.857471238
9049,250,313,21,15,0.001029412,760255,0.857494924
10646,156,302,20,15,0.000980392,760275,0.857517483
10002,274,463,20,15,0.000980392,760295,0.857540041
7247,335,261,20,15,0.000980392,760315,0.857562599
11656,236,383,20,15,0.000980392,760335,0.857585157
7669,638,307,20,15,0.000980392,760355,0.857607715
14247,193,624,20,15,0.000980392,760375,0.857630273
9364,265,497,20,15,0.000980392,760395,0.857652831
7316,242,380,20,15,0.000980392,760415,0.857675389
12357,204,126,20,15,0.000980392,760435,0.857697947
12406,280,593,20,15,0.000980392,760455,0.857720505
15210,552,618,20,15,0.000980392,760475,0.857743063
10398,463,397,20,15,0.000980392,760495,0.857765621
7140,529,141,20,15,0.000980392,760515,0.85778818
14030,219,508,20,15,0.000980392,760535,0.857810738
11045,280,414,20,15,0.000980392,760555,0.857833296
10585,250,385,20,15,0.000980392,760575,0.857855854
9876,117,335,20,15,0.000980392,760595,0.857878412
9390,335,140,20,15,0.000980392,760615,0.85790097
7203,543,638,20,15,0.000980392,760635,0.857923528
9393,463,348,20,15,0.000980392,760655,0.857946086
8223,6,543,20,15,0.000980392,760675,0.857968644
11203,158,242,20,15,0.000980392,760695,0.857991202
11741,310,274,20,15,0.000980392,760715,0.85801376
10268,517,6,20,15,0.000980392,760735,0.858036319
8911,10,85,20,15,0.000980392,760755,0.858058877
10160,264,498,20,15,0.000980392,760775,0.858081435
5027,9,511,20,15,0.000980392,760795,0.858103993
10154,307,77,20,15,0.000980392,760815,0.858126551
10140,22,529,20,15,0.000980392,760835,0.858149109
10127,43,68,20,15,0.000980392,760855,0.858171667
7956,501,609,20,15,0.000980392,760875,0.858194225
13066,609,242,20,15,0.000980392,760895,0.858216783
9308,473,661,20,15,0.000980392,760915,0.858239341
5462,682,314,20,15,0.000980392,760935,0.858261899
5885,11,123,20,15,0.000980392,760955,0.858284457
10223,353,708,20,15,0.000980392,760975,0.858307016
10584,131,242,20,15,0.000980392,760995,0.858329574
10539,265,131,20,15,0.000980392,761015,0.858352132
10056,56,264,20,15,0.000980392,761035,0.85837469
7027,274,331,20,15,0.000980392,761055,0.858397248
10048,204,1,20,15,0.000980392,761075,0.858419806
8031,380,164,20,15,0.000980392,761095,0.858442364
11787,498,605,20,15,0.000980392,761115,0.858464922
7508,544,473,20,15,0.000980392,761135,0.85848748
10103,443,562,20,15,0.000980392,761155,0.858510038
11803,295,126,20,15,0.000980392,761175,0.858532596
10100,236,64,20,15,0.000980392,761195,0.858555155
17074,427,501,20,15,0.000980392,761215,0.858577713
15044,167,219,20,15,0.000980392,761235,0.858600271
13291,543,97,20,15,0.000980392,761255,0.858622829
10528,314,103,20,15,0.000980392,761275,0.858645387
10529,331,167,20,15,0.000980392,761295,0.858667945
10857,596,543,20,15,0.000980392,761315,0.858690503
6601,394,131,20,15,0.000980392,761335,0.858713061
10877,84,409,20,15,0.000980392,761355,0.858735619
13716,131,121,20,15,0.000980392,761375,0.858758177
9536,708,463,20,15,0.000980392,761395,0.858780735
8402,274,302,20,15,0.000980392,761415,0.858803293
10929,243,348,20,15,0.000980392,761435,0.858825852
9475,11,50,20,15,0.000980392,761455,0.85884841
8388,224,683,20,15,0.000980392,761475,0.858870968
11456,230,646,20,15,0.000980392,761495,0.858893526
11423,95,280,20,15,0.000980392,761515,0.858916084
8429,5,224,20,15,0.000980392,761535,0.858938642
10827,32,364,20,15,0.000980392,761555,0.8589612
9560,618,219,20,15,0.000980392,761575,0.858983758
10891,236,517,20,15,0.000980392,761595,0.859006316
8530,614,274,20,15,0.000980392,761615,0.859028874
5858,307,379,20,15,0.000980392,761635,0.859051432
11329,393,25,20,15,0.000980392,761655,0.859073991
13176,458,32,20,15,0.000980392,761675,0.859096549
5711,4,394,20,15,0.000980392,761695,0.859119107
11395,397,204,20,15,0.000980392,761715,0.859141665
9729,265,10,20,15,0.000980392,761735,0.859164223
11472,380,503,20,15,0.000980392,761755,0.859186781
12319,614,414,19,15,0.000931373,761774,0.859208211
15842,121,588,19,15,0.000931373,761793,0.859229641
10873,517,663,19,15,0.000931373,761812,0.859251072
13338,236,409,19,15,0.000931373,761831,0.859272502
6151,145,6,19,15,0.000931373,761850,0.859293932
10142,224,328,19,15,0.000931373,761869,0.859315362
15031,48,613,19,15,0.000931373,761888,0.859336792
10094,328,535,19,15,0.000931373,761907,0.859358222
10060,507,314,19,15,0.000931373,761926,0.859379653
10089,307,655,19,15,0.000931373,761945,0.859401083
11239,502,501,19,15,0.000931373,761964,0.859422513
9018,532,163,19,15,0.000931373,761983,0.859443943
13035,130,54,19,15,0.000931373,762002,0.859465373
13445,331,90,19,15,0.000931373,762021,0.859486804
10113,56,529,19,15,0.000931373,762040,0.859508234
10116,501,463,19,15,0.000931373,762059,0.859529664
8679,544,9,19,15,0.000931373,762078,0.859551094
10538,514,250,19,15,0.000931373,762097,0.859572524
5132,9,605,19,15,0.000931373,762116,0.859593954
13515,48,294,19,15,0.000931373,762135,0.859615385
7659,655,11,19,15,0.000931373,762154,0.859636815
13767,130,552,19,15,0.000931373,762173,0.859658245
11922,22,380,19,15,0.000931373,762192,0.859679675
8605,398,414,19,15,0.000931373,762211,0.859701105
10933,492,230,19,15,0.000931373,762230,0.859722536
11906,517,31,19,15,0.000931373,762249,0.859743966
11973,171,367,19,15,0.000931373,762268,0.859765396
9483,498,471,19,15,0.000931373,762287,0.859786826
13235,663,5,19,15,0.000931373,762306,0.859808256
9294,12,123,19,15,0.000931373,762325,0.859829686
9297,30,97,19,15,0.000931373,762344,0.859851117
11157,638,632,19,15,0.000931373,762363,0.859872547
6711,33,141,19,15,0.000931373,762382,0.859893977
13556,224,383,19,15,0.000931373,762401,0.859915407
8901,638,97,19,15,0.000931373,762420,0.859936837
15749,348,207,19,15,0.000931373,762439,0.859958268
13055,588,22,19,15,0.000931373,762458,0.859979698
11248,130,155,19,15,0.000931373,762477,0.860001128
12139,302,126,19,15,0.000931373,762496,0.860022558
16003,64,348,19,15,0.000931373,762515,0.860043988
10217,123,2,19,15,0.000931373,762534,0.860065418
12127,230,587,19,15,0.000931373,762553,0.860086849
11259,174,167,19,15,0.000931373,762572,0.860108279
9184,95,708,19,15,0.000931373,762591,0.860129709
11500,114,398,19,15,0.000931373,762610,0.860151139
8428,265,397,19,15,0.000931373,762629,0.860172569
10748,230,605,19,15,0.000931373,762648,0.860194
9796,22,10,19,15,0.000931373,762667,0.86021543
6902,261,105,19,15,0.000931373,762686,0.86023686
13720,562,34,19,15,0.000931373,762705,0.86025829
9097,14,9,19,15,0.000931373,762724,0.86027972
9368,295,532,19,15,0.000931373,762743,0.86030115
11571,33,364,19,15,0.000931373,762762,0.860322581
9398,586,558,19,15,0.000931373,762781,0.860344011
14114,156,3,19,15,0.000931373,762800,0.860365441
7158,158,532,19,15,0.000931373,762819,0.860386871
9041,311,156,19,15,0.000931373,762838,0.860408301
11964,588,511,19,15,0.000931373,762857,0.860429732
12628,97,517,19,15,0.000931373,762876,0.860451162
8726,498,522,19,15,0.000931373,762895,0.860472592
8275,558,609,19,15,0.000931373,762914,0.860494022
9412,379,708,19,15,0.000931373,762933,0.860515452
8168,95,196,19,15,0.000931373,762952,0.860536882
14020,16,54,19,15,0.000931373,762971,0.860558313
9993,193,126,19,15,0.000931373,762990,0.860579743
9126,84,475,19,15,0.000931373,763009,0.860601173
8490,310,708,19,15,0.000931373,763028,0.860622603
8939,133,280,19,15,0.000931373,763047,0.860644033
15111,114,562,19,15,0.000931373,763066,0.860665464
12329,171,164,19,15,0.000931373,763085,0.860686894
8662,14,310,19,15,0.000931373,763104,0.860708324
12500,121,105,19,15,0.000931373,763123,0.860729754
8948,68,544,19,15,0.000931373,763142,0.860751184
15451,385,439,19,15,0.000931373,763161,0.860772614
13442,11,328,19,15,0.000931373,763180,0.860794045
9772,632,10,19,15,0.000931373,763199,0.860815475
11129,593,265,19,15,0.000931373,763218,0.860836905
9432,15,331,19,15,0.000931373,763237,0.860858335
13178,409,596,19,15,0.000931373,763256,0.860879765
10786,347,1,19,15,0.000931373,763275,0.860901196
10608,383,243,19,15,0.000931373,763294,0.860922626
8083,522,682,19,15,0.000931373,763313,0.860944056
13894,354,682,19,15,0.000931373,763332,0.860965486
9216,663,398,19,15,0.000931373,763351,0.860986916
7183,9,682,19,15,0.000931373,763370,0.861008346
6193,655,331,19,15,0.000931373,763389,0.861029777
7177,562,655,18,15,0.000882353,763407,0.861050079
7615,605,394,18,15,0.000882353,763425,0.861070381
15494,380,13,18,15,0.000882353,763443,0.861090684
10716,353,4,18,15,0.000882353,763461,0.861110986
6450,689,379,18,15,0.000882353,763479,0.861131288
7072,562,302,18,15,0.000882353,763497,0.86115159
10931,43,367,18,15,0.000882353,763515,0.861171893
11952,48,1,18,15,0.000882353,763533,0.861192195
13094,311,140,18,15,0.000882353,763551,0.861212497
10959,133,311,18,15,0.000882353,763569,0.861232799
8984,353,682,18,15,0.000882353,763587,0.861253102
15035,64,32,18,15,0.000882353,763605,0.861273404
10618,331,508,18,15,0.000882353,763623,0.861293706
13129,385,646,18,15,0.000882353,763641,0.861314009
10839,347,331,18,15,0.000882353,763659,0.861334311
8935,668,473,18,15,0.000882353,763677,0.861354613
11016,674,609,18,15,0.000882353,763695,0.861374915
7416,544,295,18,15,0.000882353,763713,0.861395218
10552,20,311,18,15,0.000882353,763731,0.86141552
7340,313,514,18,15,0.000882353,763749,0.861435822
8950,544,331,18,15,0.000882353,763767,0.861456125
10688,97,334,18,15,0.000882353,763785,0.861476427
10428,158,674,18,15,0.000882353,763803,0.861496729
11878,632,367,18,15,0.000882353,763821,0.861517031
7199,640,443,18,15,0.000882353,763839,0.861537334
10424,689,145,18,15,0.000882353,763857,0.861557636
11432,314,13,18,15,0.000882353,763875,0.861577938
10902,614,242,18,15,0.000882353,763893,0.86159824
8965,10,683,18,15,0.000882353,763911,0.861618543
10673,204,313,18,15,0.000882353,763929,0.861638845
6587,4,443,18,15,0.000882353,763947,0.861659147
11855,596,482,18,15,0.000882353,763965,0.86167945
11649,367,364,18,15,0.000882353,763983,0.861699752
8117,84,479,18,15,0.000882353,764001,0.861720054
11241,532,332,18,15,0.000882353,764019,0.861740356
13655,131,56,18,15,0.000882353,764037,0.861760659
8697,80,714,18,15,0.000882353,764055,0.861780961
12727,517,10,18,15,0.000882353,764073,0.861801263
9443,385,114,18,15,0.000882353,764091,0.861821566
12374,33,502,18,15,0.000882353,764109,0.861841868
13707,511,6,18,15,0.000882353,764127,0.86186217
8074,331,30,18,15,0.000882353,764145,0.861882472
12924,414,347,18,15,0.000882353,764163,0.861902775
8681,614,95,18,15,0.000882353,764181,0.861923077
13027,354,514,18,15,0.000882353,764199,0.861943379
9672,588,560,18,15,0.000882353,764217,0.861963681
13026,43,347,18,15,0.000882353,764235,0.861983984
11088,130,404,18,15,0.000882353,764253,0.862004286
10031,543,498,18,15,0.000882353,764271,0.862024588
12584,15,632,18,15,0.000882353,764289,0.862044891
12017,219,475,18,15,0.000882353,764307,0.862065193
16421,392,404,18,15,0.000882353,764325,0.862085495
11052,543,22,18,15,0.000882353,764343,0.862105797
9521,243,614,18,15,0.000882353,764361,0.8621261
12035,50,131,18,15,0.000882353,764379,0.862146402
10250,640,543,18,15,0.000882353,764397,0.862166704
12038,640,15,18,15,0.000882353,764415,0.862187007
11169,458,27,18,15,0.000882353,764433,0.862207309
8724,9,587,18,15,0.000882353,764451,0.862227611
9844,10,4,18,15,0.000882353,764469,0.862247913
11990,13,97,18,15,0.000882353,764487,0.862268216
9499,145,236,18,15,0.000882353,764505,0.862288518
9502,334,353,18,15,0.000882353,764523,0.86230882
12867,394,307,18,15,0.000882353,764541,0.862329122
7853,30,145,18,15,0.000882353,764559,0.862349425
8574,473,195,18,15,0.000882353,764577,0.862369727
5115,673,158,18,15,0.000882353,764595,0.862390029
11066,393,392,18,15,0.000882353,764613,0.862410332
14583,196,517,18,15,0.000882353,764631,0.862430634
17019,492,114,18,15,0.000882353,764649,0.862450936
10178,544,204,18,15,0.000882353,764667,0.862471238
7918,532,471,18,15,0.000882353,764685,0.862491541
9055,514,141,18,15,0.000882353,764703,0.862511843
12515,140,473,18,15,0.000882353,764721,0.862532145
13797,130,661,18,15,0.000882353,764739,0.862552448
9187,514,131,17,15,0.000833333,764756,0.862571622
11542,68,714,17,15,0.000833333,764773,0.862590796
15443,156,107,17,15,0.000833333,764790,0.862609971
9420,33,170,17,15,0.000833333,764807,0.862629145
14089,219,392,17,15,0.000833333,764824,0.862648319
10996,145,114,17,15,0.000833333,764841,0.862667494
16968,158,433,17,15,0.000833333,764858,0.862686668
12594,5,558,17,15,0.000833333,764875,0.862705843
12865,673,156,17,15,0.000833333,764892,0.862725017
8613,295,543,17,15,0.000833333,764909,0.862744191
9527,1,334,17,15,0.000833333,764926,0.862763366
13352,196,195,17,15,0.000833333,764943,0.86278254
18311,661,22,17,15,0.000833333,764960,0.862801714
9692,593,393,17,15,0.000833333,764977,0.862820889
9616,414,473,17,15,0.000833333,764994,0.862840063
9648,367,475,17,15,0.000833333,765011,0.862859238
15965,392,398,17,15,0.000833333,765028,0.862878412
12213,34,560,17,15,0.000833333,765045,0.862897586
11837,219,562,17,15,0.000833333,765062,0.862916761
10158,663,64,17,15,0.000833333,765079,0.862935935
8908,605,236,17,15,0.000833333,765096,0.862955109
12973,295,170,17,15,0.000833333,765113,0.862974284
12241,397,14,17,15,0.000833333,765130,0.862993458
8899,404,230,17,15,0.000833333,765147,0.863012633
9113,20,175,17,15,0.000833333,765164,0.863031807
12006,463,6,17,15,0.000833333,765181,0.863050981
14814,114,328,17,15,0.000833333,765198,0.863070156
9051,15,30,17,15,0.000833333,765215,0.86308933
7691,397,158,17,15,0.000833333,765232,0.863108504
12059,56,439,17,15,0.000833333,765249,0.863127679
10422,196,2,17,15,0.000833333,765266,0.863146853
11058,502,107,17,15,0.000833333,765283,0.863166028
9265,494,27,17,15,0.000833333,765300,0.863185202
10236,219,121,17,15,0.000833333,765317,0.863204376
7618,264,243,17,15,0.000833333,765334,0.863223551
12029,171,30,17,15,0.000833333,765351,0.863242725
10343,164,380,17,15,0.000833333,765368,0.863261899
12997,614,34,17,15,0.000833333,765385,0.863281074
11313,158,15,17,15,0.000833333,765402,0.863300248
12313,528,535,17,15,0.000833333,765419,0.863319423
12394,463,2,17,15,0.000833333,765436,0.863338597
11003,196,443,17,15,0.000833333,765453,0.863357771
11705,624,204,17,15,0.000833333,765470,0.863376946
13315,348,22,17,15,0.000833333,765487,0.86339612
11737,34,126,17,15,0.000833333,765504,0.863415294
10571,250,25,17,15,0.000833333,765521,0.863434469
13592,394,493,17,15,0.000833333,765538,0.863453643
11755,264,331,17,15,0.000833333,765555,0.863472818
7386,25,314,17,15,0.000833333,765572,0.863491992
6486,15,158,17,15,0.000833333,765589,0.863511166
8019,708,105,17,15,0.000833333,765606,0.863530341
11777,43,708,17,15,0.000833333,765623,0.863549515
16465,552,5,16,15,0.000784314,765639,0.863567561
11188,107,2,16,15,0.000784314,765655,0.863585608
15927,130,624,16,15,0.000784314,765671,0.863603654
16553,354,446,16,15,0.000784314,765687,0.863621701
12391,398,558,16,15,0.000784314,765703,0.863639747
12699,498,439,16,15,0.000784314,765719,0.863657794
12763,674,54,16,15,0.000784314,765735,0.86367584
12812,43,14,16,15,0.000784314,765751,0.863693887
14060,632,114,16,15,0.000784314,765767,0.863711933
12911,50,236,16,15,0.000784314,765783,0.86372998
11696,354,25,16,15,0.000784314,765799,0.863748026
13202,250,475,16,15,0.000784314,765815,0.863766073
11448,30,13,16,15,0.000784314,765831,0.863784119
11988,243,22,16,15,0.000784314,765847,0.863802166
14787,77,290,16,15,0.000784314,765863,0.863820212
12065,310,29,16,15,0.000784314,765879,0.863838259
12090,20,22,16,15,0.000784314,765895,0.863856305
13084,13,10,16,15,0.000784314,765911,0.863874351
13103,632,674,16,15,0.000784314,765927,0.863892398
10484,3,632,16,15,0.000784314,765943,0.863910444
7893,280,535,16,15,0.000784314,765959,0.863928491
9494,394,95,16,15,0.000784314,765975,0.863946537
9612,307,463,16,15,0.000784314,765991,0.863964584
9556,558,501,16,15,0.000784314,766007,0.86398263
10687,632,663,16,15,0.000784314,766023,0.864000677
8421,593,582,16,15,0.000784314,766039,0.864018723
8564,196,64,16,15,0.000784314,766055,0.86403677
10676,385,219,16,15,0.000784314,766071,0.864054816
8079,394,385,16,15,0.000784314,766087,0.864072863
10658,3,30,16,15,0.000784314,766103,0.864090909
9937,439,473,16,15,0.000784314,766119,0.864108956
10308,219,164,16,15,0.000784314,766135,0.864127002
6125,313,385,16,15,0.000784314,766151,0.864145048
10022,532,543,16,15,0.000784314,766167,0.864163095
11084,163,532,16,15,0.000784314,766183,0.864181141
4558,689,80,16,15,0.000784314,766199,0.864199188
10014,97,204,16,15,0.000784314,766215,0.864217234
10172,663,56,16,15,0.000784314,766231,0.864235281
13214,398,439,15,15,0.000735294,766246,0.864252199
10063,20,475,15,15,0.000735294,766261,0.864269118
19360,503,508,15,15,0.000735294,766276,0.864286037
10334,582,409,15,15,0.000735294,766291,0.864302955
11974,552,34,15,15,0.000735294,766306,0.864319874
12837,552,22,15,15,0.000735294,766321,0.864336792
13056,314,23,15,15,0.000735294,766336,0.864353711
19782,114,493,15,15,0.000735294,766351,0.864370629
12463,107,54,15,15,0.000735294,766366,0.864387548
7429,393,219,15,15,0.000735294,766381,0.864404467
16029,427,26,15,15,0.000735294,766396,0.864421385
11114,479,544,15,15,0.000735294,766411,0.864438304
14012,364,84,15,15,0.000735294,766426,0.864455222
13824,414,646,15,15,0.000735294,766441,0.864472141
11541,156,552,15,15,0.000735294,766456,0.864489059
8676,313,103,29,14,0.001421569,766485,0.864521769
8121,77,508,29,14,0.001421569,766514,0.864554478
8260,34,313,28,14,0.001372549,766542,0.864586059
13981,463,673,28,14,0.001372549,766570,0.86461764
14127,463,207,27,14,0.001323529,766597,0.864648094
4983,596,145,27,14,0.001323529,766624,0.864678547
7069,26,33,27,14,0.001323529,766651,0.864709001
7602,204,26,26,14,0.00127451,766677,0.864738326
7336,219,107,26,14,0.00127451,766703,0.864767652
9537,498,274,25,14,0.00122549,766728,0.864795849
9210,475,689,25,14,0.00122549,766753,0.864824047
9944,15,307,25,14,0.00122549,766778,0.864852245
7653,638,353,25,14,0.00122549,766803,0.864880442
9834,30,367,25,14,0.00122549,766828,0.86490864
12488,15,397,25,14,0.00122549,766853,0.864936837
8216,379,502,25,14,0.00122549,766878,0.864965035
10870,27,178,25,14,0.00122549,766903,0.864993233
11050,463,614,24,14,0.001176471,766927,0.865020302
7378,673,522,24,14,0.001176471,766951,0.865047372
13023,348,364,24,14,0.001176471,766975,0.865074442
10369,380,12,24,14,0.001176471,766999,0.865101511
6016,501,264,24,14,0.001176471,767023,0.865128581
6545,43,15,24,14,0.001176471,767047,0.865155651
4381,4,16,23,14,0.001127451,767070,0.865181593
9331,475,708,23,14,0.001127451,767093,0.865207534
10518,22,123,23,14,0.001127451,767116,0.865233476
8831,243,522,23,14,0.001127451,767139,0.865259418
13067,85,380,23,14,0.001127451,767162,0.86528536
12425,632,640,23,14,0.001127451,767185,0.865311302
10971,596,204,23,14,0.001127451,767208,0.865337243
10336,30,141,23,14,0.001127451,767231,0.865363185
9606,535,145,23,14,0.001127451,767254,0.865389127
11468,552,394,23,14,0.001127451,767277,0.865415069
6427,682,582,23,14,0.001127451,767300,0.865441011
8459,2,196,23,14,0.001127451,767323,0.865466952
7667,97,331,23,14,0.001127451,767346,0.865492894
13792,236,126,23,14,0.001127451,767369,0.865518836
11234,335,155,23,14,0.001127451,767392,0.865544778
9173,22,170,22,14,0.001078431,767414,0.865569592
10645,219,689,22,14,0.001078431,767436,0.865594406
9800,68,682,22,14,0.001078431,767458,0.865619219
10206,535,475,22,14,0.001078431,767480,0.865644033
10737,682,280,22,14,0.001078431,767502,0.865668847
10944,196,596,22,14,0.001078431,767524,0.865693661
12905,48,85,22,14,0.001078431,767546,0.865718475
9597,479,404,22,14,0.001078431,767568,0.865743289
10744,683,16,22,14,0.001078431,767590,0.865768103
10543,171,84,22,14,0.001078431,767612,0.865792917
10938,528,404,22,14,0.001078431,767634,0.865817731
13136,68,175,22,14,0.001078431,767656,0.865842545
10542,68,587,22,14,0.001078431,767678,0.865867358
13551,15,164,22,14,0.001078431,767700,0.865892172
7252,379,15,22,14,0.001078431,767722,0.865916986
7309,640,10,22,14,0.001078431,767744,0.8659418
7384,640,367,22,14,0.001078431,767766,0.865966614
7578,655,502,22,14,0.001078431,767788,0.865991428
7585,614,674,22,14,0.001078431,767810,0.866016242
8312,3,34,22,14,0.001078431,767832,0.866041056
8622,535,307,22,14,0.001078431,767854,0.86606587
8061,95,14,22,14,0.001078431,767876,0.866090684
8235,618,582,22,14,0.001078431,767898,0.866115497
3494,497,80,22,14,0.001078431,767920,0.866140311
6357,9,4,22,14,0.001078431,767942,0.866165125
6610,640,471,22,14,0.001078431,767964,0.866189939
8233,498,170,21,14,0.001029412,767985,0.866213625
9832,13,105,21,14,0.001029412,768006,0.866237311
8137,95,97,21,14,0.001029412,768027,0.866260997
5968,582,502,21,14,0.001029412,768048,0.866284683
9881,535,502,21,14,0.001029412,768069,0.866308369
8485,219,3,21,14,0.001029412,768090,0.866332055
8481,522,264,21,14,0.001029412,768111,0.866355741
6123,721,529,21,14,0.001029412,768132,0.866379427
8621,614,514,21,14,0.001029412,768153,0.866403113
12548,673,517,21,14,0.001029412,768174,0.866426799
6019,6,56,21,14,0.001029412,768195,0.866450485
9740,311,508,21,14,0.001029412,768216,0.866474171
8377,532,196,21,14,0.001029412,768237,0.866497857
11216,328,6,21,14,0.001029412,768258,0.866521543
7489,393,264,21,14,0.001029412,768279,0.866545229
6969,558,393,21,14,0.001029412,768300,0.866568915
11831,13,310,21,14,0.001029412,768321,0.866592601
11844,544,674,21,14,0.001029412,768342,0.866616287
11514,219,25,21,14,0.001029412,768363,0.866639973
10457,501,15,21,14,0.001029412,768384,0.866663659
10454,34,84,21,14,0.001029412,768405,0.866687345
11609,204,155,21,14,0.001029412,768426,0.866711031
11610,404,243,21,14,0.001029412,768447,0.866734717
10615,156,463,21,14,0.001029412,768468,0.866758403
12128,443,269,21,14,0.001029412,768489,0.866782089
7922,274,265,21,14,0.001029412,768510,0.866805775
11592,479,414,21,14,0.001029412,768531,0.866829461
7996,295,11,21,14,0.001029412,768552,0.866853147
12296,171,195,21,14,0.001029412,768573,0.866876833
10995,596,439,21,14,0.001029412,768594,0.866900519
11930,471,398,21,14,0.001029412,768615,0.866924205
11975,492,335,21,14,0.001029412,768636,0.866947891
10323,114,243,21,14,0.001029412,768657,0.866971577
3088,544,80,21,14,0.001029412,768678,0.866995263
12004,236,508,21,14,0.001029412,768699,0.867018949
8828,95,34,21,14,0.001029412,768720,0.867042635
9340,33,56,21,14,0.001029412,768741,0.867066321
9240,14,230,21,14,0.001029412,768762,0.867090007
8686,156,9,21,14,0.001029412,768783,0.867113693
9169,443,23,21,14,0.001029412,768804,0.867137379
9040,439,224,21,14,0.001029412,768825,0.867161065
8779,265,514,21,14,0.001029412,768846,0.867184751
8875,1,331,21,14,0.001029412,768867,0.867208437
11689,354,170,20,14,0.000980392,768887,0.867230995
12440,207,310,20,14,0.000980392,768907,0.867253553
9899,14,302,20,14,0.000980392,768927,0.867276111
9372,236,511,20,14,0.000980392,768947,0.867298669
8110,558,196,20,14,0.000980392,768967,0.867321227
11097,532,414,20,14,0.000980392,768987,0.867343785
9956,56,295,20,14,0.000980392,769007,0.867366343
10633,5,1,20,14,0.000980392,769027,0.867388901
11577,22,522,20,14,0.000980392,769047,0.86741146
4355,383,380,20,14,0.000980392,769067,0.867434018
9776,689,367,20,14,0.000980392,769087,0.867456576
9769,673,250,20,14,0.000980392,769107,0.867479134
13649,535,54,20,14,0.000980392,769127,0.867501692
14098,48,207,20,14,0.000980392,769147,0.86752425
9823,6,614,20,14,0.000980392,769167,0.867546808
7911,123,30,20,14,0.000980392,769187,0.867569366
11028,588,552,20,14,0.000980392,769207,0.867591924
10145,596,307,20,14,0.000980392,769227,0.867614482
7946,12,311,20,14,0.000980392,769247,0.86763704
11920,331,126,20,14,0.000980392,769267,0.867659598
11870,50,347,20,14,0.000980392,769287,0.867682157
12138,364,105,20,14,0.000980392,769307,0.867704715
10496,334,32,20,14,0.000980392,769327,0.867727273
10289,14,145,20,14,0.000980392,769347,0.867749831
7447,632,479,20,14,0.000980392,769367,0.867772389
14378,427,130,20,14,0.000980392,769387,0.867794947
7414,311,246,20,14,0.000980392,769407,0.867817505
10042,586,385,20,14,0.000980392,769427,0.867840063
10575,558,2,20,14,0.000980392,769447,0.867862621
10255,84,544,20,14,0.000980392,769467,0.867885179
9232,479,586,20,14,0.000980392,769487,0.867907737
7993,544,230,20,14,0.000980392,769507,0.867930296
6483,532,313,20,14,0.000980392,769527,0.867952854
11793,517,529,20,14,0.000980392,769547,0.867975412
9541,145,638,20,14,0.000980392,769567,0.86799797
12929,130,5,20,14,0.000980392,769587,0.868020528
11344,155,14,20,14,0.000980392,769607,0.868043086
9714,397,502,20,14,0.000980392,769627,0.868065644
11398,353,544,20,14,0.000980392,769647,0.868088202
11172,80,587,20,14,0.000980392,769667,0.86811076
11420,439,10,20,14,0.000980392,769687,0.868133318
8522,614,463,20,14,0.000980392,769707,0.868155876
10813,178,348,20,14,0.000980392,769727,0.868178434
10836,50,302,20,14,0.000980392,769747,0.868200993
8667,10,511,20,14,0.000980392,769767,0.868223551
8655,632,174,20,14,0.000980392,769787,0.868246109
8995,311,514,20,14,0.000980392,769807,0.868268667
8657,609,385,20,14,0.000980392,769827,0.868291225
6161,10,264,20,14,0.000980392,769847,0.868313783
5298,640,313,20,14,0.000980392,769867,0.868336341
12221,409,310,19,14,0.000931373,769886,0.868357771
8547,683,105,19,14,0.000931373,769905,0.868379201
8548,614,663,19,14,0.000931373,769924,0.868400632
10137,414,48,19,14,0.000931373,769943,0.868422062
7939,156,543,19,14,0.000931373,769962,0.868443492
9459,558,50,19,14,0.000931373,769981,0.868464922
9063,50,588,19,14,0.000931373,770000,0.868486352
7498,313,25,19,14,0.000931373,770019,0.868507783
7497,264,84,19,14,0.000931373,770038,0.868529213
7971,674,475,19,14,0.000931373,770057,0.868550643
11486,404,558,19,14,0.000931373,770076,0.868572073
8502,446,6,19,14,0.000931373,770095,0.868593503
3951,9,30,19,14,0.000931373,770114,0.868614933
9298,475,219,19,14,0.000931373,770133,0.868636364
13330,593,528,19,14,0.000931373,770152,0.868657794
7652,48,535,19,14,0.000931373,770171,0.868679224
12832,236,507,19,14,0.000931373,770190,0.868700654
10384,682,367,19,14,0.000931373,770209,0.868722084
13778,43,632,19,14,0.000931373,770228,0.868743515
7638,492,80,19,14,0.000931373,770247,0.868764945
13498,397,409,19,14,0.000931373,770266,0.868786375
11918,348,503,19,14,0.000931373,770285,0.868807805
13120,34,250,19,14,0.000931373,770304,0.868829235
11980,397,517,19,14,0.000931373,770323,0.868850665
10361,158,394,19,14,0.000931373,770342,0.868872096
7673,311,20,19,14,0.000931373,770361,0.868893526
9305,331,632,19,14,0.000931373,770380,0.868914956
9320,196,663,19,14,0.000931373,770399,0.868936386
11029,130,195,19,14,0.000931373,770418,0.868957816
9251,114,48,19,14,0.000931373,770437,0.868979247
12171,219,167,19,14,0.000931373,770456,0.869000677
10462,588,126,19,14,0.000931373,770475,0.869022107
13351,34,618,19,14,0.000931373,770494,0.869043537
12769,552,164,19,14,0.000931373,770513,0.869064967
7889,295,84,19,14,0.000931373,770532,0.869086397
11887,721,224,19,14,0.000931373,770551,0.869107828
5219,528,314,19,14,0.000931373,770570,0.869129258
12060,347,367,19,14,0.000931373,770589,0.869150688
11341,68,181,19,14,0.000931373,770608,0.869172118
10344,348,121,19,14,0.000931373,770627,0.869193548
9394,3,529,19,14,0.000931373,770646,0.869214979
10655,2,145,19,14,0.000931373,770665,0.869236409
9836,535,97,19,14,0.000931373,770684,0.869257839
8135,394,114,19,14,0.000931373,770703,0.869279269
12401,250,242,19,14,0.000931373,770722,0.869300699
10994,219,97,19,14,0.000931373,770741,0.869322129
8106,397,364,19,14,0.000931373,770760,0.86934356
12556,596,364,19,14,0.000931373,770779,0.86936499
10758,588,264,19,14,0.000931373,770798,0.86938642
8755,164,9,19,14,0.000931373,770817,0.86940785
8752,280,543,19,14,0.000931373,770836,0.86942928
9206,5,313,19,14,0.000931373,770855,0.869450711
9723,398,48,19,14,0.000931373,770874,0.869472141
11678,11,295,19,14,0.000931373,770893,0.869493571
9694,674,250,19,14,0.000931373,770912,0.869515001
9887,501,614,19,14,0.000931373,770931,0.869536431
12462,535,56,19,14,0.000931373,770950,0.869557861
11108,394,514,19,14,0.000931373,770969,0.869579292
11588,26,348,19,14,0.000931373,770988,0.869600722
9909,414,522,19,14,0.000931373,771007,0.869622152
8688,219,307,19,14,0.000931373,771026,0.869643582
9640,497,236,19,14,0.000931373,771045,0.869665012
12348,334,663,19,14,0.000931373,771064,0.869686443
7035,302,30,19,14,0.000931373,771083,0.869707873
10588,347,204,19,14,0.000931373,771102,0.869729303
10705,529,385,19,14,0.000931373,771121,0.869750733
12355,114,3,19,14,0.000931373,771140,0.869772163
9763,588,164,19,14,0.000931373,771159,0.869793594
15578,269,501,19,14,0.000931373,771178,0.869815024
12608,394,392,19,14,0.000931373,771197,0.869836454
11013,11,114,19,14,0.000931373,771216,0.869857884
12663,219,155,19,14,0.000931373,771235,0.869879314
9011,43,6,19,14,0.000931373,771254,0.869900744
10614,80,364,19,14,0.000931373,771273,0.869922175
7206,682,9,19,14,0.000931373,771292,0.869943605
13143,171,280,19,14,0.000931373,771311,0.869965035
10624,310,528,19,14,0.000931373,771330,0.869986465
9389,498,295,19,14,0.000931373,771349,0.870007895
11602,19,27,19,14,0.000931373,771368,0.870029326
8478,383,84,19,14,0.000931373,771387,0.870050756
8408,497,335,19,14,0.000931373,771406,0.870072186
7623,689,331,18,14,0.000882353,771424,0.870092488
11905,243,714,18,14,0.000882353,771442,0.87011279
13266,646,250,18,14,0.000882353,771460,0.870133093
10355,552,655,18,14,0.000882353,771478,0.870153395
10362,32,507,18,14,0.000882353,771496,0.870173697
11544,48,364,18,14,0.000882353,771514,0.870194
10962,353,427,18,14,0.000882353,771532,0.870214302
10762,97,295,18,14,0.000882353,771550,0.870234604
10803,414,33,18,14,0.000882353,771568,0.870254906
10801,156,347,18,14,0.000882353,771586,0.870275209
10800,535,196,18,14,0.000882353,771604,0.870295511
10989,26,511,18,14,0.000882353,771622,0.870315813
10739,404,473,18,14,0.000882353,771640,0.870336115
13509,708,5,18,14,0.000882353,771658,0.870356418
9270,473,683,18,14,0.000882353,771676,0.87037672
11581,250,31,18,14,0.000882353,771694,0.870397022
15803,392,609,18,14,0.000882353,771712,0.870417325
6521,145,334,18,14,0.000882353,771730,0.870437627
10923,618,145,18,14,0.000882353,771748,0.870457929
6826,31,311,18,14,0.000882353,771766,0.870478231
9038,30,307,18,14,0.000882353,771784,0.870498534
7296,397,95,18,14,0.000882353,771802,0.870518836
11454,334,655,18,14,0.000882353,771820,0.870539138
10497,414,529,18,14,0.000882353,771838,0.870559441
10834,414,68,18,14,0.000882353,771856,0.870579743
6906,501,334,18,14,0.000882353,771874,0.870600045
10489,334,131,18,14,0.000882353,771892,0.870620347
11763,328,614,18,14,0.000882353,771910,0.87064065
10587,145,30,18,14,0.000882353,771928,0.870660952
7463,397,471,18,14,0.000882353,771946,0.870681254
7480,586,33,18,14,0.000882353,771964,0.870701557
11824,48,543,18,14,0.000882353,771982,0.870721859
10649,3,511,18,14,0.000882353,772000,0.870742161
11856,310,2,18,14,0.000882353,772018,0.870762463
10913,334,68,18,14,0.000882353,772036,0.870782766
6736,605,224,18,14,0.000882353,772054,0.870803068
11859,562,250,18,14,0.000882353,772072,0.87082337
13159,328,4,18,14,0.000882353,772090,0.870843672
11516,586,347,18,14,0.000882353,772108,0.870863975
15344,155,473,18,14,0.000882353,772126,0.870884277
13218,250,682,18,14,0.000882353,772144,0.870904579
9205,274,33,18,14,0.000882353,772162,0.870924882
7551,529,609,18,14,0.000882353,772180,0.870945184
10666,34,114,18,14,0.000882353,772198,0.870965486
7557,95,77,18,14,0.000882353,772216,0.870985788
10669,463,141,18,14,0.000882353,772234,0.871006091
10681,535,723,18,14,0.000882353,772252,0.871026393
12562,131,508,18,14,0.000882353,772270,0.871046695
14460,64,27,18,14,0.000882353,772288,0.871066998
12410,114,347,18,14,0.000882353,772306,0.8710873
13853,131,117,18,14,0.000882353,772324,0.871107602
10099,302,614,18,14,0.000882353,772342,0.871127904
12246,463,236,18,14,0.000882353,772360,0.871148207
7987,614,562,18,14,0.000882353,772378,0.871168509
9418,380,22,18,14,0.000882353,772396,0.871188811
9807,158,367,18,14,0.000882353,772414,0.871209113
12177,145,50,18,14,0.000882353,772432,0.871229416
7923,586,25,18,14,0.000882353,772450,0.871249718
8277,593,26,18,14,0.000882353,772468,0.87127002
9591,334,588,18,14,0.000882353,772486,0.871290323
9592,562,596,18,14,0.000882353,772504,0.871310625
8507,80,640,18,14,0.000882353,772522,0.871330927
8651,26,114,18,14,0.000882353,772540,0.871351229
13840,131,439,18,14,0.000882353,772558,0.871371532
10068,311,126,18,14,0.000882353,772576,0.871391834
8765,517,379,18,14,0.000882353,772594,0.871412136
9347,380,2,18,14,0.000882353,772612,0.871432439
8774,397,497,18,14,0.000882353,772630,0.871452741
13967,347,11,18,14,0.000882353,772648,0.871473043
12334,68,701,18,14,0.000882353,772666,0.871493345
4326,543,80,18,14,0.000882353,772684,0.871513648
12933,31,397,18,14,0.000882353,772702,0.87153395
9658,80,164,18,14,0.000882353,772720,0.871554252
8460,314,171,18,14,0.000882353,772738,0.871574554
11122,145,535,18,14,0.000882353,772756,0.871594857
9448,6,141,18,14,0.000882353,772774,0.871615159
8437,562,77,18,14,0.000882353,772792,0.871635461
8342,674,393,18,14,0.000882353,772810,0.871655764
10043,596,163,18,14,0.000882353,772828,0.871676066
9916,493,380,18,14,0.000882353,772846,0.871696368
5359,4,56,18,14,0.000882353,772864,0.87171667
9524,532,34,18,14,0.000882353,772882,0.871736973
12033,15,50,18,14,0.000882353,772900,0.871757275
12809,588,618,18,14,0.000882353,772918,0.871777577
10254,16,117,18,14,0.000882353,772936,0.87179788
9862,295,723,18,14,0.000882353,772954,0.871818182
10321,9,1,18,14,0.000882353,772972,0.871838484
11985,19,31,18,14,0.000882353,772990,0.871858786
11273,56,64,18,14,0.000882353,773008,0.871879089
7744,507,32,18,14,0.000882353,773026,0.871899391
10295,264,367,18,14,0.000882353,773044,0.871919693
12454,588,246,18,14,0.000882353,773062,0.871939995
13285,131,514,18,14,0.000882353,773080,0.871960298
12121,463,543,18,14,0.000882353,773098,0.8719806
9377,26,156,18,14,0.000882353,773116,0.872000902
8570,1,3,18,14,0.000882353,773134,0.872021205
8153,498,588,18,14,0.000882353,773152,0.872041507
9554,354,121,18,14,0.000882353,773170,0.872061809
8579,6,170,18,14,0.000882353,773188,0.872082111
12136,674,502,18,14,0.000882353,773206,0.872102414
13620,348,117,18,14,0.000882353,773224,0.872122716
9553,97,131,18,14,0.000882353,773242,0.872143018
10745,84,14,17,14,0.000833333,773259,0.872162193
15372,243,503,17,14,0.000833333,773276,0.872181367
8276,25,379,17,14,0.000833333,773293,0.872200541
8373,655,393,17,14,0.000833333,773310,0.872219716
11111,529,23,17,14,0.000833333,773327,0.87223889
10777,25,302,17,14,0.000833333,773344,0.872258065
11601,443,544,17,14,0.000833333,773361,0.872277239
14035,348,482,17,14,0.000833333,773378,0.872296413
9820,379,605,17,14,0.000833333,773395,0.872315588
13167,155,708,17,14,0.000833333,773412,0.872334762
9408,367,246,17,14,0.000833333,773429,0.872353936
11558,29,582,17,14,0.000833333,773446,0.872373111
9791,655,31,17,14,0.000833333,773463,0.872392285
12528,171,331,17,14,0.000833333,773480,0.87241146
13263,243,269,17,14,0.000833333,773497,0.872430634
9758,97,674,17,14,0.000833333,773514,0.872449808
12552,164,582,17,14,0.000833333,773531,0.872468983
8374,379,427,17,14,0.000833333,773548,0.872488157
11339,655,204,17,14,0.000833333,773565,0.872507331
12751,295,571,17,14,0.000833333,773582,0.872526506
10885,196,294,17,14,0.000833333,773599,0.87254568
8588,529,497,17,14,0.000833333,773616,0.872564855
12873,80,163,17,14,0.000833333,773633,0.872584029
10963,9,85,17,14,0.000833333,773650,0.872603203
11349,33,294,17,14,0.000833333,773667,0.872622378
12845,280,196,17,14,0.000833333,773684,0.872641552
13237,471,250,17,14,0.000833333,773701,0.872660726
13754,23,502,17,14,0.000833333,773718,0.872679901
12834,250,463,17,14,0.000833333,773735,0.872699075
12829,364,230,17,14,0.000833333,773752,0.872718249
8603,133,498,17,14,0.000833333,773769,0.872737424
8433,331,714,17,14,0.000833333,773786,0.872756598
3726,30,588,17,14,0.000833333,773803,0.872775773
13977,22,302,17,14,0.000833333,773820,0.872794947
9727,219,708,17,14,0.000833333,773837,0.872814121
9728,596,121,17,14,0.000833333,773854,0.872833296
11476,219,156,17,14,0.000833333,773871,0.87285247
12715,588,683,17,14,0.000833333,773888,0.872871644
11140,121,379,17,14,0.000833333,773905,0.872890819
11683,14,379,17,14,0.000833333,773922,0.872909993
10132,9,126,17,14,0.000833333,773939,0.872929168
10135,56,15,17,14,0.000833333,773956,0.872948342
15968,535,2,17,14,0.000833333,773973,0.872967516
7556,562,20,17,14,0.000833333,773990,0.872986691
12176,535,25,17,14,0.000833333,774007,0.873005865
7916,31,638,17,14,0.000833333,774024,0.873025039
10121,295,141,17,14,0.000833333,774041,0.873044214
12277,514,164,17,14,0.000833333,774058,0.873063388
11019,334,471,17,14,0.000833333,774075,0.873082563
10527,682,353,17,14,0.000833333,774092,0.873101737
10096,274,501,17,14,0.000833333,774109,0.873120911
12235,236,12,17,14,0.000833333,774126,0.873140086
10114,475,97,17,14,0.000833333,774143,0.87315926
7523,655,264,17,14,0.000833333,774160,0.873178434
10276,674,121,17,14,0.000833333,774177,0.873197609
7773,367,427,17,14,0.000833333,774194,0.873216783
14779,15,5,17,14,0.000833333,774211,0.873235958
11991,379,2,17,14,0.000833333,774228,0.873255132
11281,473,207,17,14,0.000833333,774245,0.873274306
5445,586,123,17,14,0.000833333,774262,0.873293481
11064,121,314,17,14,0.000833333,774279,0.873312655
11871,250,295,17,14,0.000833333,774296,0.873331829
12044,236,646,17,14,0.000833333,774313,0.873351004
10400,397,15,17,14,0.000833333,774330,0.873370178
13587,246,367,17,14,0.000833333,774347,0.873389353
8009,383,394,17,14,0.000833333,774364,0.873408527
10660,393,31,17,14,0.000833333,774381,0.873427701
10659,295,427,17,14,0.000833333,774398,0.873446876
8123,655,25,17,14,0.000833333,774415,0.87346605
9929,274,164,17,14,0.000833333,774432,0.873485224
11005,295,587,17,14,0.000833333,774449,0.873504399
9065,50,471,17,14,0.000833333,774466,0.873523573
4944,4,280,17,14,0.000833333,774483,0.873542748
13146,498,163,17,14,0.000833333,774500,0.873561922
13612,64,230,17,14,0.000833333,774517,0.873581096
13619,328,141,17,14,0.000833333,774534,0.873600271
11670,34,11,17,14,0.000833333,774551,0.873619445
15353,310,392,17,14,0.000833333,774568,0.873638619
8191,196,219,17,14,0.000833333,774585,0.873657794
9391,25,614,17,14,0.000833333,774602,0.873676968
9889,158,170,17,14,0.000833333,774619,0.873696143
8731,11,535,17,14,0.000833333,774636,0.873715317
14162,502,242,17,14,0.000833333,774653,0.873734491
9901,397,427,17,14,0.000833333,774670,0.873753666
15253,347,446,17,14,0.000833333,774687,0.87377284
13624,383,242,17,14,0.000833333,774704,0.873792014
12447,552,347,17,14,0.000833333,774721,0.873811189
12359,171,723,17,14,0.000833333,774738,0.873830363
11093,56,121,17,14,0.000833333,774755,0.873849538
8942,242,236,17,14,0.000833333,774772,0.873868712
8017,414,535,17,14,0.000833333,774789,0.873887886
10047,103,105,17,14,0.000833333,774806,0.873907061
11776,15,11,17,14,0.000833333,774823,0.873926235
11735,196,508,17,14,0.000833333,774840,0.873945409
9962,501,348,17,14,0.000833333,774857,0.873964584
12383,596,269,17,14,0.000833333,774874,0.873983758
11717,43,10,17,14,0.000833333,774891,0.874002933
11252,22,274,16,14,0.000784314,774907,0.874020979
11197,502,393,16,14,0.000784314,774923,0.874039025
13602,347,29,16,14,0.000784314,774939,0.874057072
14227,11,14,16,14,0.000784314,774955,0.874075118
14132,54,394,16,14,0.000784314,774971,0.874093165
12529,497,397,16,14,0.000784314,774987,0.874111211
12716,596,5,16,14,0.000784314,775003,0.874129258
13724,11,196,16,14,0.000784314,775019,0.874147304
12875,280,552,16,14,0.000784314,775035,0.874165351
13774,121,16,16,14,0.000784314,775051,0.874183397
12835,56,689,16,14,0.000784314,775067,0.874201444
14066,204,25,16,14,0.000784314,775083,0.87421949
13903,50,439,16,14,0.000784314,775099,0.874237537
15423,171,632,16,14,0.000784314,775115,0.874255583
13412,48,414,16,14,0.000784314,775131,0.87427363
15331,348,714,16,14,0.000784314,775147,0.874291676
11665,588,446,16,14,0.000784314,775163,0.874309723
15200,502,347,16,14,0.000784314,775179,0.874327769
15146,207,463,16,14,0.000784314,775195,0.874345815
15099,544,393,16,14,0.000784314,775211,0.874363862
15763,522,261,16,14,0.000784314,775227,0.874381908
11406,114,558,16,14,0.000784314,775243,0.874399955
11493,532,475,16,14,0.000784314,775259,0.874418001
15480,473,13,16,14,0.000784314,775275,0.874436048
13378,618,640,16,14,0.000784314,775291,0.874454094
15086,20,529,16,14,0.000784314,775307,0.874472141
15069,5,219,16,14,0.000784314,775323,0.874490187
12015,588,20,16,14,0.000784314,775339,0.874508234
14704,354,164,16,14,0.000784314,775355,0.87452628
12049,684,224,16,14,0.000784314,775371,0.874544327
15051,250,261,16,14,0.000784314,775387,0.874562373
14976,471,517,16,14,0.000784314,775403,0.87458042
11962,479,364,16,14,0.000784314,775419,0.874598466
11874,261,224,16,14,0.000784314,775435,0.874616513
9473,514,274,16,14,0.000784314,775451,0.874634559
7908,274,394,16,14,0.000784314,775467,0.874652605
9292,25,311,16,14,0.000784314,775483,0.874670652
9268,609,265,16,14,0.000784314,775499,0.874688698
9231,501,663,16,14,0.000784314,775515,0.874706745
11018,588,294,16,14,0.000784314,775531,0.874724791
11015,439,9,16,14,0.000784314,775547,0.874742838
9627,2,334,16,14,0.000784314,775563,0.874760884
9535,708,380,16,14,0.000784314,775579,0.874778931
10451,668,558,16,14,0.000784314,775595,0.874796977
10784,30,508,16,14,0.000784314,775611,0.874815024
8807,15,723,16,14,0.000784314,775627,0.87483307
8418,250,414,16,14,0.000784314,775643,0.874851117
10759,443,682,16,14,0.000784314,775659,0.874869163
8881,95,3,16,14,0.000784314,775675,0.87488721
8486,532,511,16,14,0.000784314,775691,0.874905256
10610,532,479,16,14,0.000784314,775707,0.874923303
8063,532,48,16,14,0.000784314,775723,0.874941349
9140,105,155,16,14,0.000784314,775739,0.874959395
9137,302,130,16,14,0.000784314,775755,0.874977442
10862,331,156,16,14,0.000784314,775771,0.874995488
9017,398,588,16,14,0.000784314,775787,0.875013535
8988,632,353,16,14,0.000784314,775803,0.875031581
10790,638,114,16,14,0.000784314,775819,0.875049628
8634,593,379,16,14,0.000784314,775835,0.875067674
6473,609,473,16,14,0.000784314,775851,0.875085721
6513,123,614,16,14,0.000784314,775867,0.875103767
5130,655,9,16,14,0.000784314,775883,0.875121814
9846,605,354,16,14,0.000784314,775899,0.87513986
10237,313,587,16,14,0.000784314,775915,0.875157907
11096,171,532,16,14,0.000784314,775931,0.875175953
11151,614,427,16,14,0.000784314,775947,0.875194
5789,640,353,16,14,0.000784314,775963,0.875212046
9067,498,638,15,14,0.000735294,775978,0.875228965
9991,501,121,15,14,0.000735294,775993,0.875245883
10592,394,6,15,14,0.000735294,776008,0.875262802
13265,380,1,15,14,0.000735294,776023,0.87527972
12156,43,30,15,14,0.000735294,776038,0.875296639
13541,131,502,15,14,0.000735294,776053,0.875313557
11644,26,97,15,14,0.000735294,776068,0.875330476
8978,673,3,15,14,0.000735294,776083,0.875347395
10051,367,723,15,14,0.000735294,776098,0.875364313
10647,43,331,15,14,0.000735294,776113,0.875381232
8884,721,16,15,14,0.000735294,776128,0.87539815
11976,347,638,15,14,0.000735294,776143,0.875415069
12511,25,313,15,14,0.000735294,776158,0.875431987
10438,394,528,15,14,0.000735294,776173,0.875448906
9688,640,280,15,14,0.000735294,776188,0.875465824
11957,243,463,15,14,0.000735294,776203,0.875482743
12872,673,34,15,14,0.000735294,776218,0.875499662
11800,236,503,15,14,0.000735294,776233,0.87551658
10307,632,3,15,14,0.000735294,776248,0.875533499
9891,409,331,15,14,0.000735294,776263,0.875550417
7752,439,123,15,14,0.000735294,776278,0.875567336
11366,158,535,15,14,0.000735294,776293,0.875584254
7554,689,14,15,14,0.000735294,776308,0.875601173
15007,48,511,15,14,0.000735294,776323,0.875618092
7502,264,25,15,14,0.000735294,776338,0.87563501
7843,398,123,15,14,0.000735294,776353,0.875651929
8013,4,250,15,14,0.000735294,776368,0.875668847
7965,307,588,15,14,0.000735294,776383,0.875685766
18744,121,196,15,14,0.000735294,776398,0.875702684
11244,31,29,15,14,0.000735294,776413,0.875719603
11207,5,663,15,14,0.000735294,776428,0.875736522
16438,380,448,15,14,0.000735294,776443,0.87575344
15235,347,498,15,14,0.000735294,776458,0.875770359
15427,155,68,15,14,0.000735294,776473,0.875787277
7056,4,26,15,14,0.000735294,776488,0.875804196
11275,11,392,15,14,0.000735294,776503,0.875821114
15923,145,439,15,14,0.000735294,776518,0.875838033
10207,367,439,15,14,0.000735294,776533,0.875854952
10791,196,34,15,14,0.000735294,776548,0.87587187
10806,479,398,15,14,0.000735294,776563,0.875888789
11568,367,130,15,14,0.000735294,776578,0.875905707
13991,15,130,15,14,0.000735294,776593,0.875922626
10065,307,84,14,14,0.000686275,776607,0.875938416
16453,124,380,14,14,0.000686275,776621,0.875954207
17242,11,560,14,14,0.000686275,776635,0.875969998
16259,23,514,14,14,0.000686275,776649,0.875985788
13980,614,689,14,14,0.000686275,776663,0.876001579
12968,501,552,14,14,0.000686275,776677,0.87601737
14280,15,517,14,14,0.000686275,776691,0.87603316
15158,269,498,14,14,0.000686275,776705,0.876048951
12633,171,663,14,14,0.000686275,776719,0.876064742
14111,50,14,14,14,0.000686275,776733,0.876080532
11371,12,674,14,14,0.000686275,776747,0.876096323
10685,158,97,14,14,0.000686275,776761,0.876112114
10743,30,170,14,14,0.000686275,776775,0.876127904
10869,158,404,14,14,0.000686275,776789,0.876143695
11368,443,204,14,14,0.000686275,776803,0.876159486
7874,311,392,30,13,0.001470588,776833,0.876193323
9880,230,29,27,13,0.001323529,776860,0.876223776
10122,334,535,27,13,0.001323529,776887,0.87625423
9954,34,655,26,13,0.00127451,776913,0.876283555
9262,443,295,26,13,0.00127451,776939,0.876312881
10558,230,714,26,13,0.00127451,776965,0.876342206
11264,11,502,25,13,0.00122549,776990,0.876370404
9637,347,236,25,13,0.00122549,777015,0.876398601
6188,471,475,25,13,0.00122549,777040,0.876426799
10281,22,497,24,13,0.001176471,777064,0.876453869
10039,84,164,24,13,0.001176471,777088,0.876480938
10001,674,156,23,13,0.001127451,777111,0.87650688
13448,121,393,23,13,0.001127451,777134,0.876532822
10729,517,558,23,13,0.001127451,777157,0.876558764
11155,708,167,22,13,0.001078431,777179,0.876583578
9287,328,26,22,13,0.001078431,777201,0.876608392
11209,385,397,22,13,0.001078431,777223,0.876633206
11183,463,552,22,13,0.001078431,777245,0.876658019
8482,596,674,22,13,0.001078431,777267,0.876682833
8062,475,77,22,13,0.001078431,777289,0.876707647
8992,562,22,22,13,0.001078431,777311,0.876732461
6568,6,121,22,13,0.001078431,777333,0.876757275
9890,689,558,21,13,0.001029412,777354,0.876780961
9910,498,674,21,13,0.001029412,777375,0.876804647
9618,30,663,21,13,0.001029412,777396,0.876828333
9551,614,307,21,13,0.001029412,777417,0.876852019
9511,26,34,21,13,0.001029412,777438,0.876875705
12618,498,503,21,13,0.001029412,777459,0.876899391
8281,32,164,21,13,0.001029412,777480,0.876923077
7516,261,397,21,13,0.001029412,777501,0.876946763
6984,95,723,21,13,0.001029412,777522,0.876970449
11834,155,32,21,13,0.001029412,777543,0.876994135
10019,562,443,21,13,0.001029412,777564,0.877017821
10844,532,383,21,13,0.001029412,777585,0.877041507
11642,27,160,21,13,0.001029412,777606,0.877065193
10577,354,614,21,13,0.001029412,777627,0.877088879
7991,475,145,21,13,0.001029412,777648,0.877112565
8037,479,655,21,13,0.001029412,777669,0.877136251
7825,11,364,21,13,0.001029412,777690,0.877159937
10311,90,379,21,13,0.001029412,777711,0.877183623
9100,26,170,21,13,0.001029412,777732,0.877207309
13553,347,632,21,13,0.001029412,777753,0.877230995
9476,354,204,21,13,0.001029412,777774,0.877254681
10605,562,95,20,13,0.000980392,777794,0.877277239
7254,307,348,20,13,0.000980392,777814,0.877299797
14264,385,265,20,13,0.000980392,777834,0.877322355
7287,15,638,20,13,0.000980392,777854,0.877344913
11193,29,32,20,13,0.000980392,777874,0.877367471
7711,394,313,20,13,0.000980392,777894,0.877390029
8336,313,20,20,13,0.000980392,777914,0.877412587
9760,114,596,20,13,0.000980392,777934,0.877435145
9323,250,264,20,13,0.000980392,777954,0.877457704
10133,473,502,20,13,0.000980392,777974,0.877480262
10187,193,314,20,13,0.000980392,777994,0.87750282
11904,673,145,20,13,0.000980392,778014,0.877525378
7812,274,497,20,13,0.000980392,778034,0.877547936
12125,224,482,20,13,0.000980392,778054,0.877570494
12227,27,137,20,13,0.000980392,778074,0.877593052
10072,261,107,20,13,0.000980392,778094,0.87761561
10069,502,11,20,13,0.000980392,778114,0.877638168
8345,50,313,20,13,0.000980392,778134,0.877660726
8384,721,443,20,13,0.000980392,778154,0.877683284
8456,207,473,20,13,0.000980392,778174,0.877705843
12630,280,364,20,13,0.000980392,778194,0.877728401
9642,673,367,20,13,0.000980392,778214,0.877750959
11490,347,15,20,13,0.000980392,778234,0.877773517
10783,310,64,20,13,0.000980392,778254,0.877796075
9022,295,64,20,13,0.000980392,778274,0.877818633
8024,638,475,19,13,0.000931373,778293,0.877840063
15021,2,34,19,13,0.000931373,778312,0.877861493
9062,353,503,19,13,0.000931373,778331,0.877882924
11442,517,397,19,13,0.000931373,778350,0.877904354
11438,140,394,19,13,0.000931373,778369,0.877925784
12272,310,167,19,13,0.000931373,778388,0.877947214
11479,34,614,19,13,0.000931373,778407,0.877968644
10865,280,503,19,13,0.000931373,778426,0.877990074
10086,48,439,19,13,0.000931373,778445,0.878011505
11078,328,347,19,13,0.000931373,778464,0.878032935
9477,397,31,19,13,0.000931373,778483,0.878054365
10274,640,508,19,13,0.000931373,778502,0.878075795
13738,34,107,19,13,0.000931373,778521,0.878097225
11278,204,379,19,13,0.000931373,778540,0.878118656
11277,562,107,19,13,0.000931373,778559,0.878140086
8496,443,638,19,13,0.000931373,778578,0.878161516
7620,32,723,19,13,0.000931373,778597,0.878182946
12802,552,674,19,13,0.000931373,778616,0.878204376
12799,511,236,19,13,0.000931373,778635,0.878225806
12122,107,593,19,13,0.000931373,778654,0.878247237
9223,655,614,19,13,0.000931373,778673,0.878268667
9185,236,4,19,13,0.000931373,778692,0.878290097
11498,204,497,19,13,0.000931373,778711,0.878311527
8666,26,503,19,13,0.000931373,778730,0.878332957
11327,5,230,19,13,0.000931373,778749,0.878354388
9192,689,354,19,13,0.000931373,778768,0.878375818
9885,328,383,19,13,0.000931373,778787,0.878397248
11503,236,593,19,13,0.000931373,778806,0.878418678
6181,582,511,19,13,0.000931373,778825,0.878440108
7038,721,380,19,13,0.000931373,778844,0.878461538
9996,204,532,19,13,0.000931373,778863,0.878482969
9994,354,562,19,13,0.000931373,778882,0.878504399
10023,632,48,19,13,0.000931373,778901,0.878525829
8344,33,243,19,13,0.000931373,778920,0.878547259
12582,170,27,19,13,0.000931373,778939,0.878568689
11631,56,674,19,13,0.000931373,778958,0.87859012
9703,302,385,19,13,0.000931373,778977,0.87861155
11893,552,596,18,13,0.000882353,778995,0.878631852
11578,156,280,18,13,0.000882353,779013,0.878652154
6455,12,582,18,13,0.000882353,779031,0.878672457
11553,90,27,18,13,0.000882353,779049,0.878692759
15783,107,269,18,13,0.000882353,779067,0.878713061
13175,404,532,18,13,0.000882353,779085,0.878733363
10345,463,655,18,13,0.000882353,779103,0.878753666
11543,328,196,18,13,0.000882353,779121,0.878773968
10764,582,646,18,13,0.000882353,779139,0.87879427
7101,32,264,18,13,0.000882353,779157,0.878814573
10802,663,385,18,13,0.000882353,779175,0.878834875
10380,404,529,18,13,0.000882353,779193,0.878855177
11489,334,48,18,13,0.000882353,779211,0.878875479
8923,582,246,18,13,0.000882353,779229,0.878895782
6815,30,174,18,13,0.000882353,779247,0.878916084
11807,328,295,18,13,0.000882353,779265,0.878936386
10897,393,514,18,13,0.000882353,779283,0.878956688
10829,721,596,18,13,0.000882353,779301,0.878976991
9016,532,708,18,13,0.000882353,779319,0.878997293
11017,171,9,18,13,0.000882353,779337,0.879017595
9229,535,264,18,13,0.000882353,779355,0.879037898
10603,5,64,18,13,0.000882353,779373,0.8790582
6596,242,25,18,13,0.000882353,779391,0.879078502
6467,123,414,18,13,0.000882353,779409,0.879098804
13493,117,219,18,13,0.000882353,779427,0.879119107
10849,385,498,18,13,0.000882353,779445,0.879139409
11833,6,364,18,13,0.000882353,779463,0.879159711
10463,638,723,18,13,0.000882353,779481,0.879180014
10908,380,156,18,13,0.000882353,779499,0.879200316
11510,50,6,18,13,0.000882353,779517,0.879220618
12567,502,367,18,13,0.000882353,779535,0.87924092
9625,522,328,18,13,0.000882353,779553,0.879261223
8111,193,508,18,13,0.000882353,779571,0.879281525
12255,535,121,18,13,0.000882353,779589,0.879301827
6048,95,334,18,13,0.000882353,779607,0.879322129
14187,364,16,18,13,0.000882353,779625,0.879342432
8819,314,174,18,13,0.000882353,779643,0.879362734
10162,502,230,18,13,0.000882353,779661,0.879383036
7934,26,50,18,13,0.000882353,779679,0.879403339
12214,552,529,18,13,0.000882353,779697,0.879423641
13573,471,614,18,13,0.000882353,779715,0.879443943
9927,514,230,18,13,0.000882353,779733,0.879464245
9605,103,27,18,13,0.000882353,779751,0.879484548
8461,582,392,18,13,0.000882353,779769,0.87950485
12599,12,392,18,13,0.000882353,779787,0.879525152
8671,9,661,18,13,0.000882353,779805,0.879545455
12641,708,295,18,13,0.000882353,779823,0.879565757
11233,219,501,18,13,0.000882353,779841,0.879586059
12302,497,347,18,13,0.000882353,779859,0.879606361
9751,15,171,18,13,0.000882353,779877,0.879626664
8535,638,663,18,13,0.000882353,779895,0.879646966
12365,4,328,18,13,0.000882353,779913,0.879667268
7778,673,95,18,13,0.000882353,779931,0.87968757
9516,331,22,18,13,0.000882353,779949,0.879707873
9517,261,314,18,13,0.000882353,779967,0.879728175
7811,50,3,18,13,0.000882353,779985,0.879748477
14104,543,167,18,13,0.000882353,780003,0.87976878
12031,140,335,18,13,0.000882353,780021,0.879789082
12810,13,640,18,13,0.000882353,780039,0.879809384
9853,25,497,18,13,0.000882353,780057,0.879829686
12847,558,517,18,13,0.000882353,780075,0.879849989
12842,3,528,18,13,0.000882353,780093,0.879870291
9866,196,126,18,13,0.000882353,780111,0.879890593
10292,131,274,18,13,0.000882353,780129,0.879910896
9083,32,439,18,13,0.000882353,780147,0.879931198
13062,614,167,18,13,0.000882353,780165,0.8799515
5313,404,314,18,13,0.000882353,780183,0.879971802
8823,33,609,18,13,0.000882353,780201,0.879992105
8554,427,331,18,13,0.000882353,780219,0.880012407
13807,663,502,18,13,0.000882353,780237,0.880032709
11585,14,543,17,13,0.000833333,780254,0.880051884
10782,107,683,17,13,0.000833333,780271,0.880071058
12971,133,243,17,13,0.000833333,780288,0.880090232
13690,131,5,17,13,0.000833333,780305,0.880109407
9410,156,380,17,13,0.000833333,780322,0.880128581
7005,383,314,17,13,0.000833333,780339,0.880147755
9838,471,427,17,13,0.000833333,780356,0.88016693
14010,12,274,17,13,0.000833333,780373,0.880186104
8243,593,16,17,13,0.000833333,780390,0.880205279
8994,463,674,17,13,0.000833333,780407,0.880224453
10769,624,14,17,13,0.000833333,780424,0.880243627
9768,56,265,17,13,0.000833333,780441,0.880262802
9837,16,414,17,13,0.000833333,780458,0.880281976
10993,15,280,17,13,0.000833333,780475,0.88030115
7169,33,26,17,13,0.000833333,780492,0.880320325
7709,497,331,17,13,0.000833333,780509,0.880339499
13805,295,294,17,13,0.000833333,780526,0.880358674
11416,640,130,17,13,0.000833333,780543,0.880377848
9565,532,20,17,13,0.000833333,780560,0.880397022
11340,22,80,17,13,0.000833333,780577,0.880416197
15741,158,689,17,13,0.000833333,780594,0.880435371
9132,614,145,17,13,0.000833333,780611,0.880454545
9463,164,655,17,13,0.000833333,780628,0.88047372
16642,23,236,17,13,0.000833333,780645,0.880492894
11156,471,353,17,13,0.000833333,780662,0.880512069
5880,4,471,17,13,0.000833333,780679,0.880531243
13253,31,632,17,13,0.000833333,780696,0.880550417
9500,328,3,17,13,0.000833333,780713,0.880569592
8648,31,10,17,13,0.000833333,780730,0.880588766
9033,404,334,17,13,0.000833333,780747,0.88060794
9134,145,354,17,13,0.000833333,780764,0.880627115
11402,353,511,17,13,0.000833333,780781,0.880646289
13197,552,280,17,13,0.000833333,780798,0.880665464
8434,502,582,17,13,0.000833333,780815,0.880684638
12621,77,195,17,13,0.000833333,780832,0.880703812
9445,674,723,17,13,0.000833333,780849,0.880722987
9726,586,274,17,13,0.000833333,780866,0.880742161
9730,114,588,17,13,0.000833333,780883,0.880761335
15577,571,33,17,13,0.000833333,780900,0.88078051
12652,31,618,17,13,0.000833333,780917,0.880799684
9603,32,618,17,13,0.000833333,780934,0.880818859
12722,158,14,17,13,0.000833333,780951,0.880838033
6146,123,501,17,13,0.000833333,780968,0.880857207
6858,9,22,17,13,0.000833333,780985,0.880876382
11483,427,394,17,13,0.000833333,781002,0.880895556
13363,167,204,17,13,0.000833333,781019,0.88091473
14539,27,319,17,13,0.000833333,781036,0.880933905
11832,632,618,17,13,0.000833333,781053,0.880953079
8816,3,414,17,13,0.000833333,781070,0.880972254
10475,398,242,17,13,0.000833333,781087,0.880991428
11841,15,26,17,13,0.000833333,781104,0.881010602
10469,552,77,17,13,0.000833333,781121,0.881029777
14567,393,196,17,13,0.000833333,781138,0.881048951
13117,2,30,17,13,0.000833333,781155,0.881068125
11819,156,532,17,13,0.000833333,781172,0.8810873
15057,130,328,17,13,0.000833333,781189,0.881106474
10534,511,582,17,13,0.000833333,781206,0.881125649
10081,558,264,17,13,0.000833333,781223,0.881144823
11077,501,674,17,13,0.000833333,781240,0.881163997
9121,31,379,17,13,0.000833333,781257,0.881183172
10510,131,126,17,13,0.000833333,781274,0.881202346
8808,26,638,17,13,0.000833333,781291,0.88122152
11812,204,130,17,13,0.000833333,781308,0.881240695
7597,414,586,17,13,0.000833333,781325,0.881259869
10443,117,588,17,13,0.000833333,781342,0.881279044
10055,517,15,17,13,0.000833333,781359,0.881298218
8842,302,250,17,13,0.000833333,781376,0.881317392
10381,33,250,17,13,0.000833333,781393,0.881336567
14818,64,48,17,13,0.000833333,781410,0.881355741
7685,689,48,17,13,0.000833333,781427,0.881374915
7732,640,48,17,13,0.000833333,781444,0.88139409
8862,250,655,17,13,0.000833333,781461,0.881413264
13521,663,54,17,13,0.000833333,781478,0.881432439
7872,353,638,17,13,0.000833333,781495,0.881451613
11875,84,85,17,13,0.000833333,781512,0.881470787
10224,242,443,17,13,0.000833333,781529,0.881489962
11883,558,171,17,13,0.000833333,781546,0.881509136
16101,354,167,17,13,0.000833333,781563,0.88152831
10252,117,16,17,13,0.000833333,781580,0.881547485
14908,535,552,17,13,0.000833333,781597,0.881566659
9936,497,32,17,13,0.000833333,781614,0.881585834
12432,475,1,17,13,0.000833333,781631,0.881605008
9941,50,77,17,13,0.000833333,781648,0.881624182
9103,97,6,17,13,0.000833333,781665,0.881643357
7279,274,264,17,13,0.000833333,781682,0.881662531
9102,34,479,17,13,0.000833333,781699,0.881681705
10661,674,683,17,13,0.000833333,781716,0.88170088
9868,242,131,17,13,0.000833333,781733,0.881720054
8172,517,295,17,13,0.000833333,781750,0.881739229
12459,614,97,17,13,0.000833333,781767,0.881758403
10683,514,11,17,13,0.000833333,781784,0.881777577
8740,682,32,17,13,0.000833333,781801,0.881796752
9903,475,638,17,13,0.000833333,781818,0.881815926
15168,196,701,17,13,0.000833333,781835,0.8818351
11218,398,663,17,13,0.000833333,781852,0.881854275
8064,243,302,17,13,0.000833333,781869,0.881873449
14367,155,348,17,13,0.000833333,781886,0.881892624
9226,353,156,17,13,0.000833333,781903,0.881911798
11732,314,155,17,13,0.000833333,781920,0.881930972
12366,242,23,17,13,0.000833333,781937,0.881950147
8760,307,158,17,13,0.000833333,781954,0.881969321
12371,13,131,17,13,0.000833333,781971,0.881988495
9044,26,479,17,13,0.000833333,781988,0.88200767
8647,123,117,17,13,0.000833333,782005,0.882026844
11726,261,250,17,13,0.000833333,782022,0.882046018
13014,193,723,17,13,0.000833333,782039,0.882065193
11228,479,242,17,13,0.000833333,782056,0.882084367
16295,121,11,16,13,0.000784314,782072,0.882102414
11201,10,507,16,13,0.000784314,782088,0.88212046
11354,632,2,16,13,0.000784314,782104,0.882138507
12362,354,543,16,13,0.000784314,782120,0.882156553
14259,250,502,16,13,0.000784314,782136,0.8821746
12998,10,1,16,13,0.000784314,782152,0.882192646
14217,131,544,16,13,0.000784314,782168,0.882210693
12990,393,121,16,13,0.000784314,782184,0.882228739
12983,22,331,16,13,0.000784314,782200,0.882246785
12502,130,29,16,13,0.000784314,782216,0.882264832
14628,552,107,16,13,0.000784314,782232,0.882282878
12203,596,640,16,13,0.000784314,782248,0.882300925
12223,379,511,16,13,0.000784314,782264,0.882318971
12234,674,398,16,13,0.000784314,782280,0.882337018
12705,404,48,16,13,0.000784314,782296,0.882355064
13746,236,482,16,13,0.000784314,782312,0.882373111
13877,77,332,16,13,0.000784314,782328,0.882391157
14044,31,497,16,13,0.000784314,782344,0.882409204
12950,138,609,16,13,0.000784314,782360,0.88242725
12576,114,6,16,13,0.000784314,782376,0.882445297
12587,562,171,16,13,0.000784314,782392,0.882463343
12588,514,242,16,13,0.000784314,782408,0.88248139
12669,107,552,16,13,0.000784314,782424,0.882499436
13930,1,181,16,13,0.000784314,782440,0.882517483
12611,11,439,16,13,0.000784314,782456,0.882535529
11560,593,48,16,13,0.000784314,782472,0.882553575
13399,347,640,16,13,0.000784314,782488,0.882571622
13163,107,383,16,13,0.000784314,782504,0.882589668
11663,443,427,16,13,0.000784314,782520,0.882607715
13137,117,522,16,13,0.000784314,782536,0.882625761
11400,331,12,16,13,0.000784314,782552,0.882643808
11409,414,26,16,13,0.000784314,782568,0.882661854
11467,562,274,16,13,0.000784314,782584,0.882679901
15563,14,529,16,13,0.000784314,782600,0.882697947
11767,114,655,16,13,0.000784314,782616,0.882715994
11772,32,571,16,13,0.000784314,782632,0.88273404
14836,614,640,16,13,0.000784314,782648,0.882752087
14832,347,674,16,13,0.000784314,782664,0.882770133
12050,50,95,16,13,0.000784314,782680,0.88278818
12067,673,14,16,13,0.000784314,782696,0.882806226
12091,30,11,16,13,0.000784314,782712,0.882824273
11983,544,532,16,13,0.000784314,782728,0.882842319
11963,347,30,16,13,0.000784314,782744,0.882860365
11797,682,265,16,13,0.000784314,782760,0.882878412
13123,15,609,16,13,0.000784314,782776,0.882896458
11867,56,4,16,13,0.000784314,782792,0.882914505
13110,54,354,16,13,0.000784314,782808,0.882932551
14877,385,409,16,13,0.000784314,782824,0.882950598
9461,16,196,16,13,0.000784314,782840,0.882968644
7746,562,84,16,13,0.000784314,782856,0.882986691
7809,582,294,16,13,0.000784314,782872,0.883004737
9429,242,219,16,13,0.000784314,782888,0.883022784
9425,15,497,16,13,0.000784314,782904,0.88304083
9397,379,528,16,13,0.000784314,782920,0.883058877
7845,582,683,16,13,0.000784314,782936,0.883076923
10533,646,394,16,13,0.000784314,782952,0.88309497
9257,5,335,16,13,0.000784314,782968,0.883113016
9234,479,661,16,13,0.000784314,782984,0.883131062
7677,613,77,16,13,0.000784314,783000,0.883149109
9611,26,714,16,13,0.000784314,783016,0.883167155
9668,193,29,16,13,0.000784314,783032,0.883185202
9619,34,596,16,13,0.000784314,783048,0.883203248
7654,9,140,16,13,0.000784314,783064,0.883221295
10410,721,394,16,13,0.000784314,783080,0.883239341
10972,12,502,16,13,0.000784314,783096,0.883257388
10967,655,250,16,13,0.000784314,783112,0.883275434
7530,379,414,16,13,0.000784314,783128,0.883293481
10951,427,311,16,13,0.000784314,783144,0.883311527
9509,307,498,16,13,0.000784314,783160,0.883329574
9495,398,404,16,13,0.000784314,783176,0.88334762
8055,393,471,16,13,0.000784314,783192,0.883365667
10878,32,13,16,13,0.000784314,783208,0.883383713
10358,353,479,16,13,0.000784314,783224,0.88340176
8389,20,123,16,13,0.000784314,783240,0.883419806
8761,331,560,16,13,0.000784314,783256,0.883437852
10707,12,522,16,13,0.000784314,783272,0.883455899
8504,280,463,16,13,0.000784314,783288,0.883473945
8687,50,48,16,13,0.000784314,783304,0.883491992
10728,140,77,16,13,0.000784314,783320,0.883510038
8105,596,427,16,13,0.000784314,783336,0.883528085
9048,219,535,16,13,0.000784314,783352,0.883546131
9705,443,605,16,13,0.000784314,783368,0.883564178
11112,498,723,16,13,0.000784314,783384,0.883582224
9841,26,682,16,13,0.000784314,783400,0.883600271
5329,16,264,16,13,0.000784314,783416,0.883618317
11092,236,544,16,13,0.000784314,783432,0.883636364
10278,105,13,16,13,0.000784314,783448,0.88365441
10247,307,674,16,13,0.000784314,783464,0.883672457
10241,439,379,16,13,0.000784314,783480,0.883690503
10262,3,20,16,13,0.000784314,783496,0.88370855
10183,56,586,16,13,0.000784314,783512,0.883726596
9778,311,383,16,13,0.000784314,783528,0.883744642
9753,20,310,16,13,0.000784314,783544,0.883762689
9789,501,274,16,13,0.000784314,783560,0.883780735
11153,133,310,16,13,0.000784314,783576,0.883798782
11134,302,22,16,13,0.000784314,783592,0.883816828
6932,655,123,16,13,0.000784314,783608,0.883834875
13717,439,334,15,13,0.000735294,783623,0.883851793
11716,314,12,15,13,0.000735294,783638,0.883868712
9059,77,90,15,13,0.000735294,783653,0.88388563
10007,274,514,15,13,0.000735294,783668,0.883902549
12339,492,77,15,13,0.000735294,783683,0.883919468
12094,618,30,15,13,0.000735294,783698,0.883936386
13336,663,682,15,13,0.000735294,783713,0.883953305
13647,614,475,15,13,0.000735294,783728,0.883970223
9027,204,334,15,13,0.000735294,783743,0.883987142
12112,50,56,15,13,0.000735294,783758,0.88400406
9080,26,562,15,13,0.000735294,783773,0.884020979
13192,544,723,15,13,0.000735294,783788,0.884037898
9150,379,614,15,13,0.000735294,783803,0.884054816
13209,497,48,15,13,0.000735294,783818,0.884071735
11743,335,174,15,13,0.000735294,783833,0.884088653
13751,34,195,15,13,0.000735294,783848,0.884105572
10627,193,640,15,13,0.000735294,783863,0.88412249
8841,196,1,15,13,0.000735294,783878,0.884139409
8836,393,558,15,13,0.000735294,783893,0.884156328
13582,15,393,15,13,0.000735294,783908,0.884173246
12178,34,243,15,13,0.000735294,783923,0.884190165
12119,528,353,15,13,0.000735294,783938,0.884207083
10134,158,265,15,13,0.000735294,783953,0.884224002
13534,380,163,15,13,0.000735294,783968,0.88424092
11622,331,1,15,13,0.000735294,783983,0.884257839
10644,204,77,15,13,0.000735294,783998,0.884274758
13511,158,596,15,13,0.000735294,784013,0.884291676
10565,207,582,15,13,0.000735294,784028,0.884308595
12752,34,497,15,13,0.000735294,784043,0.884325513
12771,544,367,15,13,0.000735294,784058,0.884342432
11882,364,314,15,13,0.000735294,784073,0.88435935
12535,494,84,15,13,0.000735294,784088,0.884376269
12526,33,587,15,13,0.000735294,784103,0.884393187
11978,334,219,15,13,0.000735294,784118,0.884410106
9532,394,141,15,13,0.000735294,784133,0.884427025
9531,404,397,15,13,0.000735294,784148,0.884443943
9176,95,393,15,13,0.000735294,784163,0.884460862
10370,30,397,15,13,0.000735294,784178,0.88447778
12623,295,614,15,13,0.000735294,784193,0.884494699
9698,663,164,15,13,0.000735294,784208,0.884511617
12610,224,508,15,13,0.000735294,784223,0.884528536
9750,95,114,15,13,0.000735294,784238,0.884545455
12632,307,596,15,13,0.000735294,784253,0.884562373
12653,414,439,15,13,0.000735294,784268,0.884579292
19879,342,131,15,13,0.000735294,784283,0.88459621
12697,394,97,15,13,0.000735294,784298,0.884613129
9306,609,3,15,13,0.000735294,784313,0.884630047
10526,171,511,15,13,0.000735294,784328,0.884646966
13104,280,475,15,13,0.000735294,784343,0.884663885
12423,443,528,15,13,0.000735294,784358,0.884680803
12418,265,23,15,13,0.000735294,784373,0.884697722
12595,54,473,15,13,0.000735294,784388,0.88471464
9200,174,32,15,13,0.000735294,784403,0.884731559
9342,473,562,15,13,0.000735294,784418,0.884748477
12878,404,588,15,13,0.000735294,784433,0.884765396
12887,552,348,15,13,0.000735294,784448,0.884782314
12486,31,167,15,13,0.000735294,784463,0.884799233
12926,163,397,15,13,0.000735294,784478,0.884816152
9442,379,274,15,13,0.000735294,784493,0.88483307
10485,443,196,15,13,0.000735294,784508,0.884849989
9436,20,335,15,13,0.000735294,784523,0.884866907
11804,107,14,15,13,0.000735294,784538,0.884883826
9870,618,16,15,13,0.000735294,784553,0.884900744
10500,20,380,15,13,0.000735294,784568,0.884917663
13012,334,311,15,13,0.000735294,784583,0.884934582
11845,439,3,15,13,0.000735294,784598,0.8849515
10731,16,507,15,13,0.000735294,784613,0.884968419
14890,310,12,15,13,0.000735294,784628,0.884985337
7675,398,32,15,13,0.000735294,784643,0.885002256
11386,195,6,15,13,0.000735294,784658,0.885019174
7785,632,588,15,13,0.000735294,784673,0.885036093
7814,529,302,15,13,0.000735294,784688,0.885053012
11443,20,9,15,13,0.000735294,784703,0.88506993
14394,156,243,15,13,0.000735294,784718,0.885086849
14363,50,107,15,13,0.000735294,784733,0.885103767
8035,123,121,15,13,0.000735294,784748,0.885120686
14565,498,587,15,13,0.000735294,784763,0.885137604
11424,663,328,15,13,0.000735294,784778,0.885154523
14586,348,103,15,13,0.000735294,784793,0.885171441
14693,501,502,15,13,0.000735294,784808,0.88518836
6267,4,84,15,13,0.000735294,784823,0.885205279
16293,131,54,15,13,0.000735294,784838,0.885222197
11086,473,274,15,13,0.000735294,784853,0.885239116
16140,593,723,15,13,0.000735294,784868,0.885256034
17429,155,25,15,13,0.000735294,784883,0.885272953
17096,54,33,15,13,0.000735294,784898,0.885289871
17053,393,409,15,13,0.000735294,784913,0.88530679
16749,5,463,15,13,0.000735294,784928,0.885323709
15995,701,379,15,13,0.000735294,784943,0.885340627
11296,193,105,15,13,0.000735294,784958,0.885357546
15262,124,131,15,13,0.000735294,784973,0.885374464
11307,638,250,15,13,0.000735294,784988,0.885391383
6986,475,20,15,13,0.000735294,785003,0.885408301
15502,131,618,15,13,0.000735294,785018,0.88542522
15617,48,482,15,13,0.000735294,785033,0.885442139
11279,242,280,15,13,0.000735294,785048,0.885459057
15770,158,502,15,13,0.000735294,785063,0.885475976
17678,121,302,15,13,0.000735294,785078,0.885492894
14931,328,264,15,13,0.000735294,785093,0.885509813
8356,123,708,15,13,0.000735294,785108,0.885526731
14202,414,348,15,13,0.000735294,785123,0.88554365
8255,145,20,15,13,0.000735294,785138,0.885560568
11575,385,532,15,13,0.000735294,785153,0.885577487
10789,618,105,15,13,0.000735294,785168,0.885594406
10822,307,544,15,13,0.000735294,785183,0.885611324
8308,302,543,15,13,0.000735294,785198,0.885628243
14106,11,646,15,13,0.000735294,785213,0.885645161
13965,219,587,15,13,0.000735294,785228,0.88566208
10864,535,614,15,13,0.000735294,785243,0.885678998
8087,367,479,15,13,0.000735294,785258,0.885695917
13793,56,1,15,13,0.000735294,785273,0.885712836
13985,689,2,15,13,0.000735294,785288,0.885729754
14234,427,475,15,13,0.000735294,785303,0.885746673
13938,588,503,15,13,0.000735294,785318,0.885763591
14203,479,274,15,13,0.000735294,785333,0.88578051
6458,414,123,14,13,0.000686275,785347,0.8857963
15499,25,385,14,13,0.000686275,785361,0.885812091
8725,383,582,14,13,0.000686275,785375,0.885827882
12536,230,156,14,13,0.000686275,785389,0.885843672
16073,196,236,14,13,0.000686275,785403,0.885859463
12411,517,3,14,13,0.000686275,785417,0.885875254
13838,348,605,14,13,0.000686275,785431,0.885891044
6349,640,638,14,13,0.000686275,785445,0.885906835
13637,145,274,14,13,0.000686275,785459,0.885922626
12433,25,230,14,13,0.000686275,785473,0.885938416
17982,543,593,14,13,0.000686275,785487,0.885954207
13878,414,6,14,13,0.000686275,785501,0.885969998
9793,640,50,14,13,0.000686275,785515,0.885985788
9790,274,31,14,13,0.000686275,785529,0.886001579
8417,14,123,14,13,0.000686275,785543,0.88601737
12516,280,56,14,13,0.000686275,785557,0.88603316
17667,243,160,14,13,0.000686275,785571,0.886048951
15836,90,394,14,13,0.000686275,785585,0.886064742
15848,427,562,14,13,0.000686275,785599,0.886080532
9861,463,367,14,13,0.000686275,785613,0.886096323
17827,131,269,14,13,0.000686275,785627,0.886112114
9973,3,4,14,13,0.000686275,785641,0.886127904
8539,473,181,14,13,0.000686275,785655,0.886143695
13725,367,22,14,13,0.000686275,785669,0.886159486
13719,448,473,14,13,0.000686275,785683,0.886175276
13811,397,511,14,13,0.000686275,785697,0.886191067
16838,501,54,14,13,0.000686275,785711,0.886206858
12152,535,328,14,13,0.000686275,785725,0.886222648
12167,302,1,14,13,0.000686275,785739,0.886238439
9999,334,77,14,13,0.000686275,785753,0.88625423
16254,385,121,14,13,0.000686275,785767,0.88627002
16220,5,689,14,13,0.000686275,785781,0.886285811
17302,6,569,14,13,0.000686275,785795,0.886301602
9958,398,114,14,13,0.000686275,785809,0.886317392
16284,171,114,14,13,0.000686275,785823,0.886333183
12288,3,29,14,13,0.000686275,785837,0.886348974
8670,265,586,14,13,0.000686275,785851,0.886364764
13409,511,348,14,13,0.000686275,785865,0.886380555
8232,721,498,14,13,0.000686275,785879,0.886396346
8982,9,714,14,13,0.000686275,785893,0.886412136
14811,427,443,14,13,0.000686275,785907,0.886427927
14800,683,397,14,13,0.000686275,785921,0.886443718
14406,1,463,14,13,0.000686275,785935,0.886459508
14385,514,535,14,13,0.000686275,785949,0.886475299
14297,236,332,14,13,0.000686275,785963,0.88649109
13115,33,265,14,13,0.000686275,785977,0.88650688
8001,295,535,14,13,0.000686275,785991,0.886522671
13316,84,34,14,13,0.000686275,786005,0.886538462
14125,171,393,14,13,0.000686275,786019,0.886554252
9613,33,511,14,13,0.000686275,786033,0.886570043
8360,26,404,14,13,0.000686275,786047,0.886585834
14091,133,164,14,13,0.000686275,786061,0.886601624
12813,609,31,14,13,0.000686275,786075,0.886617415
8244,274,141,14,13,0.000686275,786089,0.886633206
8325,497,123,14,13,0.000686275,786103,0.886648996
13492,155,280,14,13,0.000686275,786117,0.886664787
7514,4,236,14,13,0.000686275,786131,0.886680577
12791,156,544,14,13,0.000686275,786145,0.886696368
10695,463,126,14,13,0.000686275,786159,0.886712159
10456,15,141,14,13,0.000686275,786173,0.886727949
11180,123,683,14,13,0.000686275,786187,0.88674374
11099,30,624,14,13,0.000686275,786201,0.886759531
10482,588,85,14,13,0.000686275,786215,0.886775321
11397,14,380,14,13,0.000686275,786229,0.886791112
10409,13,380,14,13,0.000686275,786243,0.886806903
10427,638,393,14,13,0.000686275,786257,0.886822693
10863,2,84,14,13,0.000686275,786271,0.886838484
11079,498,156,14,13,0.000686275,786285,0.886854275
11319,646,353,14,13,0.000686275,786299,0.886870065
11715,274,130,14,13,0.000686275,786313,0.886885856
10294,3,385,14,13,0.000686275,786327,0.886901647
11608,22,9,14,13,0.000686275,786341,0.886917437
11579,68,103,14,13,0.000686275,786355,0.886933228
10725,394,31,14,13,0.000686275,786369,0.886949019
7200,32,174,13,13,0.000637255,786382,0.886963681
15332,68,290,13,13,0.000637255,786395,0.886978344
13387,196,56,13,13,0.000637255,786408,0.886993007
13329,552,97,13,13,0.000637255,786421,0.88700767
15454,354,1,13,13,0.000637255,786434,0.887022333
13257,204,171,13,13,0.000637255,786447,0.887036995
15414,314,332,13,13,0.000637255,786460,0.887051658
13317,307,121,13,13,0.000637255,786473,0.887066321
15374,473,12,13,13,0.000637255,786486,0.887080984
10444,414,32,13,13,0.000637255,786499,0.887095646
15924,535,126,13,13,0.000637255,786512,0.887110309
13050,682,473,13,13,0.000637255,786525,0.887124972
15658,158,517,13,13,0.000637255,786538,0.887139635
6593,529,123,13,13,0.000637255,786551,0.887154297
11820,156,22,13,13,0.000637255,786564,0.88716896
14040,145,107,13,13,0.000637255,786577,0.887183623
13957,668,48,13,13,0.000637255,786590,0.887198286
14397,174,9,13,13,0.000637255,786603,0.887212948
14381,380,29,13,13,0.000637255,786616,0.887227611
11505,479,552,13,13,0.000637255,786629,0.887242274
14166,348,507,13,13,0.000637255,786642,0.887256937
14478,97,427,13,13,0.000637255,786655,0.887271599
18167,25,163,13,13,0.000637255,786668,0.887286262
13485,164,473,13,13,0.000637255,786681,0.887300925
18145,114,605,13,13,0.000637255,786694,0.887315588
14869,385,463,13,13,0.000637255,786707,0.88733025
14849,535,543,13,13,0.000637255,786720,0.887344913
8640,498,3,13,13,0.000637255,786733,0.887359576
9799,638,3,13,13,0.000637255,786746,0.887374239
12407,721,236,13,13,0.000637255,786759,0.887388901
9788,618,9,13,13,0.000637255,786772,0.887403564
17319,64,334,13,13,0.000637255,786785,0.887418227
16585,439,295,13,13,0.000637255,786798,0.88743289
12635,242,335,13,13,0.000637255,786811,0.887447552
5204,243,158,29,12,0.001421569,786840,0.887480262
4728,721,280,24,12,0.001176471,786864,0.887507331
12353,64,471,23,12,0.001127451,786887,0.887533273
8977,174,68,23,12,0.001127451,786910,0.887559215
12667,354,56,21,12,0.001029412,786931,0.887582901
8290,507,335,21,12,0.001029412,786952,0.887606587
7983,367,4,21,12,0.001029412,786973,0.887630273
10819,174,15,21,12,0.001029412,786994,0.887653959
10209,497,609,21,12,0.001029412,787015,0.887677645
8639,11,117,21,12,0.001029412,787036,0.887701331
9466,394,558,21,12,0.001029412,787057,0.887725017
9318,193,1,21,12,0.001029412,787078,0.887748703
9303,107,682,21,12,0.001029412,787099,0.887772389
10641,130,714,20,12,0.000980392,787119,0.887794947
7146,614,334,20,12,0.000980392,787139,0.887817505
9407,230,511,20,12,0.000980392,787159,0.887840063
8778,479,1,20,12,0.000980392,787179,0.887862621
10973,80,511,20,12,0.000980392,787199,0.887885179
11396,302,560,20,12,0.000980392,787219,0.887907737
10884,609,121,20,12,0.000980392,787239,0.887930296
10914,663,167,20,12,0.000980392,787259,0.887952854
6854,397,265,20,12,0.000980392,787279,0.887975412
8372,204,311,20,12,0.000980392,787299,0.88799797
9623,335,673,20,12,0.000980392,787319,0.888020528
11179,458,16,20,12,0.000980392,787339,0.888043086
12902,121,224,20,12,0.000980392,787359,0.888065644
12210,409,367,19,12,0.000931373,787378,0.888087074
9602,473,4,19,12,0.000931373,787397,0.888108504
5532,638,348,19,12,0.000931373,787416,0.888129935
14716,463,274,19,12,0.000931373,787435,0.888151365
7817,558,30,19,12,0.000931373,787454,0.888172795
6654,30,522,19,12,0.000931373,787473,0.888194225
9281,95,121,19,12,0.000931373,787492,0.888215655
7852,265,379,19,12,0.000931373,787511,0.888237085
14695,544,107,19,12,0.000931373,787530,0.888258516
6218,502,158,19,12,0.000931373,787549,0.888279946
9875,31,2,19,12,0.000931373,787568,0.888301376
9663,11,614,19,12,0.000931373,787587,0.888322806
9945,558,167,19,12,0.000931373,787606,0.888344236
5307,204,80,19,12,0.000931373,787625,0.888365667
9883,34,77,19,12,0.000931373,787644,0.888387097
10017,5,588,19,12,0.000931373,787663,0.888408527
8046,332,243,19,12,0.000931373,787682,0.888429957
8772,196,331,19,12,0.000931373,787701,0.888451387
14233,29,30,19,12,0.000931373,787720,0.888472818
8980,392,380,18,12,0.000882353,787738,0.88849312
10991,16,64,18,12,0.000882353,787756,0.888513422
6709,605,314,18,12,0.000882353,787774,0.888533724
10796,15,674,18,12,0.000882353,787792,0.888554027
13348,3,661,18,12,0.000882353,787810,0.888574329
6509,15,174,18,12,0.000882353,787828,0.888594631
11008,236,30,18,12,0.000882353,787846,0.888614933
7356,30,331,18,12,0.000882353,787864,0.888635236
10525,280,404,18,12,0.000882353,787882,0.888655538
8929,507,582,18,12,0.000882353,787900,0.88867584
10447,640,34,18,12,0.000882353,787918,0.888696143
13431,224,207,18,12,0.000882353,787936,0.888716445
11332,708,313,18,12,0.000882353,787954,0.888736747
10423,663,264,18,12,0.000882353,787972,0.888757049
7246,582,29,18,12,0.000882353,787990,0.888777352
14983,535,517,18,12,0.000882353,788008,0.888797654
13153,80,246,18,12,0.000882353,788026,0.888817956
9138,511,558,18,12,0.000882353,788044,0.888838259
12245,335,181,18,12,0.000882353,788062,0.888858561
12250,522,503,18,12,0.000882353,788080,0.888878863
14453,43,50,18,12,0.000882353,788098,0.888899165
9918,95,11,18,12,0.000882353,788116,0.888919468
10164,393,663,18,12,0.000882353,788134,0.88893977
9969,632,708,18,12,0.000882353,788152,0.888960072
9732,507,9,18,12,0.000882353,788170,0.888980374
12327,552,14,18,12,0.000882353,788188,0.889000677
8736,31,219,18,12,0.000882353,788206,0.889020979
7760,97,311,18,12,0.000882353,788224,0.889041281
12013,224,618,18,12,0.000882353,788242,0.889061584
9490,20,13,18,12,0.000882353,788260,0.889081886
14152,34,501,18,12,0.000882353,788278,0.889102188
12879,507,170,18,12,0.000882353,788296,0.88912249
9568,640,26,18,12,0.000882353,788314,0.889142793
11173,332,224,18,12,0.000882353,788332,0.889163095
14629,398,723,18,12,0.000882353,788350,0.889183397
10760,638,77,17,12,0.000833333,788367,0.889202572
12937,12,328,17,12,0.000833333,788384,0.889221746
9780,34,3,17,12,0.000833333,788401,0.88924092
16484,175,295,17,12,0.000833333,788418,0.889260095
11199,475,393,17,12,0.000833333,788435,0.889279269
9426,397,638,17,12,0.000833333,788452,0.889298443
12960,721,397,17,12,0.000833333,788469,0.889317618
8279,414,280,17,12,0.000833333,788486,0.889336792
9559,632,5,17,12,0.000833333,788503,0.889355967
12762,22,501,17,12,0.000833333,788520,0.889375141
11457,95,130,17,12,0.000833333,788537,0.889394315
5788,529,9,17,12,0.000833333,788554,0.88941349
10940,348,12,17,12,0.000833333,788571,0.889432664
12828,471,439,17,12,0.000833333,788588,0.889451838
12733,632,394,17,12,0.000833333,788605,0.889471013
12651,501,204,17,12,0.000833333,788622,0.889490187
12625,171,443,17,12,0.000833333,788639,0.889509362
12619,243,14,17,12,0.000833333,788656,0.889528536
12615,543,552,17,12,0.000833333,788673,0.88954771
9168,439,313,17,12,0.000833333,788690,0.889566885
13393,43,145,17,12,0.000833333,788707,0.889586059
6827,497,582,17,12,0.000833333,788724,0.889605233
8469,158,295,17,12,0.000833333,788741,0.889624408
15624,313,43,17,12,0.000833333,788758,0.889643582
9621,507,131,17,12,0.000833333,788775,0.889662757
9456,501,250,17,12,0.000833333,788792,0.889681931
12691,171,335,17,12,0.000833333,788809,0.889701105
11491,311,409,17,12,0.000833333,788826,0.88972028
8479,140,314,17,12,0.000833333,788843,0.889739454
10842,164,25,17,12,0.000833333,788860,0.889758628
14143,448,347,17,12,0.000833333,788877,0.889777803
9859,638,397,17,12,0.000833333,788894,0.889796977
10480,562,397,17,12,0.000833333,788911,0.889816152
9326,103,582,17,12,0.000833333,788928,0.889835326
7581,398,655,17,12,0.000833333,788945,0.8898545
12174,655,398,17,12,0.000833333,788962,0.889873675
10088,48,141,17,12,0.000833333,788979,0.889892849
12230,15,34,17,12,0.000833333,788996,0.889912023
11946,145,562,17,12,0.000833333,789013,0.889931198
13093,171,618,17,12,0.000833333,789030,0.889950372
10270,335,446,17,12,0.000833333,789047,0.889969547
9267,16,587,17,12,0.000833333,789064,0.889988721
11858,32,54,17,12,0.000833333,789081,0.890007895
10434,158,274,17,12,0.000833333,789098,0.89002707
6299,31,588,17,12,0.000833333,789115,0.890046244
11885,682,219,17,12,0.000833333,789132,0.890065418
9304,562,614,17,12,0.000833333,789149,0.890084593
11917,130,171,17,12,0.000833333,789166,0.890103767
14170,130,507,17,12,0.000833333,789183,0.890122942
11679,16,508,17,12,0.000833333,789200,0.890142116
12402,193,689,17,12,0.000833333,789217,0.89016129
10634,230,560,17,12,0.000833333,789234,0.890180465
15241,6,383,17,12,0.000833333,789251,0.890199639
10696,494,379,17,12,0.000833333,789268,0.890218813
13635,529,269,17,12,0.000833333,789285,0.890237988
11316,498,14,17,12,0.000833333,789302,0.890257162
8142,196,638,17,12,0.000833333,789319,0.890276337
8946,43,80,17,12,0.000833333,789336,0.890295511
10573,479,265,17,12,0.000833333,789353,0.890314685
10567,34,174,17,12,0.000833333,789370,0.89033386
10612,158,95,17,12,0.000833333,789387,0.890353034
13272,588,502,17,12,0.000833333,789404,0.890372208
7335,673,393,17,12,0.000833333,789421,0.890391383
11206,673,121,16,12,0.000784314,789437,0.890409429
11247,13,335,16,12,0.000784314,789453,0.890427476
16310,167,16,16,12,0.000784314,789469,0.890445522
16043,155,552,16,12,0.000784314,789485,0.890463569
16171,383,613,16,12,0.000784314,789501,0.890481615
11322,522,1,16,12,0.000784314,789517,0.890499662
11226,131,20,16,12,0.000784314,789533,0.890517708
11308,158,397,16,12,0.000784314,789549,0.890535755
13325,507,33,16,12,0.000784314,789565,0.890553801
16215,117,26,16,12,0.000784314,789581,0.890571848
14274,353,195,16,12,0.000784314,789597,0.890589894
13000,404,535,16,12,0.000784314,789613,0.89060794
12392,171,10,16,12,0.000784314,789629,0.890625987
14182,171,107,16,12,0.000784314,789645,0.890644033
12446,353,560,16,12,0.000784314,789661,0.89066208
12450,15,236,16,12,0.000784314,789677,0.890680126
12468,50,596,16,12,0.000784314,789693,0.890698173
12498,543,130,16,12,0.000784314,789709,0.890716219
12351,4,392,16,12,0.000784314,789725,0.890734266
14293,473,714,16,12,0.000784314,789741,0.890752312
14546,503,10,16,12,0.000784314,789757,0.890770359
13046,674,385,16,12,0.000784314,789773,0.890788405
13296,614,503,16,12,0.000784314,789789,0.890806452
14498,463,5,16,12,0.000784314,789805,0.890824498
14457,543,517,16,12,0.000784314,789821,0.890842545
12254,404,32,16,12,0.000784314,789837,0.890860591
13586,25,33,16,12,0.000784314,789853,0.890878637
12258,30,596,16,12,0.000784314,789869,0.890896684
12259,614,385,16,12,0.000784314,789885,0.89091473
12534,26,427,16,12,0.000784314,789901,0.890932777
13842,475,107,16,12,0.000784314,789917,0.890950823
12719,302,164,16,12,0.000784314,789933,0.89096887
12725,640,560,16,12,0.000784314,789949,0.890986916
12901,236,493,16,12,0.000784314,789965,0.891004963
12776,414,614,16,12,0.000784314,789981,0.891023009
12871,498,560,16,12,0.000784314,789997,0.891041056
12814,668,204,16,12,0.000784314,790013,0.891059102
13879,307,164,16,12,0.000784314,790029,0.891077149
12574,236,20,16,12,0.000784314,790045,0.891095195
13902,544,443,16,12,0.000784314,790061,0.891113242
12664,15,508,16,12,0.000784314,790077,0.891131288
12665,207,16,16,12,0.000784314,790093,0.891149335
12151,558,502,16,12,0.000784314,790109,0.891167381
11355,663,242,16,12,0.000784314,790125,0.891185427
11607,392,331,16,12,0.000784314,790141,0.891203474
16705,64,15,16,12,0.000784314,790157,0.89122152
11713,156,25,16,12,0.000784314,790173,0.891239567
11748,632,307,16,12,0.000784314,790189,0.891257613
13397,123,508,16,12,0.000784314,790205,0.89127566
11551,274,347,16,12,0.000784314,790221,0.891293706
12123,43,393,16,12,0.000784314,790237,0.891311753
15781,613,367,16,12,0.000784314,790253,0.891329799
11412,224,294,16,12,0.000784314,790269,0.891347846
11431,80,507,16,12,0.000784314,790285,0.891365892
15729,131,207,16,12,0.000784314,790301,0.891383939
11470,558,155,16,12,0.000784314,790317,0.891401985
15568,328,14,16,12,0.000784314,790333,0.891420032
13377,348,682,16,12,0.000784314,790349,0.891438078
14742,354,156,16,12,0.000784314,790365,0.891456125
14641,50,558,16,12,0.000784314,790381,0.891474171
14630,6,328,16,12,0.000784314,790397,0.891492217
13563,507,219,16,12,0.000784314,790413,0.891510264
11850,335,13,16,12,0.000784314,790429,0.89152831
13130,593,242,16,12,0.000784314,790445,0.891546357
13449,593,243,16,12,0.000784314,790461,0.891564403
14987,414,674,16,12,0.000784314,790477,0.89158245
11846,673,274,16,12,0.000784314,790493,0.891600496
14963,156,14,16,12,0.000784314,790509,0.891618543
14865,156,708,16,12,0.000784314,790525,0.891636589
11167,264,532,16,12,0.000784314,790541,0.891654636
10316,145,511,16,12,0.000784314,790557,0.891672682
10921,443,167,16,12,0.000784314,790573,0.891690729
10470,178,196,16,12,0.000784314,790589,0.891708775
9392,302,264,16,12,0.000784314,790605,0.891726822
9385,558,3,16,12,0.000784314,790621,0.891744868
10511,334,11,16,12,0.000784314,790637,0.891762915
9271,158,84,16,12,0.000784314,790653,0.891780961
10557,105,103,16,12,0.000784314,790669,0.891799007
9164,528,84,16,12,0.000784314,790685,0.891817054
9149,498,385,16,12,0.000784314,790701,0.8918351
7165,264,105,16,12,0.000784314,790717,0.891853147
7230,103,314,16,12,0.000784314,790733,0.891871193
11007,522,502,16,12,0.000784314,790749,0.89188924
9652,514,393,16,12,0.000784314,790765,0.891907286
10977,463,535,16,12,0.000784314,790781,0.891925333
8448,295,393,16,12,0.000784314,790797,0.891943379
8383,532,156,16,12,0.000784314,790813,0.891961426
8777,529,614,16,12,0.000784314,790829,0.891979472
8431,618,167,16,12,0.000784314,790845,0.891997519
8748,497,443,16,12,0.000784314,790861,0.892015565
10706,307,11,16,12,0.000784314,790877,0.892033612
8511,475,295,16,12,0.000784314,790893,0.892051658
10875,34,64,16,12,0.000784314,790909,0.892069704
8093,33,497,16,12,0.000784314,790925,0.892087751
8100,586,473,16,12,0.000784314,790941,0.892105797
9060,532,682,16,12,0.000784314,790957,0.892123844
10853,117,9,16,12,0.000784314,790973,0.89214189
9057,331,646,16,12,0.000784314,790989,0.892159937
8898,9,117,16,12,0.000784314,791005,0.892177983
8141,313,560,16,12,0.000784314,791021,0.89219603
8158,528,588,16,12,0.000784314,791037,0.892214076
8183,609,302,16,12,0.000784314,791053,0.892232123
8228,663,20,16,12,0.000784314,791069,0.892250169
8974,295,394,16,12,0.000784314,791085,0.892268216
8973,605,529,16,12,0.000784314,791101,0.892286262
8969,632,331,16,12,0.000784314,791117,0.892304309
8240,501,522,16,12,0.000784314,791133,0.892322355
10075,204,2,16,12,0.000784314,791149,0.892340402
10119,646,105,16,12,0.000784314,791165,0.892358448
9825,668,105,16,12,0.000784314,791181,0.892376494
6813,502,314,16,12,0.000784314,791197,0.892394541
4017,4,48,16,12,0.000784314,791213,0.892412587
9888,367,517,16,12,0.000784314,791229,0.892430634
11094,311,587,16,12,0.000784314,791245,0.89244868
10253,48,640,16,12,0.000784314,791261,0.892466727
10006,264,224,16,12,0.000784314,791277,0.892484773
10013,517,354,16,12,0.000784314,791293,0.89250282
10195,274,107,16,12,0.000784314,791309,0.892520866
10599,609,33,15,12,0.000735294,791324,0.892537785
10012,274,170,15,12,0.000735294,791339,0.892554703
10000,31,11,15,12,0.000735294,791354,0.892571622
8716,544,123,15,12,0.000735294,791369,0.89258854
9073,310,242,15,12,0.000735294,791384,0.892605459
10260,353,689,15,12,0.000735294,791399,0.892622378
13748,501,427,15,12,0.000735294,791414,0.892639296
12384,683,224,15,12,0.000735294,791429,0.892656215
9142,123,170,15,12,0.000735294,791444,0.892673133
9971,195,27,15,12,0.000735294,791459,0.892690052
10257,196,353,15,12,0.000735294,791474,0.89270697
13255,48,587,15,12,0.000735294,791489,0.892723889
13737,31,126,15,12,0.000735294,791504,0.892740808
9120,582,156,15,12,0.000735294,791519,0.892757726
13726,156,394,15,12,0.000735294,791534,0.892774645
12054,379,22,15,12,0.000735294,791549,0.892791563
10170,475,30,15,12,0.000735294,791564,0.892808482
11651,131,385,15,12,0.000735294,791579,0.8928254
12218,655,347,15,12,0.000735294,791594,0.892842319
12215,558,265,15,12,0.000735294,791609,0.892859238
11646,614,114,15,12,0.000735294,791624,0.892876156
13590,479,181,15,12,0.000735294,791639,0.892893075
13375,394,605,15,12,0.000735294,791654,0.892909993
10028,682,16,15,12,0.000735294,791669,0.892926912
12292,314,290,15,12,0.000735294,791684,0.89294383
12157,380,167,15,12,0.000735294,791699,0.892960749
13441,614,552,15,12,0.000735294,791714,0.892977667
12066,394,328,15,12,0.000735294,791729,0.892994586
13472,535,562,15,12,0.000735294,791744,0.893011505
11753,379,364,15,12,0.000735294,791759,0.893028423
13474,673,141,15,12,0.000735294,791774,0.893045342
9731,295,117,15,12,0.000735294,791789,0.89306226
10421,529,32,15,12,0.000735294,791804,0.893079179
12746,535,274,15,12,0.000735294,791819,0.893096097
12711,5,33,15,12,0.000735294,791834,0.893113016
11971,84,56,15,12,0.000735294,791849,0.893129935
10429,498,535,15,12,0.000735294,791864,0.893146853
10449,463,443,15,12,0.000735294,791879,0.893163772
9854,562,522,15,12,0.000735294,791894,0.89318069
10407,97,708,15,12,0.000735294,791909,0.893197609
9689,721,105,15,12,0.000735294,791924,0.893214527
12622,471,121,15,12,0.000735294,791939,0.893231446
12704,307,609,15,12,0.000735294,791954,0.893248365
9765,14,335,15,12,0.000735294,791969,0.893265283
11932,158,64,15,12,0.000735294,791984,0.893282202
9664,638,586,15,12,0.000735294,791999,0.89329912
9644,501,6,15,12,0.000735294,792014,0.893316039
10396,379,56,15,12,0.000735294,792029,0.893332957
12678,708,311,15,12,0.000735294,792044,0.893349876
9639,26,708,15,12,0.000735294,792059,0.893366794
10401,280,479,15,12,0.000735294,792074,0.893383713
12545,385,131,15,12,0.000735294,792089,0.893400632
9858,511,219,15,12,0.000735294,792104,0.89341755
10537,10,140,15,12,0.000735294,792119,0.893434469
9934,614,501,15,12,0.000735294,792134,0.893451387
10522,596,14,15,12,0.000735294,792149,0.893468306
13100,50,11,15,12,0.000735294,792164,0.893485224
10550,196,167,15,12,0.000735294,792179,0.893502143
13133,2,517,15,12,0.000735294,792194,0.893519062
10555,473,242,15,12,0.000735294,792209,0.89353598
10266,605,68,15,12,0.000735294,792224,0.893552899
9212,522,30,15,12,0.000735294,792239,0.893569817
9201,446,314,15,12,0.000735294,792254,0.893586736
9177,9,508,15,12,0.000735294,792269,0.893603654
10293,414,50,15,12,0.000735294,792284,0.893620573
9465,689,475,15,12,0.000735294,792299,0.893637492
9452,638,640,15,12,0.000735294,792314,0.89365441
12930,274,609,15,12,0.000735294,792329,0.893671329
12003,385,10,15,12,0.000735294,792344,0.893688247
13004,347,2,15,12,0.000735294,792359,0.893705166
13008,131,29,15,12,0.000735294,792374,0.893722084
13011,379,30,15,12,0.000735294,792389,0.893739003
12436,196,130,15,12,0.000735294,792404,0.893755921
13969,558,439,15,12,0.000735294,792419,0.89377284
7686,26,48,15,12,0.000735294,792434,0.893789759
11384,394,15,15,12,0.000735294,792449,0.893806677
10926,34,30,15,12,0.000735294,792464,0.893823596
14830,121,48,15,12,0.000735294,792479,0.893840514
14756,178,31,15,12,0.000735294,792494,0.893857433
14956,334,348,15,12,0.000735294,792509,0.893874351
14993,11,682,15,12,0.000735294,792524,0.89389127
10955,15,394,15,12,0.000735294,792539,0.893908189
3789,196,123,15,12,0.000735294,792554,0.893925107
14389,5,2,15,12,0.000735294,792569,0.893942026
14426,12,646,15,12,0.000735294,792584,0.893958944
14377,471,64,15,12,0.000735294,792599,0.893975863
14694,20,77,15,12,0.000735294,792614,0.893992781
14365,261,219,15,12,0.000735294,792629,0.8940097
14341,498,517,15,12,0.000735294,792644,0.894026619
8021,507,105,15,12,0.000735294,792659,0.894043537
7986,32,587,15,12,0.000735294,792674,0.894060456
7856,689,334,15,12,0.000735294,792689,0.894077374
15105,493,243,15,12,0.000735294,792704,0.894094293
7383,624,6,15,12,0.000735294,792719,0.894111211
15139,347,427,15,12,0.000735294,792734,0.89412813
4712,4,224,15,12,0.000735294,792749,0.894145048
17354,552,439,15,12,0.000735294,792764,0.894161967
16084,117,280,15,12,0.000735294,792779,0.894178886
11071,514,311,15,12,0.000735294,792794,0.894195804
11113,43,311,15,12,0.000735294,792809,0.894212723
11126,1,158,15,12,0.000735294,792824,0.894229641
11152,501,114,15,12,0.000735294,792839,0.89424656
16739,364,674,15,12,0.000735294,792854,0.894263478
15993,43,427,15,12,0.000735294,792869,0.894280397
18121,167,3,15,12,0.000735294,792884,0.894297316
15300,446,230,15,12,0.000735294,792899,0.894314234
15308,145,587,15,12,0.000735294,792914,0.894331153
11311,163,219,15,12,0.000735294,792929,0.894348071
15317,84,5,15,12,0.000735294,792944,0.89436499
15365,463,427,15,12,0.000735294,792959,0.894381908
15976,230,269,15,12,0.000735294,792974,0.894398827
15463,64,95,15,12,0.000735294,792989,0.894415746
15609,145,265,15,12,0.000735294,793004,0.894432664
11035,311,12,15,12,0.000735294,793019,0.894449583
11261,6,54,15,12,0.000735294,793034,0.894466501
8162,3,562,15,12,0.000735294,793049,0.89448342
11562,22,562,15,12,0.000735294,793064,0.894500338
10767,295,5,15,12,0.000735294,793079,0.894517257
11586,689,196,15,12,0.000735294,793094,0.894534176
10843,443,640,15,12,0.000735294,793109,0.894551094
11589,473,294,15,12,0.000735294,793124,0.894568013
14023,107,5,15,12,0.000735294,793139,0.894584931
14120,385,313,15,12,0.000735294,793154,0.89460185
13855,367,30,15,12,0.000735294,793169,0.894618768
13932,404,328,15,12,0.000735294,793184,0.894635687
10778,164,310,15,12,0.000735294,793199,0.894652605
11539,443,543,15,12,0.000735294,793214,0.894669524
10775,230,20,15,12,0.000735294,793229,0.894686443
14210,16,2,15,12,0.000735294,793244,0.894703361
8375,586,141,15,12,0.000735294,793259,0.89472028
11536,525,380,15,12,0.000735294,793274,0.894737198
9911,439,588,14,12,0.000686275,793288,0.894752989
8742,307,6,14,12,0.000686275,793302,0.89476878
13643,107,167,14,12,0.000686275,793316,0.89478457
8720,663,25,14,12,0.000686275,793330,0.894800361
9932,33,614,14,12,0.000686275,793344,0.894816152
13862,353,171,14,12,0.000686275,793358,0.894831942
12544,131,605,14,12,0.000686275,793372,0.894847733
13835,367,170,14,12,0.000686275,793386,0.894863524
15798,535,503,14,12,0.000686275,793400,0.894879314
15895,463,560,14,12,0.000686275,793414,0.894895105
15910,171,529,14,12,0.000686275,793428,0.894910896
15582,507,95,14,12,0.000686275,793442,0.894926686
12480,158,514,14,12,0.000686275,793456,0.894942477
13604,26,528,14,12,0.000686275,793470,0.894958268
16548,117,307,14,12,0.000686275,793484,0.894974058
13744,295,502,14,12,0.000686275,793498,0.894989849
12200,347,3,14,12,0.000686275,793512,0.89500564
12207,394,479,14,12,0.000686275,793526,0.89502143
6234,586,32,14,12,0.000686275,793540,0.895037221
10159,11,3,14,12,0.000686275,793554,0.895053012
12131,562,552,14,12,0.000686275,793568,0.895068802
16795,121,313,14,12,0.000686275,793582,0.895084593
13750,618,655,14,12,0.000686275,793596,0.895100383
16852,167,15,14,12,0.000686275,793610,0.895116174
5941,16,683,14,12,0.000686275,793624,0.895131965
16948,64,347,14,12,0.000686275,793638,0.895147755
10067,640,121,14,12,0.000686275,793652,0.895163546
8669,544,335,14,12,0.000686275,793666,0.895179337
10005,196,307,14,12,0.000686275,793680,0.895195127
6301,543,9,14,12,0.000686275,793694,0.895210918
16149,342,84,14,12,0.000686275,793708,0.895226709
13669,414,130,14,12,0.000686275,793722,0.895242499
12308,15,532,14,12,0.000686275,793736,0.89525829
8559,586,535,14,12,0.000686275,793750,0.895274081
12330,708,588,14,12,0.000686275,793764,0.895289871
12607,682,250,14,12,0.000686275,793778,0.895305662
12980,353,646,14,12,0.000686275,793792,0.895321453
9370,529,334,14,12,0.000686275,793806,0.895337243
13018,265,32,14,12,0.000686275,793820,0.895353034
7860,9,29,14,12,0.000686275,793834,0.895368825
14610,535,170,14,12,0.000686275,793848,0.895384615
14597,380,661,14,12,0.000686275,793862,0.895400406
14709,347,126,14,12,0.000686275,793876,0.895416197
12966,383,497,14,12,0.000686275,793890,0.895431987
9446,708,14,14,12,0.000686275,793904,0.895447778
13404,33,54,14,12,0.000686275,793918,0.895463569
18551,502,682,14,12,0.000686275,793932,0.895479359
9001,443,95,14,12,0.000686275,793946,0.89549515
14595,689,54,14,12,0.000686275,793960,0.895510941
15429,123,646,14,12,0.000686275,793974,0.895526731
14348,167,22,14,12,0.000686275,793988,0.895542522
13306,479,482,14,12,0.000686275,794002,0.895558313
9116,133,230,14,12,0.000686275,794016,0.895574103
13190,56,130,14,12,0.000686275,794030,0.895589894
13199,243,295,14,12,0.000686275,794044,0.895605685
14175,84,632,14,12,0.000686275,794058,0.895621475
13057,30,243,14,12,0.000686275,794072,0.895637266
14507,313,181,14,12,0.000686275,794086,0.895653057
9263,398,313,14,12,0.000686275,794100,0.895668847
13122,145,130,14,12,0.000686275,794114,0.895684638
14854,26,364,14,12,0.000686275,794128,0.895700429
15265,463,175,14,12,0.000686275,794142,0.895716219
14008,552,30,14,12,0.000686275,794156,0.89573201
13414,605,473,14,12,0.000686275,794170,0.895747801
9622,379,14,14,12,0.000686275,794184,0.895763591
7320,529,393,14,12,0.000686275,794198,0.895779382
7321,133,582,14,12,0.000686275,794212,0.895795173
12721,164,68,14,12,0.000686275,794226,0.895810963
15267,269,105,14,12,0.000686275,794240,0.895826754
18016,145,571,14,12,0.000686275,794254,0.895842545
13565,68,652,14,12,0.000686275,794268,0.895858335
15358,364,588,14,12,0.000686275,794282,0.895874126
13998,331,409,14,12,0.000686275,794296,0.895889917
12648,307,560,14,12,0.000686275,794310,0.895905707
13523,107,409,14,12,0.000686275,794324,0.895921498
12820,558,274,14,12,0.000686275,794338,0.895937289
12857,663,507,14,12,0.000686275,794352,0.895953079
12860,517,674,14,12,0.000686275,794366,0.89596887
9472,673,609,14,12,0.000686275,794380,0.895984661
13417,204,529,14,12,0.000686275,794394,0.896000451
12742,130,683,14,12,0.000686275,794408,0.896016242
12766,353,587,14,12,0.000686275,794422,0.896032032
12778,131,195,14,12,0.000686275,794436,0.896047823
7547,302,586,14,12,0.000686275,794450,0.896063614
14062,458,224,14,12,0.000686275,794464,0.896079404
12644,562,307,14,12,0.000686275,794478,0.896095195
11164,522,364,14,12,0.000686275,794492,0.896110986
11694,158,588,14,12,0.000686275,794506,0.896126776
11563,307,50,14,12,0.000686275,794520,0.896142567
11727,250,97,14,12,0.000686275,794534,0.896158358
10466,48,246,14,12,0.000686275,794548,0.896174148
11643,30,171,14,12,0.000686275,794562,0.896189939
10576,5,48,14,12,0.000686275,794576,0.89620573
11356,114,443,14,12,0.000686275,794590,0.89622152
11394,334,280,14,12,0.000686275,794604,0.896237311
11961,6,130,14,12,0.000686275,794618,0.896253102
11739,348,701,14,12,0.000686275,794632,0.896268892
10712,632,354,14,12,0.000686275,794646,0.896284683
11293,404,4,14,12,0.000686275,794660,0.896300474
11561,269,243,14,12,0.000686275,794674,0.896316264
10956,562,6,14,12,0.000686275,794688,0.896332055
11528,123,4,14,12,0.000686275,794702,0.896347846
10917,614,404,14,12,0.000686275,794716,0.896363636
10226,34,170,14,12,0.000686275,794730,0.896379427
11258,6,404,14,12,0.000686275,794744,0.896395218
11333,145,3,14,12,0.000686275,794758,0.896411008
12030,13,145,14,12,0.000686275,794772,0.896426799
10418,34,397,14,12,0.000686275,794786,0.89644259
11780,668,224,14,12,0.000686275,794800,0.89645838
10747,479,501,14,12,0.000686275,794814,0.896474171
11202,596,4,14,12,0.000686275,794828,0.896489962
11372,708,302,14,12,0.000686275,794842,0.896505752
10637,274,48,14,12,0.000686275,794856,0.896521543
11463,353,508,14,12,0.000686275,794870,0.896537334
11681,25,123,14,12,0.000686275,794884,0.896553124
10663,532,97,14,12,0.000686275,794898,0.896568915
11704,295,107,14,12,0.000686275,794912,0.896584706
11230,475,158,14,12,0.000686275,794926,0.896600496
11554,140,84,14,12,0.000686275,794940,0.896616287
11149,10,593,14,12,0.000686275,794954,0.896632078
10364,29,473,14,12,0.000686275,794968,0.896647868
11866,6,701,14,12,0.000686275,794982,0.896663659
13155,682,393,13,12,0.000637255,794995,0.896678322
13232,443,507,13,12,0.000637255,795008,0.896692984
13216,353,392,13,12,0.000637255,795021,0.896707647
6905,4,588,13,12,0.000637255,795034,0.89672231
11306,502,68,13,12,0.000637255,795047,0.896736973
11698,77,167,13,12,0.000637255,795060,0.896751635
11714,443,689,13,12,0.000637255,795073,0.896766298
15457,131,1,13,12,0.000637255,795086,0.896780961
9099,392,105,13,12,0.000637255,795099,0.896795624
15407,525,77,13,12,0.000637255,795112,0.896810286
15393,646,107,13,12,0.000637255,795125,0.896824949
15912,114,501,13,12,0.000637255,795138,0.896839612
12855,295,29,13,12,0.000637255,795151,0.896854275
9486,689,77,13,12,0.000637255,795164,0.896868938
11864,618,663,13,12,0.000637255,795177,0.8968836
12723,522,167,13,12,0.000637255,795190,0.896898263
12726,34,264,13,12,0.000637255,795203,0.896912926
12740,13,219,13,12,0.000637255,795216,0.896927589
12893,114,663,13,12,0.000637255,795229,0.896942251
11792,543,77,13,12,0.000637255,795242,0.896956914
10547,385,588,13,12,0.000637255,795255,0.896971577
11057,414,655,13,12,0.000637255,795268,0.89698624
12932,121,582,13,12,0.000637255,795281,0.897000902
12953,219,503,13,12,0.000637255,795294,0.897015565
6672,673,31,13,12,0.000637255,795307,0.897030228
13021,310,503,13,12,0.000637255,795320,0.897044891
11805,145,497,13,12,0.000637255,795333,0.897059553
9349,4,117,13,12,0.000637255,795346,0.897074216
13020,708,508,13,12,0.000637255,795359,0.897088879
10807,164,558,13,12,0.000637255,795372,0.897103542
14623,16,364,13,12,0.000637255,795385,0.897118204
14618,14,655,13,12,0.000637255,795398,0.897132867
11527,708,379,13,12,0.000637255,795411,0.89714753
8264,497,77,13,12,0.000637255,795424,0.897162193
14574,640,596,13,12,0.000637255,795437,0.897176855
10907,158,164,13,12,0.000637255,795450,0.897191518
14128,121,522,13,12,0.000637255,795463,0.897206181
14638,242,562,13,12,0.000637255,795476,0.897220844
14033,640,156,13,12,0.000637255,795489,0.897235506
7771,394,522,13,12,0.000637255,795502,0.897250169
13934,171,502,13,12,0.000637255,795515,0.897264832
14689,528,479,13,12,0.000637255,795528,0.897279495
11533,43,354,13,12,0.000637255,795541,0.897294157
14653,522,507,13,12,0.000637255,795554,0.89730882
14135,80,126,13,12,0.000637255,795567,0.897323483
11473,123,482,13,12,0.000637255,795580,0.897338146
11452,532,517,13,12,0.000637255,795593,0.897352808
14289,475,517,13,12,0.000637255,795606,0.897367471
14354,84,552,13,12,0.000637255,795619,0.897382134
11477,638,517,13,12,0.000637255,795632,0.897396797
7952,668,302,13,12,0.000637255,795645,0.89741146
11433,475,463,13,12,0.000637255,795658,0.897426122
14479,348,514,13,12,0.000637255,795671,0.897440785
10898,123,29,13,12,0.000637255,795684,0.897455448
14201,354,683,13,12,0.000637255,795697,0.897470111
7758,26,3,13,12,0.000637255,795710,0.897484773
15218,167,314,13,12,0.000637255,795723,0.897499436
18214,684,640,13,12,0.000637255,795736,0.897514099
18216,124,34,13,12,0.000637255,795749,0.897528762
11657,280,544,13,12,0.000637255,795762,0.897543424
14799,230,195,13,12,0.000637255,795775,0.897558087
11640,14,498,13,12,0.000637255,795788,0.89757275
13593,463,156,13,12,0.000637255,795801,0.897587413
13614,543,529,13,12,0.000637255,795814,0.897602075
10968,11,130,13,12,0.000637255,795827,0.897616738
11673,193,638,13,12,0.000637255,795840,0.897631401
13439,274,34,13,12,0.000637255,795853,0.897646064
10657,22,314,13,12,0.000637255,795866,0.897660726
13477,219,632,13,12,0.000637255,795879,0.897675389
11618,674,507,13,12,0.000637255,795892,0.897690052
10740,158,20,13,12,0.000637255,795905,0.897704715
13814,463,586,13,12,0.000637255,795918,0.897719377
8553,302,328,13,12,0.000637255,795931,0.89773404
10757,507,558,13,12,0.000637255,795944,0.897748703
11569,11,427,13,12,0.000637255,795957,0.897763366
13890,103,95,13,12,0.000637255,795970,0.897778028
14911,90,302,13,12,0.000637255,795983,0.897792691
15052,5,131,13,12,0.000637255,795996,0.897807354
14999,171,193,13,12,0.000637255,796009,0.897822017
14960,544,517,13,12,0.000637255,796022,0.897836679
14928,64,31,13,12,0.000637255,796035,0.897851342
13776,393,130,13,12,0.000637255,796048,0.897866005
10327,311,85,13,12,0.000637255,796061,0.897880668
12568,123,661,13,12,0.000637255,796074,0.89789533
12546,514,334,13,12,0.000637255,796087,0.897909993
9961,295,560,13,12,0.000637255,796100,0.897924656
11219,708,310,13,12,0.000637255,796113,0.897939319
16222,264,596,13,12,0.000637255,796126,0.897953982
10320,12,33,13,12,0.000637255,796139,0.897968644
11198,532,30,13,12,0.000637255,796152,0.897983307
11943,353,97,13,12,0.000637255,796165,0.89799797
16668,207,347,13,12,0.000637255,796178,0.898012633
16197,171,236,13,12,0.000637255,796191,0.898027295
17063,204,178,13,12,0.000637255,796204,0.898041958
12497,632,141,13,12,0.000637255,796217,0.898056621
9693,265,310,13,12,0.000637255,796230,0.898071284
9849,475,84,13,12,0.000637255,796243,0.898085946
11959,613,9,13,12,0.000637255,796256,0.898100609
12555,242,529,13,12,0.000637255,796269,0.898115272
12129,334,95,13,12,0.000637255,796282,0.898129935
9930,605,582,13,12,0.000637255,796295,0.898144597
12424,97,84,13,12,0.000637255,796308,0.89815926
16241,593,502,13,12,0.000637255,796321,0.898173923
12531,502,379,13,12,0.000637255,796334,0.898188586
10312,280,605,13,12,0.000637255,796347,0.898203248
17209,448,6,13,12,0.000637255,796360,0.898217911
12113,30,497,13,12,0.000637255,796373,0.898232574
14765,145,609,12,12,0.000588235,796385,0.898246109
9288,638,497,12,12,0.000588235,796397,0.898259644
14717,140,302,12,12,0.000588235,796409,0.898273178
12240,196,498,12,12,0.000588235,796421,0.898286713
13470,84,517,12,12,0.000588235,796433,0.898300248
17925,334,723,12,12,0.000588235,796445,0.898313783
13749,95,385,12,12,0.000588235,796457,0.898327318
15371,15,529,12,12,0.000588235,796469,0.898340853
17135,427,145,12,12,0.000588235,796481,0.898354388
16367,261,265,12,12,0.000588235,796493,0.898367922
11580,274,50,12,12,0.000588235,796505,0.898381457
13293,140,367,12,12,0.000588235,796517,0.898394992
12282,25,558,12,12,0.000588235,796529,0.898408527
15405,131,4,12,12,0.000588235,796541,0.898422062
19519,364,414,12,12,0.000588235,796553,0.898435597
13357,525,224,12,12,0.000588235,796565,0.898449132
11695,501,404,12,12,0.000588235,796577,0.898462666
11728,243,682,12,12,0.000588235,796589,0.898476201
21128,503,571,12,12,0.000588235,796601,0.898489736
13231,404,131,12,12,0.000588235,796613,0.898503271
19231,175,522,12,12,0.000588235,796625,0.898516806
10942,31,307,12,12,0.000588235,796637,0.898530341
10861,164,123,12,12,0.000588235,796649,0.898543875
9590,605,310,12,12,0.000588235,796661,0.89855741
10412,385,48,12,12,0.000588235,796673,0.898570945
15915,107,494,12,12,0.000588235,796685,0.89858448
14469,364,473,12,12,0.000588235,796697,0.898598015
14250,558,385,12,12,0.000588235,796709,0.89861155
12135,498,20,12,12,0.000588235,796721,0.898625085
11902,332,498,12,12,0.000588235,796733,0.898638619
13681,250,196,12,12,0.000588235,796745,0.898652154
17673,156,167,12,12,0.000588235,796757,0.898665689
10915,95,517,12,12,0.000588235,796769,0.898679224
13032,77,652,12,12,0.000588235,796781,0.898692759
13501,12,117,12,12,0.000588235,796793,0.898706294
14142,683,582,12,12,0.000588235,796805,0.898719829
14526,193,294,12,12,0.000588235,796817,0.898733363
14537,674,632,12,12,0.000588235,796829,0.898746898
13538,54,475,12,12,0.000588235,796841,0.898760433
13664,502,10,12,12,0.000588235,796853,0.898773968
12581,141,310,12,12,0.000588235,796865,0.898787503
7283,532,683,12,12,0.000588235,796877,0.898801038
14555,170,310,12,12,0.000588235,796889,0.898814573
13527,34,393,12,12,0.000588235,796901,0.898828107
12765,446,475,23,11,0.001127451,796924,0.898854049
8741,20,302,23,11,0.001127451,796947,0.898879991
9987,2,10,21,11,0.001029412,796968,0.898903677
11590,632,723,21,11,0.001029412,796989,0.898927363
10246,25,393,21,11,0.001029412,797010,0.898951049
9464,314,193,21,11,0.001029412,797031,0.898974735
10296,668,16,20,11,0.000980392,797051,0.898997293
11256,475,723,20,11,0.000980392,797071,0.899019851
10920,511,498,20,11,0.000980392,797091,0.899042409
13817,48,4,20,11,0.000980392,797111,0.899064967
9610,719,27,20,11,0.000980392,797131,0.899087525
12163,163,394,19,11,0.000931373,797150,0.899108956
12184,80,632,19,11,0.000931373,797169,0.899130386
11285,156,348,19,11,0.000931373,797188,0.899151816
9195,543,145,19,11,0.000931373,797207,0.899173246
13400,398,502,19,11,0.000931373,797226,0.899194676
12577,236,2,19,11,0.000931373,797245,0.899216106
9118,97,354,18,11,0.000882353,797263,0.899236409
11382,586,114,18,11,0.000882353,797281,0.899256711
13105,497,204,18,11,0.000882353,797299,0.899277013
11823,280,714,18,11,0.000882353,797317,0.899297316
11338,473,569,18,11,0.000882353,797335,0.899317618
11335,13,33,18,11,0.000882353,797353,0.89933792
7213,609,497,18,11,0.000882353,797371,0.899358222
11653,261,310,18,11,0.000882353,797389,0.899378525
14494,663,673,18,11,0.000882353,797407,0.899398827
8115,501,22,18,11,0.000882353,797425,0.899419129
5418,196,471,18,11,0.000882353,797443,0.899439432
9354,15,155,18,11,0.000882353,797461,0.899459734
12324,529,347,18,11,0.000882353,797479,0.899480036
11089,404,302,18,11,0.000882353,797497,0.899500338
9695,562,295,18,11,0.000882353,797515,0.899520641
12045,364,224,18,11,0.000882353,797533,0.899540943
8705,242,26,18,11,0.000882353,797551,0.899561245
10288,593,609,18,11,0.000882353,797569,0.899581547
11992,158,264,18,11,0.000882353,797587,0.89960185
11993,15,535,18,11,0.000882353,797605,0.899622152
6313,562,334,18,11,0.000882353,797623,0.899642454
13822,328,646,18,11,0.000882353,797641,0.899662757
7877,145,588,18,11,0.000882353,797659,0.899683059
11524,528,596,17,11,0.000833333,797676,0.899702233
9744,107,517,17,11,0.000833333,797693,0.899721408
14018,50,114,17,11,0.000833333,797710,0.899740582
12876,107,708,17,11,0.000833333,797727,0.899759756
13830,43,107,17,11,0.000833333,797744,0.899778931
11352,155,314,17,11,0.000833333,797761,0.899798105
6922,562,164,17,11,0.000833333,797778,0.899817279
9617,544,68,17,11,0.000833333,797795,0.899836454
15598,16,193,17,11,0.000833333,797812,0.899855628
13491,50,398,17,11,0.000833333,797829,0.899874803
8811,383,16,17,11,0.000833333,797846,0.899893977
12137,497,31,17,11,0.000833333,797863,0.899913151
14521,230,673,17,11,0.000833333,797880,0.899932326
12256,250,605,17,11,0.000833333,797897,0.8999515
11791,12,95,17,11,0.000833333,797914,0.899970674
12260,331,294,17,11,0.000833333,797931,0.899989849
16065,140,114,17,11,0.000833333,797948,0.900009023
10340,562,236,17,11,0.000833333,797965,0.900028198
10411,514,473,17,11,0.000833333,797982,0.900047372
12027,80,552,17,11,0.000833333,797999,0.900066546
12270,661,224,17,11,0.000833333,798016,0.900085721
9924,145,689,17,11,0.000833333,798033,0.900104895
11701,385,243,17,11,0.000833333,798050,0.900124069
10699,30,443,17,11,0.000833333,798067,0.900143244
13156,196,193,17,11,0.000833333,798084,0.900162418
14318,596,661,17,11,0.000833333,798101,0.900181593
8098,30,640,17,11,0.000833333,798118,0.900200767
11223,10,64,17,11,0.000833333,798135,0.900219941
13299,10,294,16,11,0.000784314,798151,0.900237988
11186,310,632,16,11,0.000784314,798167,0.900256034
17394,34,155,16,11,0.000784314,798183,0.900274081
11181,15,618,16,11,0.000784314,798199,0.900292127
13529,427,367,16,11,0.000784314,798215,0.900310174
13653,552,723,16,11,0.000784314,798231,0.90032822
14321,328,121,16,11,0.000784314,798247,0.900346267
17064,471,243,16,11,0.000784314,798263,0.900364313
12204,367,511,16,11,0.000784314,798279,0.90038236
12224,11,674,16,11,0.000784314,798295,0.900400406
12228,532,439,16,11,0.000784314,798311,0.900418453
14422,328,723,16,11,0.000784314,798327,0.900436499
12323,80,392,16,11,0.000784314,798343,0.900454545
14335,140,164,16,11,0.000784314,798359,0.900472592
12967,95,544,16,11,0.000784314,798375,0.900490638
13971,463,708,16,11,0.000784314,798391,0.900508685
12634,314,701,16,11,0.000784314,798407,0.900526731
13883,13,5,16,11,0.000784314,798423,0.900544778
12126,20,280,16,11,0.000784314,798439,0.900562824
11598,682,354,16,11,0.000784314,798455,0.900580871
11627,140,310,16,11,0.000784314,798471,0.900598917
11545,708,335,16,11,0.000784314,798487,0.900616964
13345,668,167,16,11,0.000784314,798503,0.90063501
13225,427,114,16,11,0.000784314,798519,0.900653057
11507,404,443,16,11,0.000784314,798535,0.900671103
12856,596,593,16,11,0.000784314,798551,0.90068915
14635,121,655,16,11,0.000784314,798567,0.900707196
8790,605,84,16,11,0.000784314,798583,0.900725242
7780,164,105,16,11,0.000784314,798599,0.900743289
7910,31,522,16,11,0.000784314,798615,0.900761335
10392,250,121,16,11,0.000784314,798631,0.900779382
10988,133,331,16,11,0.000784314,798647,0.900797428
8845,522,511,16,11,0.000784314,798663,0.900815475
8477,242,394,16,11,0.000784314,798679,0.900833521
8533,482,27,16,11,0.000784314,798695,0.900851568
8581,25,107,16,11,0.000784314,798711,0.900869614
8892,614,25,16,11,0.000784314,798727,0.900887661
10847,56,141,16,11,0.000784314,798743,0.900905707
8900,30,10,16,11,0.000784314,798759,0.900923754
11065,562,586,16,11,0.000784314,798775,0.9009418
10082,22,164,16,11,0.000784314,798791,0.900959847
10109,6,511,16,11,0.000784314,798807,0.900977893
11100,528,443,16,11,0.000784314,798823,0.90099594
9817,48,64,16,11,0.000784314,798839,0.901013986
10715,14,723,15,11,0.000735294,798854,0.901030905
13688,77,23,15,11,0.000735294,798869,0.901047823
10218,20,170,15,11,0.000735294,798884,0.901064742
13343,543,26,15,11,0.000735294,798899,0.90108166
9026,522,683,15,11,0.000735294,798914,0.901098579
13350,543,562,15,11,0.000735294,798929,0.901115497
13194,163,609,15,11,0.000735294,798944,0.901132416
9151,145,543,15,11,0.000735294,798959,0.901149335
11747,13,295,15,11,0.000735294,798974,0.901166253
10579,310,544,15,11,0.000735294,798989,0.901183172
13645,196,178,15,11,0.000735294,799004,0.90120009
13574,25,170,15,11,0.000735294,799019,0.901217009
8844,16,682,15,11,0.000735294,799034,0.901233927
13559,347,723,15,11,0.000735294,799049,0.901250846
10144,532,121,15,11,0.000735294,799064,0.901267764
13609,668,663,15,11,0.000735294,799079,0.901284683
10155,443,6,15,11,0.000735294,799094,0.901301602
10156,398,264,15,11,0.000735294,799109,0.90131852
12089,14,522,15,11,0.000735294,799124,0.901335439
12198,404,655,15,11,0.000735294,799139,0.901352357
13392,593,25,15,11,0.000735294,799154,0.901369276
8904,265,311,15,11,0.000735294,799169,0.901386194
10177,193,195,15,11,0.000735294,799184,0.901403113
12099,582,167,15,11,0.000735294,799199,0.901420032
9574,682,68,15,11,0.000735294,799214,0.90143695
9584,6,562,15,11,0.000735294,799229,0.901453869
11968,614,164,15,11,0.000735294,799244,0.901470787
12781,353,126,15,11,0.000735294,799259,0.901487706
9822,264,655,15,11,0.000735294,799274,0.901504624
11873,14,34,15,11,0.000735294,799289,0.901521543
10432,528,11,15,11,0.000735294,799304,0.901538462
11984,614,6,15,11,0.000735294,799319,0.90155538
11907,105,673,15,11,0.000735294,799334,0.901572299
11955,43,723,15,11,0.000735294,799349,0.901589217
11954,114,532,15,11,0.000735294,799364,0.901606136
12573,310,511,15,11,0.000735294,799379,0.901623054
9696,689,15,15,11,0.000735294,799394,0.901639973
9645,379,535,15,11,0.000735294,799409,0.901656891
11911,708,219,15,11,0.000735294,799424,0.90167381
9860,593,280,15,11,0.000735294,799439,0.901690729
10290,414,114,15,11,0.000735294,799454,0.901707647
10286,397,439,15,11,0.000735294,799469,0.901724566
13047,56,593,15,11,0.000735294,799484,0.901741484
13040,314,668,15,11,0.000735294,799499,0.901758403
13086,558,56,15,11,0.000735294,799514,0.901775321
10548,25,23,15,11,0.000735294,799529,0.90179224
13149,668,131,15,11,0.000735294,799544,0.901809159
11762,243,313,15,11,0.000735294,799559,0.901826077
10291,193,473,15,11,0.000735294,799574,0.901842996
13765,114,348,15,11,0.000735294,799589,0.901859914
12473,31,15,15,11,0.000735294,799604,0.901876833
12472,1,34,15,11,0.000735294,799619,0.901893751
11828,242,514,15,11,0.000735294,799634,0.90191067
9430,511,32,15,11,0.000735294,799649,0.901927589
12972,105,494,15,11,0.000735294,799664,0.901944507
9919,302,56,15,11,0.000735294,799679,0.901961426
10943,392,335,15,11,0.000735294,799694,0.901978344
11379,48,328,15,11,0.000735294,799709,0.901995263
7813,313,502,15,11,0.000735294,799724,0.902012181
14954,367,409,15,11,0.000735294,799739,0.9020291
7599,367,638,15,11,0.000735294,799754,0.902046018
10894,383,393,15,11,0.000735294,799769,0.902062937
14325,80,294,15,11,0.000735294,799784,0.902079856
14497,77,207,15,11,0.000735294,799799,0.902096774
7949,517,123,15,11,0.000735294,799814,0.902113693
11427,30,723,15,11,0.000735294,799829,0.902130611
11426,562,114,15,11,0.000735294,799844,0.90214753
10910,663,2,15,11,0.000735294,799859,0.902164448
11419,522,164,15,11,0.000735294,799874,0.902181367
11235,721,331,15,11,0.000735294,799889,0.902198286
16334,105,492,15,11,0.000735294,799904,0.902215204
16118,174,471,15,11,0.000735294,799919,0.902232123
16418,560,10,15,11,0.000735294,799934,0.902249041
11194,394,117,15,11,0.000735294,799949,0.90226596
5147,9,25,15,11,0.000735294,799964,0.902282878
16513,29,5,15,11,0.000735294,799979,0.902299797
16529,427,328,15,11,0.000735294,799994,0.902316716
11162,224,1,15,11,0.000735294,800009,0.902333634
15239,593,14,15,11,0.000735294,800024,0.902350553
18101,13,397,15,11,0.000735294,800039,0.902367471
7114,265,77,15,11,0.000735294,800054,0.90238439
11262,544,471,15,11,0.000735294,800069,0.902401308
17553,204,328,15,11,0.000735294,800084,0.902418227
8049,582,20,15,11,0.000735294,800099,0.902435145
8475,393,427,15,11,0.000735294,800114,0.902452064
11501,532,508,15,11,0.000735294,800129,0.902468983
14174,243,15,15,11,0.000735294,800144,0.902485901
8122,105,261,15,11,0.000735294,800159,0.90250282
11492,632,522,15,11,0.000735294,800174,0.902519738
14146,80,23,15,11,0.000735294,800189,0.902536657
10785,313,448,15,11,0.000735294,800204,0.902553575
11529,204,141,15,11,0.000735294,800219,0.902570494
10823,404,117,15,11,0.000735294,800234,0.902587413
14229,31,34,15,11,0.000735294,800249,0.902604331
13781,6,140,15,11,0.000735294,800264,0.90262125
9897,174,314,14,11,0.000686275,800278,0.90263704
16088,95,167,14,11,0.000686275,800292,0.902652831
6968,582,25,14,11,0.000686275,800306,0.902668622
13623,494,380,14,11,0.000686275,800320,0.902684412
6718,16,632,14,11,0.000686275,800334,0.902700203
13961,552,535,14,11,0.000686275,800348,0.902715994
15693,261,404,14,11,0.000686275,800362,0.902731784
15641,265,15,14,11,0.000686275,800376,0.902747575
15980,528,497,14,11,0.000686275,800390,0.902763366
9798,334,302,14,11,0.000686275,800404,0.902779156
9811,25,335,14,11,0.000686275,800418,0.902794947
6875,6,393,14,11,0.000686275,800432,0.902810738
12483,613,331,14,11,0.000686275,800446,0.902826528
12205,158,552,14,11,0.000686275,800460,0.902842319
10104,11,385,14,11,0.000686275,800474,0.90285811
12244,614,204,14,11,0.000686275,800488,0.9028739
12248,114,15,14,11,0.000686275,800502,0.902889691
10166,84,613,14,11,0.000686275,800516,0.902905482
16579,131,140,14,11,0.000686275,800530,0.902921272
12143,446,582,14,11,0.000686275,800544,0.902937063
12153,131,155,14,11,0.000686275,800558,0.902952854
16583,427,34,14,11,0.000686275,800572,0.902968644
10182,586,663,14,11,0.000686275,800586,0.902984435
12168,95,497,14,11,0.000686275,800600,0.903000226
16699,528,280,14,11,0.000686275,800614,0.903016016
16916,261,280,14,11,0.000686275,800628,0.903031807
12408,302,4,14,11,0.000686275,800642,0.903047598
10061,20,103,14,11,0.000686275,800656,0.903063388
17248,385,392,14,11,0.000686275,800670,0.903079179
13827,593,33,14,11,0.000686275,800684,0.90309497
17315,117,68,14,11,0.000686275,800698,0.90311076
17345,439,463,14,11,0.000686275,800712,0.903126551
12403,673,501,14,11,0.000686275,800726,0.903142342
16286,171,242,14,11,0.000686275,800740,0.903158132
12316,446,479,14,11,0.000686275,800754,0.903173923
16442,328,246,14,11,0.000686275,800768,0.903189714
12303,471,463,14,11,0.000686275,800782,0.903205504
16437,224,13,14,11,0.000686275,800796,0.903221295
10041,646,354,14,11,0.000686275,800810,0.903237085
16296,364,367,14,11,0.000686275,800824,0.903252876
12321,632,543,14,11,0.000686275,800838,0.903268667
13692,5,15,14,11,0.000686275,800852,0.903284457
10018,107,261,14,11,0.000686275,800866,0.903300248
8673,4,532,14,11,0.000686275,800880,0.903316039
13247,158,196,14,11,0.000686275,800894,0.903331829
13361,1,307,14,11,0.000686275,800908,0.90334762
7821,673,307,14,11,0.000686275,800922,0.903363411
12974,145,264,14,11,0.000686275,800936,0.903379201
14155,427,3,14,11,0.000686275,800950,0.903394992
13347,479,560,14,11,0.000686275,800964,0.903410783
14654,543,126,14,11,0.000686275,800978,0.903426573
13016,6,22,14,11,0.000686275,800992,0.903442364
13353,614,543,14,11,0.000686275,801006,0.903458155
14596,668,463,14,11,0.000686275,801020,0.903473945
12915,398,385,14,11,0.000686275,801034,0.903489736
7741,30,3,14,11,0.000686275,801048,0.903505527
8210,393,95,14,11,0.000686275,801062,0.903521317
14723,674,364,14,11,0.000686275,801076,0.903537108
12948,443,140,14,11,0.000686275,801090,0.903552899
14168,19,302,14,11,0.000686275,801104,0.903568689
13311,404,114,14,11,0.000686275,801118,0.90358448
13278,80,140,14,11,0.000686275,801132,0.903600271
13340,6,683,14,11,0.000686275,801146,0.903616061
14313,10,652,14,11,0.000686275,801160,0.903631852
14245,27,43,14,11,0.000686275,801174,0.903647643
13233,302,507,14,11,0.000686275,801188,0.903663433
14273,721,230,14,11,0.000686275,801202,0.903679224
14408,140,236,14,11,0.000686275,801216,0.903695015
14538,1,596,14,11,0.000686275,801230,0.903710805
13078,347,145,14,11,0.000686275,801244,0.903726596
14514,13,331,14,11,0.000686275,801258,0.903742387
13132,328,15,14,11,0.000686275,801272,0.903758177
7280,33,393,14,11,0.000686275,801286,0.903773968
15266,50,475,14,11,0.000686275,801300,0.903789759
9643,307,479,14,11,0.000686275,801314,0.903805549
15230,328,409,14,11,0.000686275,801328,0.90382134
7272,274,393,14,11,0.000686275,801342,0.903837131
14004,174,380,14,11,0.000686275,801356,0.903852921
15284,77,174,14,11,0.000686275,801370,0.903868712
7175,443,307,14,11,0.000686275,801384,0.903884503
12627,517,522,14,11,0.000686275,801398,0.903900293
15311,140,48,14,11,0.000686275,801412,0.903916084
12642,398,364,14,11,0.000686275,801426,0.903931875
18102,19,10,14,11,0.000686275,801440,0.903947665
15286,68,12,14,11,0.000686275,801454,0.903963456
13516,614,14,14,11,0.000686275,801468,0.903979247
9505,404,123,14,11,0.000686275,801482,0.903995037
7613,4,313,14,11,0.000686275,801496,0.904010828
12863,498,479,14,11,0.000686275,801510,0.904026619
14886,1,156,14,11,0.000686275,801524,0.904042409
8955,593,107,14,11,0.000686275,801538,0.9040582
9594,393,522,14,11,0.000686275,801552,0.904073991
12734,13,302,14,11,0.000686275,801566,0.904089781
7413,265,331,14,11,0.000686275,801580,0.904105572
12758,335,171,14,11,0.000686275,801594,0.904121363
14059,164,394,14,11,0.000686275,801608,0.904137153
15038,124,32,14,11,0.000686275,801622,0.904152944
13486,528,638,14,11,0.000686275,801636,0.904168734
11143,562,170,14,11,0.000686275,801650,0.904184525
11425,307,511,14,11,0.000686275,801664,0.904200316
10227,242,9,14,11,0.000686275,801678,0.904216106
11721,107,30,14,11,0.000686275,801692,0.904231897
10569,163,84,14,11,0.000686275,801706,0.904247688
11719,48,404,14,11,0.000686275,801720,0.904263478
11305,204,29,14,11,0.000686275,801734,0.904279269
11664,204,97,14,11,0.000686275,801748,0.90429506
11508,14,479,14,11,0.000686275,801762,0.90431085
11062,50,479,14,11,0.000686275,801776,0.904326641
12047,552,170,14,11,0.000686275,801790,0.904342432
10704,638,596,14,11,0.000686275,801804,0.904358222
11733,638,544,14,11,0.000686275,801818,0.904374013
10697,6,264,14,11,0.000686275,801832,0.904389804
10490,529,265,14,11,0.000686275,801846,0.904405594
11054,123,164,14,11,0.000686275,801860,0.904421385
11056,385,473,14,11,0.000686275,801874,0.904437176
12082,613,27,14,11,0.000686275,801888,0.904452966
11718,497,68,14,11,0.000686275,801902,0.904468757
12026,43,219,14,11,0.000686275,801916,0.904484548
11898,10,54,14,11,0.000686275,801930,0.904500338
11928,196,97,14,11,0.000686275,801944,0.904516129
11690,250,12,14,11,0.000686275,801958,0.90453192
11942,673,640,14,11,0.000686275,801972,0.90454771
10315,207,479,14,11,0.000686275,801986,0.904563501
10233,393,6,14,11,0.000686275,802000,0.904579292
10720,501,33,14,11,0.000686275,802014,0.904595082
17894,427,439,13,11,0.000637255,802027,0.904609745
9179,335,85,13,11,0.000637255,802040,0.904624408
9178,30,353,13,11,0.000637255,802053,0.904639071
17898,10,13,13,11,0.000637255,802066,0.904653733
6950,443,535,13,11,0.000637255,802079,0.904668396
10560,6,242,13,11,0.000637255,802092,0.904683059
13223,463,532,13,11,0.000637255,802105,0.904697722
13228,311,482,13,11,0.000637255,802118,0.904712384
10211,311,493,13,11,0.000637255,802131,0.904727047
18090,236,5,13,11,0.000637255,802144,0.90474171
10625,302,364,13,11,0.000637255,802157,0.904756373
13358,463,501,13,11,0.000637255,802170,0.904771035
10631,638,11,13,11,0.000637255,802183,0.904785698
13368,668,33,13,11,0.000637255,802196,0.904800361
9015,668,471,13,11,0.000637255,802209,0.904815024
13383,30,632,13,11,0.000637255,802222,0.904829686
15310,1,107,13,11,0.000637255,802235,0.904844349
11697,613,85,13,11,0.000637255,802248,0.904859012
13269,385,404,13,11,0.000637255,802261,0.904873675
11730,593,335,13,11,0.000637255,802274,0.904888337
13308,443,383,13,11,0.000637255,802287,0.904903
13324,353,439,13,11,0.000637255,802300,0.904917663
17609,160,596,13,11,0.000637255,802313,0.904932326
12818,204,508,13,11,0.000637255,802326,0.904946988
12825,307,562,13,11,0.000637255,802339,0.904961651
12840,398,497,13,11,0.000637255,802352,0.904976314
15903,77,13,13,11,0.000637255,802365,0.904990977
9482,280,121,13,11,0.000637255,802378,0.90500564
17581,124,295,13,11,0.000637255,802391,0.905020302
11060,97,50,13,11,0.000637255,802404,0.905034965
15892,562,385,13,11,0.000637255,802417,0.905049628
10461,4,609,13,11,0.000637255,802430,0.905064291
12884,11,562,13,11,0.000637255,802443,0.905078953
9522,582,514,13,11,0.000637255,802456,0.905093616
10397,528,77,13,11,0.000637255,802469,0.905108279
17387,394,409,13,11,0.000637255,802482,0.905122942
11242,331,661,13,11,0.000637255,802495,0.905137604
16067,34,242,13,11,0.000637255,802508,0.905152267
15954,121,471,13,11,0.000637255,802521,0.90516693
11249,265,473,13,11,0.000637255,802534,0.905181593
9570,613,105,13,11,0.000637255,802547,0.905196255
10431,586,502,13,11,0.000637255,802560,0.905210918
10433,11,15,13,11,0.000637255,802573,0.905225581
6477,514,379,13,11,0.000637255,802586,0.905240244
15865,544,97,13,11,0.000637255,802599,0.905254906
13126,295,195,13,11,0.000637255,802612,0.905269569
9453,638,655,13,11,0.000637255,802625,0.905284232
15656,50,708,13,11,0.000637255,802638,0.905298895
17813,528,347,13,11,0.000637255,802651,0.905313557
15651,117,11,13,11,0.000637255,802664,0.90532822
11786,117,123,13,11,0.000637255,802677,0.905342883
15639,193,224,13,11,0.000637255,802690,0.905357546
13114,354,274,13,11,0.000637255,802703,0.905372208
9250,674,114,13,11,0.000637255,802716,0.905386871
11774,117,529,13,11,0.000637255,802729,0.905401534
11274,80,708,13,11,0.000637255,802742,0.905416197
10492,471,663,13,11,0.000637255,802755,0.905430859
9376,543,379,13,11,0.000637255,802768,0.905445522
9362,397,663,13,11,0.000637255,802781,0.905460185
10508,310,683,13,11,0.000637255,802794,0.905474848
13403,145,544,13,11,0.000637255,802807,0.90548951
13467,30,439,13,11,0.000637255,802820,0.905504173
14614,708,126,13,11,0.000637255,802833,0.905518836
8284,708,174,13,11,0.000637255,802846,0.905533499
14600,439,68,13,11,0.000637255,802859,0.905548162
14589,34,508,13,11,0.000637255,802872,0.905562824
14562,84,511,13,11,0.000637255,802885,0.905577487
14550,544,640,13,11,0.000637255,802898,0.90559215
14122,164,141,13,11,0.000637255,802911,0.905606813
14134,674,64,13,11,0.000637255,802924,0.905621475
8316,385,123,13,11,0.000637255,802937,0.905636138
13916,334,394,13,11,0.000637255,802950,0.905650801
13921,1,638,13,11,0.000637255,802963,0.905665464
13922,3,652,13,11,0.000637255,802976,0.905680126
10928,383,498,13,11,0.000637255,802989,0.905694789
13960,107,12,13,11,0.000637255,803002,0.905709452
13970,31,596,13,11,0.000637255,803015,0.905724115
13986,552,475,13,11,0.000637255,803028,0.905738777
11407,497,311,13,11,0.000637255,803041,0.90575344
18574,701,196,13,11,0.000637255,803054,0.905768103
14680,596,632,13,11,0.000637255,803067,0.905782766
14652,593,588,13,11,0.000637255,803080,0.905797428
14409,117,471,13,11,0.000637255,803093,0.905812091
14404,12,170,13,11,0.000637255,803106,0.905826754
8080,655,379,13,11,0.000637255,803119,0.905841417
14383,353,54,13,11,0.000637255,803132,0.905856079
14286,242,558,13,11,0.000637255,803145,0.905870742
10888,107,544,13,11,0.000637255,803158,0.905885405
14310,174,30,13,11,0.000637255,803171,0.905900068
8025,668,80,13,11,0.000637255,803184,0.90591473
8082,95,26,13,11,0.000637255,803197,0.905929393
14410,243,163,13,11,0.000637255,803210,0.905944056
14523,471,596,13,11,0.000637255,803223,0.905958719
7960,261,80,13,11,0.000637255,803236,0.905973381
14176,14,5,13,11,0.000637255,803249,0.905988044
14491,427,68,13,11,0.000637255,803262,0.906002707
10838,632,158,13,11,0.000637255,803275,0.90601737
8108,383,354,13,11,0.000637255,803288,0.906032032
14483,10,207,13,11,0.000637255,803301,0.906046695
14474,310,140,13,11,0.000637255,803314,0.906061358
14464,334,558,13,11,0.000637255,803327,0.906076021
14215,230,409,13,11,0.000637255,803340,0.906090684
14225,164,230,13,11,0.000637255,803353,0.906105346
8424,501,302,13,11,0.000637255,803366,0.906120009
8796,4,302,13,11,0.000637255,803379,0.906134672
13552,95,562,13,11,0.000637255,803392,0.906149335
18231,167,353,13,11,0.000637255,803405,0.906163997
10691,367,674,13,11,0.000637255,803418,0.90617866
11343,26,543,13,11,0.000637255,803431,0.906193323
13633,522,508,13,11,0.000637255,803444,0.906207986
11347,145,156,13,11,0.000637255,803457,0.906222648
8903,12,473,13,11,0.000637255,803470,0.906237311
11688,310,364,13,11,0.000637255,803483,0.906251974
13421,171,497,13,11,0.000637255,803496,0.906266637
18116,661,31,13,11,0.000637255,803509,0.906281299
13426,56,25,13,11,0.000637255,803522,0.906295962
10651,12,501,13,11,0.000637255,803535,0.906310625
11001,34,394,13,11,0.000637255,803548,0.906325288
8934,673,427,13,11,0.000637255,803561,0.90633995
18130,364,479,13,11,0.000637255,803574,0.906354613
11091,6,164,13,11,0.000637255,803587,0.906369276
13650,439,609,13,11,0.000637255,803600,0.906383939
13788,463,280,13,11,0.000637255,803613,0.906398601
8557,353,683,13,11,0.000637255,803626,0.906413264
14866,334,15,13,11,0.000637255,803639,0.906427927
13843,543,640,13,11,0.000637255,803652,0.90644259
13876,552,393,13,11,0.000637255,803665,0.906457252
8493,15,3,13,11,0.000637255,803678,0.906471915
13888,544,596,13,11,0.000637255,803691,0.906486578
8693,22,26,13,11,0.000637255,803704,0.906501241
15042,663,514,13,11,0.000637255,803717,0.906515903
19344,328,661,13,11,0.000637255,803730,0.906530566
15015,124,347,13,11,0.000637255,803743,0.906545229
15013,56,34,13,11,0.000637255,803756,0.906559892
13696,514,502,13,11,0.000637255,803769,0.906574554
11365,265,588,13,11,0.000637255,803782,0.906589217
10374,379,145,13,11,0.000637255,803795,0.90660388
12148,640,427,13,11,0.000637255,803808,0.906618543
12147,593,84,13,11,0.000637255,803821,0.906633206
10153,224,20,13,11,0.000637255,803834,0.906647868
12169,274,535,13,11,0.000637255,803847,0.906662531
12170,29,331,13,11,0.000637255,803860,0.906677194
9677,6,446,13,11,0.000637255,803873,0.906691857
12449,394,56,13,11,0.000637255,803886,0.906706519
10193,265,264,13,11,0.000637255,803899,0.906721182
17082,613,123,13,11,0.000637255,803912,0.906735845
9906,463,475,13,11,0.000637255,803925,0.906750508
16368,638,167,13,11,0.000637255,803938,0.90676517
12164,492,609,13,11,0.000637255,803951,0.906779833
12470,31,367,13,11,0.000637255,803964,0.906794496
16605,155,105,13,11,0.000637255,803977,0.906809159
9879,511,9,13,11,0.000637255,803990,0.906823821
12382,379,121,13,11,0.000637255,804003,0.906838484
12554,140,9,13,11,0.000637255,804016,0.906853147
16365,48,448,13,11,0.000637255,804029,0.90686781
9771,544,638,13,11,0.000637255,804042,0.906882472
12335,392,394,13,11,0.000637255,804055,0.906897135
10256,302,587,13,11,0.000637255,804068,0.906911798
10329,10,156,13,11,0.000637255,804081,0.906926461
12242,354,265,13,11,0.000637255,804094,0.906941123
12388,56,117,13,11,0.000637255,804107,0.906955786
16395,12,31,13,11,0.000637255,804120,0.906970449
12427,219,543,13,11,0.000637255,804133,0.906985112
12299,54,48,13,11,0.000637255,804146,0.906999774
10285,463,164,13,11,0.000637255,804159,0.907014437
12081,558,164,13,11,0.000637255,804172,0.9070291
10309,43,335,13,11,0.000637255,804185,0.907043763
12222,164,463,13,11,0.000637255,804198,0.907058425
16394,193,511,13,11,0.000637255,804211,0.907073088
12078,264,310,13,11,0.000637255,804224,0.907087751
12591,140,331,13,11,0.000637255,804237,0.907102414
11144,689,535,13,11,0.000637255,804250,0.907117076
12354,95,250,13,11,0.000637255,804263,0.907131739
12007,265,141,13,11,0.000637255,804276,0.907146402
16586,502,398,13,11,0.000637255,804289,0.907161065
19622,498,178,12,11,0.000588235,804301,0.9071746
11362,12,558,12,11,0.000588235,804313,0.907188134
10562,204,544,12,11,0.000588235,804325,0.907201669
10091,367,689,12,11,0.000588235,804337,0.907215204
12389,646,582,12,11,0.000588235,804349,0.907228739
12252,525,582,12,11,0.000588235,804361,0.907242274
15655,5,517,12,11,0.000588235,804373,0.907255809
10998,280,328,12,11,0.000588235,804385,0.907269344
10111,310,543,12,11,0.000588235,804397,0.907282878
10719,123,543,12,11,0.000588235,804409,0.907296413
17054,328,30,12,11,0.000588235,804421,0.907309948
15643,427,31,12,11,0.000588235,804433,0.907323483
12376,265,164,12,11,0.000588235,804445,0.907337018
13703,379,552,12,11,0.000588235,804457,0.907350553
12032,193,295,12,11,0.000588235,804469,0.907364088
15227,528,33,12,11,0.000588235,804481,0.907377622
18610,609,269,12,11,0.000588235,804493,0.907391157
12314,708,471,12,11,0.000588235,804505,0.907404692
11328,32,294,12,11,0.000588235,804517,0.907418227
14015,27,138,12,11,0.000588235,804529,0.907431762
13118,140,123,12,11,0.000588235,804541,0.907445297
15603,409,397,12,11,0.000588235,804553,0.907458831
20106,503,558,12,11,0.000588235,804565,0.907472366
9968,280,20,12,11,0.000588235,804577,0.907485901
13989,3,156,12,11,0.000588235,804589,0.907499436
8672,383,311,12,11,0.000588235,804601,0.907512971
13983,353,140,12,11,0.000588235,804613,0.907526506
6834,133,80,12,11,0.000588235,804625,0.907540041
14711,525,353,12,11,0.000588235,804637,0.907553575
8930,295,114,12,11,0.000588235,804649,0.90756711
6958,295,158,12,11,0.000588235,804661,0.907580645
9071,265,9,12,11,0.000588235,804673,0.90759418
15391,334,335,12,11,0.000588235,804685,0.907607715
11691,353,121,12,11,0.000588235,804697,0.90762125
11722,507,204,12,11,0.000588235,804709,0.907634785
10640,501,307,12,11,0.000588235,804721,0.907648319
10947,379,34,12,11,0.000588235,804733,0.907661854
12451,140,107,12,11,0.000588235,804745,0.907675389
11725,673,114,12,11,0.000588235,804757,0.907688924
13288,632,535,12,11,0.000588235,804769,0.907702459
14894,544,196,12,11,0.000588235,804781,0.907715994
14939,43,131,12,11,0.000588235,804793,0.907729529
8624,514,9,12,11,0.000588235,804805,0.907743063
11002,31,498,12,11,0.000588235,804817,0.907756598
11314,383,10,12,11,0.000588235,804829,0.907770133
13396,243,204,12,11,0.000588235,804841,0.907783668
13401,517,655,12,11,0.000588235,804853,0.907797203
8981,397,307,12,11,0.000588235,804865,0.907810738
11309,721,586,12,11,0.000588235,804877,0.907824273
13914,614,439,12,11,0.000588235,804889,0.907837807
13215,640,562,12,11,0.000588235,804901,0.907851342
13728,618,379,12,11,0.000588235,804913,0.907864877
11994,397,674,12,11,0.000588235,804925,0.907878412
13217,196,397,12,11,0.000588235,804937,0.907891947
13438,207,588,12,11,0.000588235,804949,0.907905482
13729,30,50,12,11,0.000588235,804961,0.907919016
15519,50,609,12,11,0.000588235,804973,0.907932551
13901,331,163,12,11,0.000588235,804985,0.907946086
10765,163,105,12,11,0.000588235,804997,0.907959621
9864,31,334,12,11,0.000588235,805009,0.907973156
14332,3,503,12,11,0.000588235,805021,0.907986691
12273,15,334,12,11,0.000588235,805033,0.908000226
13845,720,6,12,11,0.000588235,805045,0.90801376
12068,30,532,12,11,0.000588235,805057,0.908027295
5366,507,80,12,11,0.000588235,805069,0.90804083
13256,50,295,12,11,0.000588235,805081,0.908054365
18408,720,195,12,11,0.000588235,805093,0.9080679
15462,174,655,12,11,0.000588235,805105,0.908081435
18488,385,348,12,11,0.000588235,805117,0.90809497
12396,353,517,12,11,0.000588235,805129,0.908108504
13037,167,31,12,11,0.000588235,805141,0.908122039
14230,311,155,12,11,0.000588235,805153,0.908135574
16814,290,141,12,11,0.000588235,805165,0.908149109
14441,314,269,12,11,0.000588235,805177,0.908162644
14220,347,655,12,11,0.000588235,805189,0.908176179
15143,33,155,12,11,0.000588235,805201,0.908189714
14248,443,439,12,11,0.000588235,805213,0.908203248
17336,246,596,12,11,0.000588235,805225,0.908216783
14411,529,646,12,11,0.000588235,805237,0.908230318
14416,409,11,12,11,0.000588235,805249,0.908243853
11158,497,22,12,11,0.000588235,805261,0.908257388
18832,683,596,12,11,0.000588235,805273,0.908270923
16509,479,624,12,11,0.000588235,805285,0.908284457
14487,145,243,12,11,0.000588235,805297,0.908297992
16864,689,34,12,11,0.000588235,805309,0.908311527
18349,124,310,12,11,0.000588235,805321,0.908325062
14207,544,397,12,11,0.000588235,805333,0.908338597
15058,517,34,12,11,0.000588235,805345,0.908352132
11619,12,588,12,11,0.000588235,805357,0.908365667
13557,514,558,12,11,0.000588235,805369,0.908379201
12037,274,307,12,11,0.000588235,805381,0.908392736
13596,502,663,12,11,0.000588235,805393,0.908406271
14368,33,683,12,11,0.000588235,805405,0.908419806
14374,219,64,12,11,0.000588235,805417,0.908433341
12040,30,498,12,11,0.000588235,805429,0.908446876
11245,302,274,12,11,0.000588235,805441,0.908460411
12688,33,164,12,11,0.000588235,805453,0.908473945
10976,529,68,12,11,0.000588235,805465,0.90848748
14304,582,701,12,11,0.000588235,805477,0.908501015
17030,155,22,12,11,0.000588235,805489,0.90851455
14323,393,97,12,11,0.000588235,805501,0.908528085
16138,25,15,12,11,0.000588235,805513,0.90854162
10883,473,174,12,11,0.000588235,805525,0.908555155
12043,243,414,12,11,0.000588235,805537,0.908568689
13616,54,582,12,11,0.000588235,805549,0.908582224
7404,196,3,12,11,0.000588235,805561,0.908595759
8775,638,708,12,11,0.000588235,805573,0.908609294
17351,121,335,12,11,0.000588235,805585,0.908622829
14386,242,311,12,11,0.000588235,805597,0.908636364
16037,334,497,12,11,0.000588235,805609,0.908649898
9599,379,265,12,11,0.000588235,805621,0.908663433
11451,379,562,12,11,0.000588235,805633,0.908676968
17467,552,114,12,11,0.000588235,805645,0.908690503
15073,328,501,12,11,0.000588235,805657,0.908704038
14275,2,29,12,11,0.000588235,805669,0.908717573
10403,632,334,12,11,0.000588235,805681,0.908731108
6371,4,123,12,11,0.000588235,805693,0.908744642
14391,204,121,12,11,0.000588235,805705,0.908758177
11471,552,334,12,11,0.000588235,805717,0.908771712
9717,302,404,12,11,0.000588235,805729,0.908785247
14165,43,77,12,11,0.000588235,805741,0.908798782
14581,404,25,12,11,0.000588235,805753,0.908812317
10986,196,463,12,11,0.000588235,805765,0.908825852
14588,414,514,12,11,0.000588235,805777,0.908839386
12057,443,328,12,11,0.000588235,805789,0.908852921
15748,1,497,12,11,0.000588235,805801,0.908866456
14568,517,84,12,11,0.000588235,805813,0.908879991
11853,558,560,12,11,0.000588235,805825,0.908893526
11220,655,313,12,11,0.000588235,805837,0.908907061
14573,552,196,12,11,0.000588235,805849,0.908920596
16265,463,562,12,11,0.000588235,805861,0.90893413
12951,97,126,12,11,0.000588235,805873,0.908947665
11429,393,501,12,11,0.000588235,805885,0.9089612
13010,720,479,12,11,0.000588235,805897,0.908974735
17761,471,85,12,11,0.000588235,805909,0.90898827
13017,618,34,12,11,0.000588235,805921,0.909001805
12217,50,348,12,11,0.000588235,805933,0.909015339
13698,502,32,12,11,0.000588235,805945,0.909028874
15744,588,507,12,11,0.000588235,805957,0.909042409
12992,682,302,12,11,0.000588235,805969,0.909055944
16640,31,640,12,11,0.000588235,805981,0.909069479
16917,230,593,12,11,0.000588235,805993,0.909083014
13497,121,32,12,11,0.000588235,806005,0.909096549
12892,20,10,12,11,0.000588235,806017,0.909110083
17271,167,473,12,11,0.000588235,806029,0.909123618
15032,463,243,12,11,0.000588235,806041,0.909137153
12898,397,170,12,11,0.000588235,806053,0.909150688
14516,10,482,12,11,0.000588235,806065,0.909164223
9766,721,84,12,11,0.000588235,806077,0.909177758
14154,307,517,12,11,0.000588235,806089,0.909191293
15028,236,29,12,11,0.000588235,806101,0.909204827
10672,543,196,12,11,0.000588235,806113,0.909218362
15027,290,307,12,11,0.000588235,806125,0.909231897
15816,1,701,12,11,0.000588235,806137,0.909245432
14109,443,170,12,11,0.000588235,806149,0.909258967
18392,392,439,11,11,0.000539216,806160,0.909271374
12309,243,471,11,11,0.000539216,806171,0.909283781
8641,302,562,11,11,0.000539216,806182,0.909296188
14997,5,29,11,11,0.000539216,806193,0.909308595
14974,668,230,11,11,0.000539216,806204,0.909321002
12306,708,655,11,11,0.000539216,806215,0.909333409
10824,514,609,11,11,0.000539216,806226,0.909345815
12096,683,80,11,11,0.000539216,806237,0.909358222
11506,673,25,11,11,0.000539216,806248,0.909370629
7958,274,354,11,11,0.000539216,806259,0.909383036
14167,535,409,11,11,0.000539216,806270,0.909395443
12173,95,107,11,11,0.000539216,806281,0.90940785
10798,409,582,11,11,0.000539216,806292,0.909420257
8256,9,246,11,11,0.000539216,806303,0.909432664
16661,230,181,11,11,0.000539216,806314,0.909445071
13763,398,274,11,11,0.000539216,806325,0.909457478
11163,133,16,11,11,0.000539216,806336,0.909469885
12132,646,335,11,11,0.000539216,806347,0.909482292
11455,618,522,11,11,0.000539216,806358,0.909494699
14351,163,514,11,11,0.000539216,806369,0.909507106
10886,332,219,11,11,0.000539216,806380,0.909519513
14346,414,313,11,11,0.000539216,806391,0.90953192
14343,160,310,11,11,0.000539216,806402,0.909544327
14455,84,54,11,11,0.000539216,806413,0.909556734
14424,543,48,11,11,0.000539216,806424,0.909569141
14251,261,443,11,11,0.000539216,806435,0.909581547
14816,307,427,11,11,0.000539216,806446,0.909593954
12264,133,32,11,11,0.000539216,806457,0.909606361
14660,250,392,11,11,0.000539216,806468,0.909618768
13924,171,174,11,11,0.000539216,806479,0.909631175
16152,328,204,11,11,0.000539216,806490,0.909643582
16258,84,507,11,11,0.000539216,806501,0.909655989
12927,95,29,11,11,0.000539216,806512,0.909668396
9878,95,689,11,11,0.000539216,806523,0.909680803
17660,174,170,11,11,0.000539216,806534,0.90969321
15685,511,397,11,11,0.000539216,806545,0.909705617
13043,501,560,11,11,0.000539216,806556,0.909718024
16256,544,22,11,11,0.000539216,806567,0.909730431
13212,588,181,11,11,0.000539216,806578,0.909742838
17155,250,544,11,11,0.000539216,806589,0.909755245
17789,701,34,11,11,0.000539216,806600,0.909767652
12773,674,196,11,11,0.000539216,806611,0.909780059
15425,501,4,11,11,0.000539216,806622,0.909792466
11729,544,3,11,11,0.000539216,806633,0.909804873
9896,463,77,11,11,0.000539216,806644,0.909817279
12881,95,398,11,11,0.000539216,806655,0.909829686
17620,5,522,11,11,0.000539216,806666,0.909842093
15854,178,20,11,11,0.000539216,806677,0.9098545
15611,23,26,11,11,0.000539216,806688,0.909866907
10465,614,3,11,11,0.000539216,806699,0.909879314
9290,280,117,11,11,0.000539216,806710,0.909891721
16307,230,383,11,11,0.000539216,806721,0.909904128
17571,529,475,11,11,0.000539216,806732,0.909916535
9818,242,123,11,11,0.000539216,806743,0.909928942
10570,507,26,11,11,0.000539216,806754,0.909941349
15526,427,348,11,11,0.000539216,806765,0.909953756
12906,638,501,11,11,0.000539216,806776,0.909966163
11662,145,508,11,11,0.000539216,806787,0.90997857
15173,522,714,11,11,0.000539216,806798,0.909990977
13542,394,439,11,11,0.000539216,806809,0.910003384
12686,497,558,11,11,0.000539216,806820,0.910015791
11674,497,264,11,11,0.000539216,806831,0.910028198
19444,261,12,11,11,0.000539216,806842,0.910040605
12677,250,348,11,11,0.000539216,806853,0.910053012
11668,204,3,11,11,0.000539216,806864,0.910065418
15097,588,195,11,11,0.000539216,806875,0.910077825
8839,48,708,11,11,0.000539216,806886,0.910090232
16119,463,404,11,11,0.000539216,806897,0.910102639
18108,34,682,11,11,0.000539216,806908,0.910115046
12631,224,23,11,11,0.000539216,806919,0.910127453
11900,31,562,11,11,0.000539216,806930,0.91013986
12941,473,673,11,11,0.000539216,806941,0.910152267
6327,596,158,11,11,0.000539216,806952,0.910164674
13454,26,507,11,11,0.000539216,806963,0.910177081
12225,30,560,24,10,0.001176471,806987,0.910204151
11931,130,56,21,10,0.001029412,807008,0.910227837
10136,367,502,20,10,0.000980392,807028,0.910250395
14919,708,207,20,10,0.000980392,807048,0.910272953
10076,156,33,18,10,0.000882353,807066,0.910293255
12467,80,207,18,10,0.000882353,807084,0.910313557
9572,77,261,18,10,0.000882353,807102,0.91033386
13658,34,511,17,10,0.000833333,807119,0.910353034
10723,117,393,17,10,0.000833333,807136,0.910372208
12895,558,618,17,10,0.000833333,807153,0.910391383
10892,463,638,17,10,0.000833333,807170,0.910410557
13785,13,475,17,10,0.000833333,807187,0.910429732
16601,68,207,17,10,0.000833333,807204,0.910448906
10337,473,605,17,10,0.000833333,807221,0.91046808
10670,492,310,17,10,0.000833333,807238,0.910487255
11302,439,394,17,10,0.000833333,807255,0.910506429
16571,160,25,16,10,0.000784314,807271,0.910524476
12361,80,503,16,10,0.000784314,807287,0.910542522
12279,31,170,16,10,0.000784314,807303,0.910560568
12550,532,269,16,10,0.000784314,807319,0.910578615
12774,719,68,16,10,0.000784314,807335,0.910596661
12792,14,475,16,10,0.000784314,807351,0.910614708
13762,164,367,16,10,0.000784314,807367,0.910632754
13870,131,517,16,10,0.000784314,807383,0.910650801
12603,25,562,16,10,0.000784314,807399,0.910668847
11685,501,170,16,10,0.000784314,807415,0.910686894
15154,511,307,16,10,0.000784314,807431,0.91070494
13548,145,560,16,10,0.000784314,807447,0.910722987
14825,689,130,16,10,0.000784314,807463,0.910741033
11999,250,663,16,10,0.000784314,807479,0.91075908
15006,155,164,16,10,0.000784314,807495,0.910777126
13494,2,1,16,10,0.000784314,807511,0.910795173
10930,614,15,16,10,0.000784314,807527,0.910813219
9608,501,3,16,10,0.000784314,807543,0.910831266
9596,394,348,16,10,0.000784314,807559,0.910849312
9563,544,95,16,10,0.000784314,807575,0.910867358
8745,307,640,16,10,0.000784314,807591,0.910885405
8498,393,117,16,10,0.000784314,807607,0.910903451
6240,307,334,16,10,0.000784314,807623,0.910921498
9960,394,471,16,10,0.000784314,807639,0.910939544
10298,497,141,16,10,0.000784314,807655,0.910957591
6911,196,174,16,10,0.000784314,807671,0.910975637
13326,11,544,15,10,0.000735294,807686,0.910992556
9147,274,614,15,10,0.000735294,807701,0.911009474
10726,331,392,15,10,0.000735294,807716,0.911026393
13558,310,646,15,10,0.000735294,807731,0.911043312
8795,138,27,15,10,0.000735294,807746,0.91106023
13430,684,16,15,10,0.000735294,807761,0.911077149
12179,1,640,15,10,0.000735294,807776,0.911094067
8922,463,334,15,10,0.000735294,807791,0.911110986
13628,511,33,15,10,0.000735294,807806,0.911127904
9577,638,689,15,10,0.000735294,807821,0.911144823
19814,85,646,15,10,0.000735294,807836,0.911161741
12572,517,347,15,10,0.000735294,807851,0.91117866
10378,498,114,15,10,0.000735294,807866,0.911195579
11914,397,463,15,10,0.000735294,807881,0.911212497
13048,501,328,15,10,0.000735294,807896,0.911229416
9470,605,443,15,10,0.000735294,807911,0.911246334
13028,22,32,15,10,0.000735294,807926,0.911263253
14923,529,605,15,10,0.000735294,807941,0.911280171
10949,6,497,15,10,0.000735294,807956,0.91129709
14992,414,392,15,10,0.000735294,807971,0.911314009
11360,246,380,15,10,0.000735294,807986,0.911330927
11350,204,164,15,10,0.000735294,808001,0.911347846
15090,167,224,15,10,0.000735294,808016,0.911364764
11466,274,638,15,10,0.000735294,808031,0.911381683
14405,50,663,15,10,0.000735294,808046,0.911398601
14449,31,250,15,10,0.000735294,808061,0.91141552
11441,117,497,15,10,0.000735294,808076,0.911432439
14525,348,528,15,10,0.000735294,808091,0.911449357
15186,439,689,15,10,0.000735294,808106,0.911466276
16376,158,723,15,10,0.000735294,808121,0.911483194
15190,517,114,15,10,0.000735294,808136,0.911500113
11502,404,26,15,10,0.000735294,808151,0.911517031
11565,552,511,15,10,0.000735294,808166,0.91153395
14072,219,502,15,10,0.000735294,808181,0.911550868
11484,3,552,15,10,0.000735294,808196,0.911567787
14253,394,54,15,10,0.000735294,808211,0.911584706
12416,543,243,14,10,0.000686275,808225,0.911600496
8499,532,141,14,10,0.000686275,808239,0.911616287
15990,13,307,14,10,0.000686275,808253,0.911632078
12532,295,398,14,10,0.000686275,808267,0.911647868
12547,32,414,14,10,0.000686275,808281,0.911663659
9856,529,164,14,10,0.000686275,808295,0.91167945
8746,609,532,14,10,0.000686275,808309,0.91169524
15505,544,562,14,10,0.000686275,808323,0.911711031
10105,6,529,14,10,0.000686275,808337,0.911726822
13782,158,171,14,10,0.000686275,808351,0.911742612
12141,586,463,14,10,0.000686275,808365,0.911758403
12350,22,230,14,10,0.000686275,808379,0.911774194
13705,380,493,14,10,0.000686275,808393,0.911789984
14706,280,392,14,10,0.000686275,808407,0.911805775
14698,274,196,14,10,0.000686275,808421,0.911821566
12996,596,544,14,10,0.000686275,808435,0.911837356
13373,130,528,14,10,0.000686275,808449,0.911853147
12947,103,354,14,10,0.000686275,808463,0.911868938
13172,20,50,14,10,0.000686275,808477,0.911884728
13186,475,508,14,10,0.000686275,808491,0.911900519
9123,398,280,14,10,0.000686275,808505,0.911916309
8007,673,529,14,10,0.000686275,808519,0.9119321
13139,43,394,14,10,0.000686275,808533,0.911947891
13058,133,274,14,10,0.000686275,808547,0.911963681
19009,347,448,14,10,0.000686275,808561,0.911979472
14470,719,31,14,10,0.000686275,808575,0.911995263
13124,56,97,14,10,0.000686275,808589,0.912011053
9064,593,230,14,10,0.000686275,808603,0.912026844
15228,163,25,14,10,0.000686275,808617,0.912042635
13524,517,393,14,10,0.000686275,808631,0.912058425
9647,614,638,14,10,0.000686275,808645,0.912074216
12614,673,689,14,10,0.000686275,808659,0.912090007
14272,502,522,14,10,0.000686275,808673,0.912105797
14962,50,655,14,10,0.000686275,808687,0.912121588
9530,295,30,14,10,0.000686275,808701,0.912137379
12817,475,11,14,10,0.000686275,808715,0.912153169
9497,511,353,14,10,0.000686275,808729,0.91216896
9561,558,508,14,10,0.000686275,808743,0.912184751
10975,20,562,14,10,0.000686275,808757,0.912200541
12039,640,723,14,10,0.000686275,808771,0.912216332
11757,103,473,14,10,0.000686275,808785,0.912232123
11950,307,243,14,10,0.000686275,808799,0.912247913
11411,31,30,14,10,0.000686275,808813,0.912263704
10507,367,14,14,10,0.000686275,808827,0.912279495
10772,398,4,14,10,0.000686275,808841,0.912295285
11393,674,265,14,10,0.000686275,808855,0.912311076
12053,307,30,14,10,0.000686275,808869,0.912326867
11053,204,354,14,10,0.000686275,808883,0.912342657
11827,673,544,14,10,0.000686275,808897,0.912358448
11415,295,274,14,10,0.000686275,808911,0.912374239
11700,618,97,14,10,0.000686275,808925,0.912390029
11895,673,170,14,10,0.000686275,808939,0.91240582
11370,404,68,14,10,0.000686275,808953,0.912421611
10406,404,313,14,10,0.000686275,808967,0.912437401
11284,68,683,14,10,0.000686275,808981,0.912453192
11865,25,522,14,10,0.000686275,808995,0.912468983
11105,562,48,14,10,0.000686275,809009,0.912484773
13201,32,207,13,10,0.000637255,809022,0.912499436
11761,32,714,13,10,0.000637255,809035,0.912514099
11031,54,27,13,10,0.000637255,809048,0.912528762
9154,310,117,13,10,0.000637255,809061,0.912543424
13208,380,508,13,10,0.000637255,809074,0.912558087
13344,522,171,13,10,0.000637255,809087,0.91257275
13355,663,29,13,10,0.000637255,809100,0.912587413
13372,22,130,13,10,0.000637255,809113,0.912602075
15318,479,448,13,10,0.000637255,809126,0.912616738
11310,242,501,13,10,0.000637255,809139,0.912631401
15312,193,219,13,10,0.000637255,809152,0.912646064
9141,397,614,13,10,0.000637255,809165,0.912660726
13273,638,117,13,10,0.000637255,809178,0.912675389
10559,618,335,13,10,0.000637255,809191,0.912690052
18021,48,202,13,10,0.000637255,809204,0.912704715
15599,332,141,13,10,0.000637255,809217,0.912719377
10439,1,195,13,10,0.000637255,809230,0.91273404
11854,195,558,13,10,0.000637255,809243,0.912748703
15925,156,130,13,10,0.000637255,809256,0.912763366
17580,250,269,13,10,0.000637255,809269,0.912778028
12864,562,640,13,10,0.000637255,809282,0.912792691
10458,33,562,13,10,0.000637255,809295,0.912807354
16017,348,290,13,10,0.000637255,809308,0.912822017
11246,493,394,13,10,0.000637255,809321,0.912836679
11910,97,367,13,10,0.000637255,809334,0.912851342
12700,398,130,13,10,0.000637255,809347,0.912866005
12748,131,528,13,10,0.000637255,809360,0.912880668
12753,682,243,13,10,0.000637255,809373,0.91289533
11877,114,586,13,10,0.000637255,809386,0.912909993
12782,15,84,13,10,0.000637255,809399,0.912924656
15970,471,280,13,10,0.000637255,809412,0.912939319
9546,507,123,13,10,0.000637255,809425,0.912953982
11795,50,427,13,10,0.000637255,809438,0.912968644
15674,105,701,13,10,0.000637255,809451,0.912983307
15665,167,32,13,10,0.000637255,809464,0.91299797
15642,3,646,13,10,0.000637255,809477,0.913012633
13085,14,10,13,10,0.000637255,809490,0.913027295
9279,543,6,13,10,0.000637255,809503,0.913041958
9346,605,77,13,10,0.000637255,809516,0.913056621
11816,367,34,13,10,0.000637255,809529,0.913071284
11266,15,640,13,10,0.000637255,809542,0.913085946
15805,171,130,13,10,0.000637255,809555,0.913100609
15757,1,532,13,10,0.000637255,809568,0.913115272
17729,596,342,13,10,0.000637255,809581,0.913129935
15737,414,242,13,10,0.000637255,809594,0.913144597
9363,655,334,13,10,0.000637255,809607,0.91315926
13015,663,140,13,10,0.000637255,809620,0.913173923
15294,131,2,13,10,0.000637255,809633,0.913188586
11417,310,652,13,10,0.000637255,809646,0.913203248
14601,250,145,13,10,0.000637255,809659,0.913217911
11422,156,638,13,10,0.000637255,809672,0.913232574
8439,302,529,13,10,0.000637255,809685,0.913247237
14102,475,141,13,10,0.000637255,809698,0.913261899
14564,121,10,13,10,0.000637255,809711,0.913276562
14553,6,448,13,10,0.000637255,809724,0.913291225
10816,497,107,13,10,0.000637255,809737,0.913305888
14541,193,380,13,10,0.000637255,809750,0.91332055
14761,668,95,13,10,0.000637255,809763,0.913335213
14743,167,131,13,10,0.000637255,809776,0.913349876
14721,335,269,13,10,0.000637255,809789,0.913364539
10927,397,605,13,10,0.000637255,809802,0.913379201
14000,609,514,13,10,0.000637255,809815,0.913393864
18582,171,624,13,10,0.000637255,809828,0.913408527
14530,50,64,13,10,0.000637255,809841,0.91342319
19045,243,5,13,10,0.000637255,809854,0.913437852
14268,20,178,13,10,0.000637255,809867,0.913452515
14283,632,544,13,10,0.000637255,809880,0.913467178
14287,331,207,13,10,0.000637255,809893,0.913481841
14298,492,84,13,10,0.000637255,809906,0.913496503
8018,393,56,13,10,0.000637255,809919,0.913511166
10881,471,638,13,10,0.000637255,809932,0.913525829
14160,596,503,13,10,0.000637255,809945,0.913540492
14490,347,443,13,10,0.000637255,809958,0.913555155
14191,398,97,13,10,0.000637255,809971,0.913569817
14192,20,3,13,10,0.000637255,809984,0.91358448
14213,632,171,13,10,0.000637255,809997,0.913599143
15189,673,56,13,10,0.000637255,810010,0.913613806
15166,114,723,13,10,0.000637255,810023,0.913628468
11634,29,230,13,10,0.000637255,810036,0.913643131
13632,562,609,13,10,0.000637255,810049,0.913657794
13489,20,443,13,10,0.000637255,810062,0.913672457
13420,517,26,13,10,0.000637255,810075,0.913687119
13422,68,178,13,10,0.000637255,810088,0.913701782
15281,117,367,13,10,0.000637255,810101,0.913716445
13434,528,498,13,10,0.000637255,810114,0.913731108
8918,1,379,13,10,0.000637255,810127,0.91374577
13455,498,364,13,10,0.000637255,810140,0.913760433
13464,56,475,13,10,0.000637255,810153,0.913775096
13473,605,596,13,10,0.000637255,810166,0.913789759
13790,140,586,13,10,0.000637255,810179,0.913804421
8560,493,105,13,10,0.000637255,810192,0.913819084
11582,493,354,13,10,0.000637255,810205,0.913833747
13846,404,11,13,10,0.000637255,810218,0.91384841
14842,50,31,13,10,0.000637255,810231,0.913863072
14819,224,701,13,10,0.000637255,810244,0.913877735
8594,543,331,13,10,0.000637255,810257,0.913892398
13661,528,236,13,10,0.000637255,810270,0.913907061
15034,34,130,13,10,0.000637255,810283,0.913921723
19345,348,683,13,10,0.000637255,810296,0.913936386
13680,632,529,13,10,0.000637255,810309,0.913951049
11615,655,15,13,10,0.000637255,810322,0.913965712
13699,334,117,13,10,0.000637255,810335,0.913980374
11359,717,20,13,10,0.000637255,810348,0.913995037
11361,204,64,13,10,0.000637255,810361,0.9140097
13712,6,661,13,10,0.000637255,810374,0.914024363
11604,392,314,13,10,0.000637255,810387,0.914039025
11603,689,97,13,10,0.000637255,810400,0.914053688
14945,473,175,13,10,0.000637255,810413,0.914068351
14334,463,30,13,10,0.000637255,810426,0.914083014
9826,4,3,13,10,0.000637255,810439,0.914097677
11210,586,414,13,10,0.000637255,810452,0.914112339
12479,439,397,13,10,0.000637255,810465,0.914127002
10052,439,353,13,10,0.000637255,810478,0.914141665
16911,250,587,13,10,0.000637255,810491,0.914156328
10342,1,353,13,10,0.000637255,810504,0.91417099
9904,609,280,13,10,0.000637255,810517,0.914185653
16382,332,6,13,10,0.000637255,810530,0.914200316
12268,314,175,13,10,0.000637255,810543,0.914214979
10230,674,22,13,10,0.000637255,810556,0.914229641
16450,313,652,13,10,0.000637255,810569,0.914244304
9865,332,532,13,10,0.000637255,810582,0.914258967
10354,11,121,13,10,0.000637255,810595,0.91427363
10376,593,77,13,10,0.000637255,810608,0.914288292
16784,517,130,13,10,0.000637255,810621,0.914302955
10330,383,443,13,10,0.000637255,810634,0.914317618
12527,558,25,13,10,0.000637255,810647,0.914332281
12419,133,25,13,10,0.000637255,810660,0.914346943
16776,646,498,13,10,0.000637255,810673,0.914361606
16921,517,103,13,10,0.000637255,810686,0.914376269
12185,11,689,13,10,0.000637255,810699,0.914390932
10078,313,714,13,10,0.000637255,810712,0.914405594
12229,398,33,13,10,0.000637255,810725,0.914420257
9735,242,582,13,10,0.000637255,810738,0.91443492
15570,193,353,12,10,0.000588235,810750,0.914448455
13459,280,517,12,10,0.000588235,810762,0.91446199
15584,708,19,12,10,0.000588235,810774,0.914475524
11605,224,714,12,10,0.000588235,810786,0.914489059
15594,174,131,12,10,0.000588235,810798,0.914502594
15571,20,307,12,10,0.000588235,810810,0.914516129
12493,493,582,12,10,0.000588235,810822,0.914529664
11680,310,502,12,10,0.000588235,810834,0.914543199
12491,535,130,12,10,0.000588235,810846,0.914556734
9204,265,582,12,10,0.000588235,810858,0.914570268
8656,295,26,12,10,0.000588235,810870,0.914583803
6887,5,80,12,10,0.000588235,810882,0.914597338
13942,11,170,12,10,0.000588235,810894,0.914610873
17168,155,295,12,10,0.000588235,810906,0.914624408
10093,443,121,12,10,0.000588235,810918,0.914637943
13947,379,5,12,10,0.000588235,810930,0.914651478
13490,310,1,12,10,0.000588235,810942,0.914665012
13131,280,427,12,10,0.000588235,810954,0.914678547
13478,721,274,12,10,0.000588235,810966,0.914692082
15660,347,280,12,10,0.000588235,810978,0.914705617
14998,261,264,12,10,0.000588235,810990,0.914719152
9302,673,586,12,10,0.000588235,811002,0.914732687
13069,13,2,12,10,0.000588235,811014,0.914746222
12231,261,353,12,10,0.000588235,811026,0.914759756
12233,133,219,12,10,0.000588235,811038,0.914773291
10919,207,105,12,10,0.000588235,811050,0.914786826
17818,364,609,12,10,0.000588235,811062,0.914800361
6271,586,158,12,10,0.000588235,811074,0.914813896
11790,398,265,12,10,0.000588235,811086,0.914827431
11326,90,105,12,10,0.000588235,811098,0.914840965
16933,517,14,12,10,0.000588235,811110,0.9148545
11550,638,50,12,10,0.000588235,811122,0.914868035
13121,673,614,12,10,0.000588235,811134,0.91488157
9241,708,145,12,10,0.000588235,811146,0.914895105
12062,409,354,12,10,0.000588235,811158,0.91490864
8406,107,246,12,10,0.000588235,811170,0.914922175
15251,544,632,12,10,0.000588235,811182,0.914935709
20554,121,31,12,10,0.000588235,811194,0.914949244
11547,264,219,12,10,0.000588235,811206,0.914962779
11405,236,683,12,10,0.000588235,811218,0.914976314
9282,439,471,12,10,0.000588235,811230,0.914989849
13097,334,313,12,10,0.000588235,811242,0.915003384
10787,582,12,12,10,0.000588235,811254,0.915016919
13099,31,443,12,10,0.000588235,811266,0.915030453
11784,517,475,12,10,0.000588235,811278,0.915043988
11782,593,219,12,10,0.000588235,811290,0.915057523
16322,13,655,12,10,0.000588235,811302,0.915071058
13741,353,507,12,10,0.000588235,811314,0.915084593
13828,586,14,12,10,0.000588235,811326,0.915098128
14957,614,30,12,10,0.000588235,811338,0.915111663
6095,655,582,12,10,0.000588235,811350,0.915125197
11301,164,331,12,10,0.000588235,811362,0.915138732
15357,56,517,12,10,0.000588235,811374,0.915152267
17076,224,90,12,10,0.000588235,811386,0.915165802
9935,2,20,12,10,0.000588235,811398,0.915179337
13382,302,682,12,10,0.000588235,811410,0.915192872
12018,117,302,12,10,0.000588235,811422,0.915206406
13384,501,723,12,10,0.000588235,811434,0.915219941
14944,261,596,12,10,0.000588235,811446,0.915233476
13390,588,171,12,10,0.000588235,811458,0.915247011
10054,593,473,12,10,0.000588235,811470,0.915260546
14901,439,11,12,10,0.000588235,811482,0.915274081
7634,443,3,12,10,0.000588235,811494,0.915287616
16555,64,313,12,10,0.000588235,811506,0.91530115
9024,514,397,12,10,0.000588235,811518,0.915314685
9021,535,638,12,10,0.000588235,811530,0.91532822
12278,193,171,12,10,0.000588235,811542,0.915341755
16992,663,4,12,10,0.000588235,811554,0.91535529
13213,14,331,12,10,0.000588235,811566,0.915368825
13887,171,311,12,10,0.000588235,811578,0.91538236
15269,552,274,12,10,0.000588235,811590,0.915395894
13886,6,25,12,10,0.000588235,811602,0.915409429
14808,15,586,12,10,0.000588235,811614,0.915422964
11292,307,204,12,10,0.000588235,811626,0.915436499
17985,77,43,12,10,0.000588235,811638,0.915450034
16584,2,54,12,10,0.000588235,811650,0.915463569
15510,30,517,12,10,0.000588235,811662,0.915477104
7589,674,511,12,10,0.000588235,811674,0.915490638
19609,10,290,12,10,0.000588235,811686,0.915504173
13189,171,22,12,10,0.000588235,811698,0.915517708
13191,265,68,12,10,0.000588235,811710,0.915531243
11000,479,170,12,10,0.000588235,811722,0.915544778
11750,48,385,12,10,0.000588235,811734,0.915558313
10654,673,674,12,10,0.000588235,811746,0.915571848
17942,34,364,12,10,0.000588235,811758,0.915585382
11567,314,261,12,10,0.000588235,811770,0.915598917
15435,511,11,12,10,0.000588235,811782,0.915612452
15433,618,354,12,10,0.000588235,811794,0.915625987
7695,30,334,12,10,0.000588235,811806,0.915639522
12304,26,167,12,10,0.000588235,811818,0.915653057
14840,655,385,12,10,0.000588235,811830,0.915666591
12266,26,56,12,10,0.000588235,811842,0.915680126
13234,708,331,12,10,0.000588235,811854,0.915693661
17992,618,701,12,10,0.000588235,811866,0.915707196
11998,354,246,12,10,0.000588235,811878,0.915720731
12070,394,614,12,10,0.000588235,811890,0.915734266
12770,274,20,12,10,0.000588235,811902,0.915747801
12772,674,404,12,10,0.000588235,811914,0.915761335
15987,708,175,12,10,0.000588235,811926,0.91577487
15142,397,503,12,10,0.000588235,811938,0.915788405
14219,493,16,12,10,0.000588235,811950,0.91580194
17510,19,33,12,10,0.000588235,811962,0.915815475
12790,632,280,12,10,0.000588235,811974,0.91582901
15068,544,586,12,10,0.000588235,811986,0.915842545
18248,193,103,12,10,0.000588235,811998,0.915856079
15134,380,618,12,10,0.000588235,812010,0.915869614
14237,347,107,12,10,0.000588235,812022,0.915883149
15998,13,479,12,10,0.000588235,812034,0.915896684
12793,334,443,12,10,0.000588235,812046,0.915910219
15144,90,473,12,10,0.000588235,812058,0.915923754
13654,721,11,12,10,0.000588235,812070,0.915937289
8699,313,246,12,10,0.000588235,812082,0.915950823
8694,618,310,12,10,0.000588235,812094,0.915964358
12051,3,543,12,10,0.000588235,812106,0.915977893
13660,1,77,12,10,0.000588235,812118,0.915991428
11148,174,155,12,10,0.000588235,812130,0.916004963
7968,97,10,12,10,0.000588235,812142,0.916018498
16478,379,195,12,10,0.000588235,812154,0.916032032
12800,609,614,12,10,0.000588235,812166,0.916045567
10363,123,246,12,10,0.000588235,812178,0.916059102
15149,2,596,12,10,0.000588235,812190,0.916072637
16722,178,16,12,10,0.000588235,812202,0.916086172
13580,310,294,12,10,0.000588235,812214,0.916099707
16759,131,646,12,10,0.000588235,812226,0.916113242
16500,684,310,12,10,0.000588235,812238,0.916126776
10200,443,560,12,10,0.000588235,812250,0.916140311
10199,196,84,12,10,0.000588235,812262,0.916153846
13622,497,14,12,10,0.000588235,812274,0.916167381
17437,264,522,12,10,0.000588235,812286,0.916180916
16757,443,5,12,10,0.000588235,812298,0.916194451
11929,274,588,12,10,0.000588235,812310,0.916207986
14360,552,3,12,10,0.000588235,812322,0.91622152
18292,414,85,12,10,0.000588235,812334,0.916235055
14339,193,16,12,10,0.000588235,812346,0.91624859
13618,471,443,12,10,0.000588235,812358,0.916262125
14309,224,624,12,10,0.000588235,812370,0.91627566
12692,14,663,12,10,0.000588235,812382,0.916289195
10889,514,25,12,10,0.000588235,812394,0.91630273
15081,528,26,12,10,0.000588235,812406,0.916316264
12724,655,404,12,10,0.000588235,812418,0.916329799
9682,498,562,12,10,0.000588235,812430,0.916343334
12111,683,379,12,10,0.000588235,812442,0.916356869
14392,511,723,12,10,0.000588235,812454,0.916370404
12738,313,140,12,10,0.000588235,812466,0.916383939
16021,596,2,12,10,0.000588235,812478,0.916397473
12145,544,498,12,10,0.000588235,812490,0.916411008
6437,582,714,12,10,0.000588235,812502,0.916424543
12698,12,348,12,10,0.000588235,812514,0.916438078
15084,5,174,12,10,0.000588235,812526,0.916451613
16060,164,347,12,10,0.000588235,812538,0.916465148
10011,609,334,12,10,0.000588235,812550,0.916478683
12709,682,242,12,10,0.000588235,812562,0.916492217
15083,558,5,12,10,0.000588235,812574,0.916505752
10828,4,68,12,10,0.000588235,812586,0.916519287
6643,156,80,12,10,0.000588235,812598,0.916532822
12961,511,10,12,10,0.000588235,812610,0.916546357
18361,25,269,12,10,0.000588235,812622,0.916559892
9411,507,532,12,10,0.000588235,812634,0.916573427
12969,158,586,12,10,0.000588235,812646,0.916586961
12320,3,1,12,10,0.000588235,812658,0.916600496
15212,475,614,12,10,0.000588235,812670,0.916614031
9805,196,77,12,10,0.000588235,812682,0.916627566
15802,31,501,12,10,0.000588235,812694,0.916641101
17672,243,97,12,10,0.000588235,812706,0.916654636
17674,11,652,12,10,0.000588235,812718,0.916668171
10809,236,85,12,10,0.000588235,812730,0.916681705
17768,230,294,12,10,0.000588235,812742,0.91669524
14637,31,171,12,10,0.000588235,812754,0.916708775
13030,501,605,12,10,0.000588235,812766,0.91672231
16627,302,181,12,10,0.000588235,812778,0.916735845
14615,97,689,12,10,0.000588235,812790,0.91674938
11523,393,674,12,10,0.000588235,812802,0.916762915
15219,26,632,12,10,0.000588235,812814,0.916776449
8883,196,689,12,10,0.000588235,812826,0.916789984
9810,274,22,12,10,0.000588235,812838,0.916803519
11669,353,56,12,10,0.000588235,812850,0.916817054
13520,334,6,12,10,0.000588235,812862,0.916830589
13388,525,302,12,10,0.000588235,812874,0.916844124
11430,562,501,12,10,0.000588235,812886,0.916857658
12883,328,497,12,10,0.000588235,812898,0.916871193
13667,398,295,12,10,0.000588235,812910,0.916884728
16892,532,155,12,10,0.000588235,812922,0.916898263
11951,674,242,12,10,0.000588235,812934,0.916911798
16692,314,160,12,10,0.000588235,812946,0.916925333
11659,56,404,12,10,0.000588235,812958,0.916938868
15170,446,348,12,10,0.000588235,812970,0.916952402
8180,379,204,12,10,0.000588235,812982,0.916965937
10984,624,708,12,10,0.000588235,812994,0.916979472
10163,3,246,12,10,0.000588235,813006,0.916993007
10812,30,280,12,10,0.000588235,813018,0.917006542
14545,33,652,12,10,0.000588235,813030,0.917020077
13673,328,56,12,10,0.000588235,813042,0.917033612
12912,29,15,12,10,0.000588235,813054,0.917047146
12368,498,34,12,10,0.000588235,813066,0.917060681
13522,562,242,12,10,0.000588235,813078,0.917074216
11839,479,117,12,10,0.000588235,813090,0.917087751
12563,158,393,12,10,0.000588235,813102,0.917101286
14124,498,56,12,10,0.000588235,813114,0.917114821
11120,77,673,11,10,0.000539216,813125,0.917127228
10953,463,121,11,10,0.000539216,813136,0.917139635
19350,121,347,11,10,0.000539216,813147,0.917152042
14965,514,414,11,10,0.000539216,813158,0.917164448
12312,613,582,11,10,0.000539216,813169,0.917176855
15016,348,178,11,10,0.000539216,813180,0.917189262
11348,310,682,11,10,0.000539216,813191,0.917201669
16984,145,1,11,10,0.000539216,813202,0.917214076
15054,16,661,11,10,0.000539216,813213,0.917226483
13694,48,392,11,10,0.000539216,813224,0.91723889
13723,347,689,11,10,0.000539216,813235,0.917251297
7462,655,77,11,10,0.000539216,813246,0.917263704
16686,347,167,11,10,0.000539216,813257,0.917276111
14169,328,54,11,10,0.000539216,813268,0.917288518
14493,11,463,11,10,0.000539216,813279,0.917300925
12100,145,367,11,10,0.000539216,813290,0.917313332
14544,30,274,11,10,0.000539216,813301,0.917325739
16894,511,107,11,10,0.000539216,813312,0.917338146
14064,6,528,11,10,0.000539216,813323,0.917350553
19100,347,508,11,10,0.000539216,813334,0.91736296
14084,721,170,11,10,0.000539216,813345,0.917375367
16654,328,130,11,10,0.000539216,813356,0.917387774
14090,105,624,11,10,0.000539216,813367,0.91740018
11520,529,48,11,10,0.000539216,813378,0.917412587
16903,19,14,11,10,0.000539216,813389,0.917424994
18678,502,170,11,10,0.000539216,813400,0.917437401
8238,586,264,11,10,0.000539216,813411,0.917449808
11464,174,6,11,10,0.000539216,813422,0.917462215
14396,11,34,11,10,0.000539216,813433,0.917474622
14194,155,310,11,10,0.000539216,813444,0.917487029
14347,502,250,11,10,0.000539216,813455,0.917499436
16835,193,48,11,10,0.000539216,813466,0.917511843
16832,511,196,11,10,0.000539216,813477,0.91752425
14461,494,335,11,10,0.000539216,813488,0.917536657
11439,497,473,11,10,0.000539216,813499,0.917549064
11440,385,334,11,10,0.000539216,813510,0.917561471
14447,605,614,11,10,0.000539216,813521,0.917573878
18803,311,13,11,10,0.000539216,813532,0.917586285
14431,15,13,11,10,0.000539216,813543,0.917598692
11445,334,107,11,10,0.000539216,813554,0.917611099
18975,156,517,11,10,0.000539216,813565,0.917623506
10866,613,10,11,10,0.000539216,813576,0.917635912
14868,347,532,11,10,0.000539216,813587,0.917648319
10946,463,196,11,10,0.000539216,813598,0.917660726
16576,131,682,11,10,0.000539216,813609,0.917673133
13859,543,508,11,10,0.000539216,813620,0.91768554
13861,532,587,11,10,0.000539216,813631,0.917697947
12267,156,497,11,10,0.000539216,813642,0.917710354
14815,20,2,11,10,0.000539216,813653,0.917722761
18459,335,701,11,10,0.000539216,813664,0.917735168
13766,43,558,11,10,0.000539216,813675,0.917747575
14938,204,274,11,10,0.000539216,813686,0.917759982
13771,684,522,11,10,0.000539216,813697,0.917772389
13779,558,507,11,10,0.000539216,813708,0.917784796
16550,517,50,11,10,0.000539216,813719,0.917797203
10232,117,353,11,10,0.000539216,813730,0.91780961
13800,5,311,11,10,0.000539216,813741,0.917822017
14891,535,364,11,10,0.000539216,813752,0.917834424
16568,202,348,11,10,0.000539216,813763,0.917846831
14773,34,121,11,10,0.000539216,813774,0.917859238
14692,708,64,11,10,0.000539216,813785,0.917871644
14682,682,558,11,10,0.000539216,813796,0.917884051
11535,313,156,11,10,0.000539216,813807,0.917896458
11532,638,243,11,10,0.000539216,813818,0.917908865
10120,158,501,11,10,0.000539216,813829,0.917921272
14639,174,310,11,10,0.000539216,813840,0.917933679
19109,155,562,11,10,0.000539216,813851,0.917946086
12077,501,398,11,10,0.000539216,813862,0.917958493
14696,394,640,11,10,0.000539216,813873,0.9179709
13931,123,140,11,10,0.000539216,813884,0.917983307
12249,414,471,11,10,0.000539216,813895,0.917995714
10935,443,56,11,10,0.000539216,813906,0.918008121
14731,295,54,11,10,0.000539216,813917,0.918020528
13958,632,26,11,10,0.000539216,813928,0.918032935
14719,80,12,11,10,0.000539216,813939,0.918045342
13979,16,29,11,10,0.000539216,813950,0.918057749
11836,219,274,11,10,0.000539216,813961,0.918070156
15452,145,25,11,10,0.000539216,813972,0.918082563
13252,15,107,11,10,0.000539216,813983,0.91809497
10435,11,158,11,10,0.000539216,813994,0.918107376
17998,501,269,11,10,0.000539216,814005,0.918119783
18002,562,507,11,10,0.000539216,814016,0.91813219
11021,295,544,11,10,0.000539216,814027,0.918144597
9539,30,1,11,10,0.000539216,814038,0.918157004
12477,25,367,11,10,0.000539216,814049,0.918169411
10339,261,582,11,10,0.000539216,814060,0.918181818
12475,397,274,11,10,0.000539216,814071,0.918194225
16192,471,207,11,10,0.000539216,814082,0.918206632
11941,97,498,11,10,0.000539216,814093,0.918219039
15702,364,313,11,10,0.000539216,814104,0.918231446
15384,5,50,11,10,0.000539216,814115,0.918243853
13320,10,673,11,10,0.000539216,814126,0.91825626
16386,392,379,11,10,0.000539216,814137,0.918268667
12620,393,295,11,10,0.000539216,814148,0.918281074
15367,265,398,11,10,0.000539216,814159,0.918293481
16390,364,397,11,10,0.000539216,814170,0.918305888
15999,16,392,11,10,0.000539216,814181,0.918318295
12617,20,379,11,10,0.000539216,814192,0.918330702
12616,562,25,11,10,0.000539216,814203,0.918343109
7144,605,9,11,10,0.000539216,814214,0.918355515
16366,719,236,11,10,0.000539216,814225,0.918367922
11300,439,77,11,10,0.000539216,814236,0.918380329
12827,393,4,11,10,0.000539216,814247,0.918392736
9237,398,117,11,10,0.000539216,814258,0.918405143
15857,10,392,11,10,0.000539216,814269,0.91841755
17211,97,243,11,10,0.000539216,814280,0.918429957
19943,571,32,11,10,0.000539216,814291,0.918442364
17212,392,302,11,10,0.000539216,814302,0.918454771
13068,12,409,11,10,0.000539216,814313,0.918467178
10351,25,354,11,10,0.000539216,814324,0.918479585
15576,582,13,11,10,0.000539216,814335,0.918491992
12903,596,34,11,10,0.000539216,814346,0.918504399
15864,479,613,11,10,0.000539216,814357,0.918516806
12896,50,97,11,10,0.000539216,814368,0.918529213
15870,12,130,11,10,0.000539216,814379,0.91854162
12891,427,393,11,10,0.000539216,814390,0.918554027
12888,543,280,11,10,0.000539216,814401,0.918566434
15535,552,501,11,10,0.000539216,814412,0.918578841
10474,668,380,11,10,0.000539216,814423,0.918591247
17929,204,398,11,10,0.000539216,814434,0.918603654
17939,207,517,11,10,0.000539216,814445,0.918616061
13200,95,655,11,10,0.000539216,814456,0.918628468
17290,663,482,11,10,0.000539216,814467,0.918640875
11960,385,302,11,10,0.000539216,814478,0.918653282
11852,204,22,11,10,0.000539216,814489,0.918665689
12858,443,708,11,10,0.000539216,814500,0.918678096
16298,475,385,11,10,0.000539216,814511,0.918690503
17287,684,663,11,10,0.000539216,814522,0.91870291
13161,517,609,11,10,0.000539216,814533,0.918715317
12853,699,582,11,10,0.000539216,814544,0.918727724
11287,379,514,11,10,0.000539216,814555,0.918740131
17890,178,314,11,10,0.000539216,814566,0.918752538
17632,145,517,11,10,0.000539216,814577,0.918764945
9487,33,560,11,10,0.000539216,814588,0.918777352
19947,331,175,11,10,0.000539216,814599,0.918789759
15917,250,85,11,10,0.000539216,814610,0.918802166
16391,364,393,11,10,0.000539216,814621,0.918814573
18199,328,511,11,10,0.000539216,814632,0.918826979
15197,673,723,11,10,0.000539216,814643,0.918839386
15195,160,84,11,10,0.000539216,814654,0.918851793
19875,708,332,11,10,0.000539216,814665,0.9188642
8855,638,498,11,10,0.000539216,814676,0.918876607
12993,84,708,11,10,0.000539216,814687,0.918889014
17392,310,383,11,10,0.000539216,814698,0.918901421
16109,27,133,11,10,0.000539216,814709,0.918913828
17348,160,236,11,10,0.000539216,814720,0.918926235
11666,242,230,11,10,0.000539216,814731,0.918938642
15343,497,274,11,10,0.000539216,814742,0.918951049
13484,684,314,11,10,0.000539216,814753,0.918963456
11671,117,334,11,10,0.000539216,814764,0.918975863
9972,674,552,11,10,0.000539216,814775,0.91898827
15216,364,331,11,10,0.000539216,814786,0.919000677
17245,684,463,11,10,0.000539216,814797,0.919013084
15164,3,514,11,10,0.000539216,814808,0.919025491
12551,593,302,11,10,0.000539216,814819,0.919037898
9409,156,307,11,10,0.000539216,814830,0.919050305
11082,586,48,11,10,0.000539216,814841,0.919062711
13595,663,171,11,10,0.000539216,814852,0.919075118
13606,195,348,11,10,0.000539216,814863,0.919087525
17709,479,264,11,10,0.000539216,814874,0.919099932
9986,31,331,11,10,0.000539216,814885,0.919112339
11336,380,140,11,10,0.000539216,814896,0.919124746
12979,175,32,11,10,0.000539216,814907,0.919137153
13564,414,364,11,10,0.000539216,814918,0.91914956
15776,501,517,11,10,0.000539216,814929,0.919161967
17231,95,404,11,10,0.000539216,814940,0.919174374
16015,124,105,11,10,0.000539216,814951,0.919186781
18094,130,13,11,10,0.000539216,814962,0.919199188
19497,392,443,11,10,0.000539216,814973,0.919211595
16022,497,348,11,10,0.000539216,814984,0.919224002
15322,314,90,11,10,0.000539216,814995,0.919236409
12940,689,674,11,10,0.000539216,815006,0.919248816
11938,586,588,11,10,0.000539216,815017,0.919261223
15339,31,294,11,10,0.000539216,815028,0.91927363
12435,133,10,11,10,0.000539216,815039,0.919286037
12754,479,164,11,10,0.000539216,815050,0.919298443
12750,2,397,11,10,0.000539216,815061,0.91931085
13360,502,145,11,10,0.000539216,815072,0.919323257
11889,250,15,11,10,0.000539216,815083,0.919335664
15325,25,250,11,10,0.000539216,815094,0.919348071
11323,609,535,11,10,0.000539216,815105,0.919360478
16066,475,167,11,10,0.000539216,815116,0.919372885
13447,33,414,11,10,0.000539216,815127,0.919385292
16062,34,587,11,10,0.000539216,815138,0.919397699
15799,354,508,11,10,0.000539216,815149,0.919410106
12732,95,609,11,10,0.000539216,815160,0.919422513
16264,140,307,11,10,0.000539216,815171,0.91943492
16448,84,587,11,10,0.000539216,815182,0.919447327
21752,155,663,11,10,0.000539216,815193,0.919459734
18120,48,682,11,10,0.000539216,815204,0.919472141
17665,265,31,10,10,0.000490196,815214,0.91948342
15092,708,11,10,10,0.000490196,815224,0.919494699
15859,502,164,10,10,0.000490196,815234,0.919505978
16800,558,294,10,10,0.000490196,815244,0.919517257
14401,398,31,10,10,0.000490196,815254,0.919528536
10895,475,353,10,10,0.000490196,815264,0.919539815
14428,11,683,10,10,0.000490196,815274,0.919551094
10887,640,618,10,10,0.000490196,815284,0.919562373
17424,14,56,10,10,0.000490196,815294,0.919573652
15883,347,294,10,10,0.000490196,815304,0.919584931
16223,528,32,10,10,0.000490196,815314,0.91959621
14459,31,723,10,10,0.000490196,815324,0.919607489
15967,114,145,10,10,0.000490196,815334,0.919618768
15961,517,280,10,10,0.000490196,815344,0.919630047
17295,274,508,10,10,0.000490196,815354,0.919641326
16840,328,714,10,10,0.000490196,815364,0.919652605
11131,13,9,10,10,0.000490196,815374,0.919663885
14924,482,16,10,10,0.000490196,815384,0.919675164
16413,719,6,10,10,0.000490196,815394,0.919686443
15298,48,126,10,10,0.000490196,815404,0.919697722
15283,498,552,10,10,0.000490196,815414,0.919709001
11321,20,543,10,10,0.000490196,815424,0.91972028
14853,593,250,10,10,0.000490196,815434,0.919731559
22671,652,5,10,10,0.000490196,815444,0.919742838
15432,6,19,10,10,0.000490196,815454,0.919754117
14863,682,15,10,10,0.000490196,815464,0.919765396
16575,117,514,10,10,0.000490196,815474,0.919776675
14870,528,529,10,10,0.000490196,815484,0.919787954
16379,31,560,10,10,0.000490196,815494,0.919799233
17140,25,663,10,10,0.000490196,815504,0.919810512
18071,124,5,10,10,0.000490196,815514,0.919821791
17011,497,167,10,10,0.000490196,815524,0.91983307
15050,517,121,10,10,0.000490196,815534,0.919844349
16477,367,269,10,10,0.000490196,815544,0.919855628
15268,605,48,10,10,0.000490196,815554,0.919866907
15067,13,463,10,10,0.000490196,815564,0.919878186
15110,448,14,10,10,0.000490196,815574,0.919889465
15098,204,596,10,10,0.000490196,815584,0.919900744
16461,160,11,10,10,0.000490196,815594,0.919912023
14995,522,482,10,10,0.000490196,815604,0.919923303
16998,243,689,10,10,0.000490196,815614,0.919934582
22655,85,689,10,10,0.000490196,815624,0.919945861
16620,646,596,10,10,0.000490196,815634,0.91995714
15673,593,31,10,10,0.000490196,815644,0.919968419
15653,593,141,10,10,0.000490196,815654,0.919979698
16319,6,605,10,10,0.000490196,815664,0.919990977
15618,582,160,10,10,0.000490196,815674,0.920002256
14713,6,652,10,10,0.000490196,815684,0.920013535
16622,528,398,10,10,0.000490196,815694,0.920024814
14649,398,6,10,10,0.000490196,815704,0.920036093
15768,605,586,10,10,0.000490196,815714,0.920047372
16274,543,250,10,10,0.000490196,815724,0.920058651
15739,463,265,10,10,0.000490196,815734,0.92006993
17736,195,145,10,10,0.000490196,815744,0.920081209
17746,313,175,10,10,0.000490196,815754,0.920092488
14627,167,196,10,10,0.000490196,815764,0.920103767
11102,614,535,10,10,0.000490196,815774,0.920115046
11413,123,25,10,10,0.000490196,815784,0.920126325
17946,84,494,10,10,0.000490196,815794,0.920137604
14797,414,97,10,10,0.000490196,815804,0.920148883
14798,479,29,10,10,0.000490196,815814,0.920160162
15466,719,473,10,10,0.000490196,815824,0.920171441
15597,668,544,10,10,0.000490196,815834,0.920182721
18547,492,596,10,10,0.000490196,815844,0.920194
14753,105,290,10,10,0.000490196,815854,0.920205279
11026,609,56,10,10,0.000490196,815864,0.920216558
15565,13,48,10,10,0.000490196,815874,0.920227837
14443,313,171,10,10,0.000490196,815884,0.920239116
12660,708,522,10,10,0.000490196,815894,0.920250395
13083,593,264,10,10,0.000490196,815904,0.920261674
11851,708,479,10,10,0.000490196,815914,0.920272953
14037,164,77,10,10,0.000490196,815924,0.920284232
12165,16,56,10,10,0.000490196,815934,0.920295511
19246,140,682,10,10,0.000490196,815944,0.92030679
10347,558,614,10,10,0.000490196,815954,0.920318069
14145,347,397,10,10,0.000490196,815964,0.920329348
10306,4,95,10,10,0.000490196,815974,0.920340627
19069,552,517,10,10,0.000490196,815984,0.920351906
19067,207,367,10,10,0.000490196,815994,0.920363185
12869,618,588,10,10,0.000490196,816004,0.920374464
10639,543,532,10,10,0.000490196,816014,0.920385743
12755,50,394,10,10,0.000490196,816024,0.920397022
12808,501,479,10,10,0.000490196,816034,0.920408301
9360,689,84,10,10,0.000490196,816044,0.92041958
13530,20,164,10,10,0.000490196,816054,0.920430859
13128,497,25,10,10,0.000490196,816064,0.920442139
13568,97,64,10,10,0.000490196,816074,0.920453418
19411,48,652,10,10,0.000490196,816084,0.920464697
9254,379,479,10,10,0.000490196,816094,0.920475976
12787,689,532,10,10,0.000490196,816104,0.920487255
12819,2,394,10,10,0.000490196,816114,0.920498534
13009,95,532,10,10,0.000490196,816124,0.920509813
11531,22,25,10,10,0.000490196,816134,0.920521092
8352,97,379,10,10,0.000490196,816144,0.920532371
13495,34,167,10,10,0.000490196,816154,0.92054365
13996,31,544,10,10,0.000490196,816164,0.920554929
14002,501,682,10,10,0.000490196,816174,0.920566208
13098,265,614,10,10,0.000490196,816184,0.920577487
12775,156,123,10,10,0.000490196,816194,0.920588766
9129,638,443,10,10,0.000490196,816204,0.920600045
12291,507,145,10,10,0.000490196,816214,0.920611324
14296,310,121,10,10,0.000490196,816224,0.920622603
13773,56,511,10,10,0.000490196,816234,0.920633882
13220,25,473,10,10,0.000490196,816244,0.920645161
18920,121,353,10,10,0.000490196,816254,0.92065644
9431,498,95,10,10,0.000490196,816264,0.920667719
12209,311,507,10,10,0.000490196,816274,0.920678998
10734,689,638,10,10,0.000490196,816284,0.920690277
12935,30,689,10,10,0.000490196,816294,0.920701557
14261,501,34,10,10,0.000490196,816304,0.920712836
19335,1,90,10,10,0.000490196,816314,0.920724115
12922,532,427,10,10,0.000490196,816324,0.920735394
14271,307,2,10,10,0.000490196,816334,0.920746673
12934,655,14,10,10,0.000490196,816344,0.920757952
18927,202,15,10,10,0.000490196,816354,0.920769231
20438,498,171,10,10,0.000490196,816364,0.92078051
10194,543,471,10,10,0.000490196,816374,0.920791789
21504,479,576,10,10,0.000490196,816384,0.920803068
13695,80,156,10,10,0.000490196,816394,0.920814347
12916,497,242,10,10,0.000490196,816404,0.920825626
12146,4,414,10,10,0.000490196,816414,0.920836905
10478,532,552,10,10,0.000490196,816424,0.920848184
10124,10,29,10,10,0.000490196,816434,0.920859463
13672,498,689,10,10,0.000490196,816444,0.920870742
19586,156,560,10,10,0.000490196,816454,0.920882021
13174,393,54,10,10,0.000490196,816464,0.9208933
13678,56,30,10,10,0.000490196,816474,0.920904579
12897,1,84,10,10,0.000490196,816484,0.920915858
9319,605,230,10,10,0.000490196,816494,0.920927137
7490,196,723,17,9,0.000833333,816511,0.920946312
12465,511,131,16,9,0.000784314,816527,0.920964358
11799,517,307,16,9,0.000784314,816543,0.920982405
10481,265,274,16,9,0.000784314,816559,0.921000451
13571,721,23,15,9,0.000735294,816574,0.92101737
10520,155,158,15,9,0.000735294,816589,0.921034288
10487,331,29,15,9,0.000735294,816604,0.921051207
8617,609,48,15,9,0.000735294,816619,0.921068125
11253,379,25,15,9,0.000735294,816634,0.921085044
10851,502,335,15,9,0.000735294,816649,0.921101963
12443,517,236,14,9,0.000686275,816663,0.921117753
16136,155,10,14,9,0.000686275,816677,0.921133544
15708,90,123,14,9,0.000686275,816691,0.921149335
12565,475,243,14,9,0.000686275,816705,0.921165125
12196,314,569,14,9,0.000686275,816719,0.921180916
8580,242,397,14,9,0.000686275,816733,0.921196707
17023,684,32,14,9,0.000686275,816747,0.921212497
10128,105,174,14,9,0.000686275,816761,0.921228288
17061,204,624,14,9,0.000686275,816775,0.921244079
16842,5,34,14,9,0.000686275,816789,0.921259869
12367,683,84,14,9,0.000686275,816803,0.92127566
12397,13,64,14,9,0.000686275,816817,0.92129145
9948,673,107,14,9,0.000686275,816831,0.921307241
13714,6,414,14,9,0.000686275,816845,0.921323032
16306,124,95,14,9,0.000686275,816859,0.921338822
14683,479,171,14,9,0.000686275,816873,0.921354613
12909,708,640,14,9,0.000686275,816887,0.921370404
14759,34,398,14,9,0.000686275,816901,0.921386194
14855,522,294,14,9,0.000686275,816915,0.921401985
15204,503,353,14,9,0.000686275,816929,0.921417776
12714,673,514,14,9,0.000686275,816943,0.921433566
15406,558,207,14,9,0.000686275,816957,0.921449357
14019,614,196,14,9,0.000686275,816971,0.921465148
14892,502,48,14,9,0.000686275,816985,0.921480938
13452,295,56,14,9,0.000686275,816999,0.921496729
13471,54,224,14,9,0.000686275,817013,0.92151252
12087,265,501,14,9,0.000686275,817027,0.92152831
11051,354,392,14,9,0.000686275,817041,0.921544101
10701,196,532,14,9,0.000686275,817055,0.921559892
11530,9,482,14,9,0.000686275,817069,0.921575682
10287,295,586,14,9,0.000686275,817083,0.921591473
11785,605,535,14,9,0.000686275,817097,0.921607264
10848,250,614,14,9,0.000686275,817111,0.921623054
10581,708,30,13,9,0.000637255,817124,0.921637717
11738,77,294,13,9,0.000637255,817137,0.92165238
15330,364,335,13,9,0.000637255,817150,0.921667043
15320,174,640,13,9,0.000637255,817163,0.921681705
9045,582,446,13,9,0.000637255,817176,0.921696368
10583,274,663,13,9,0.000637255,817189,0.921711031
13244,385,50,13,9,0.000637255,817202,0.921725694
13277,353,632,13,9,0.000637255,817215,0.921740356
13279,689,11,13,9,0.000637255,817228,0.921755019
13298,640,171,13,9,0.000637255,817241,0.921769682
13302,511,170,13,9,0.000637255,817254,0.921784345
15670,471,54,13,9,0.000637255,817267,0.921799007
12838,156,475,13,9,0.000637255,817280,0.92181367
12815,562,3,13,9,0.000637255,817293,0.921828333
12695,689,640,13,9,0.000637255,817306,0.921842996
16010,596,23,13,9,0.000637255,817319,0.921857658
15676,140,15,13,9,0.000637255,817332,0.921872321
13052,443,392,13,9,0.000637255,817345,0.921886984
13082,479,207,13,9,0.000637255,817358,0.921901647
11034,532,689,13,9,0.000637255,817371,0.921916309
13106,544,463,13,9,0.000637255,817384,0.921930972
15706,230,446,13,9,0.000637255,817397,0.921945635
6750,394,3,13,9,0.000637255,817410,0.921960298
14112,394,517,13,9,0.000637255,817423,0.921974961
14752,114,463,13,9,0.000637255,817436,0.921989623
13949,68,383,13,9,0.000637255,817449,0.922004286
14256,588,156,13,9,0.000637255,817462,0.922018949
14387,204,167,13,9,0.000637255,817475,0.922033612
10876,502,354,13,9,0.000637255,817488,0.922048274
14379,674,508,13,9,0.000637255,817501,0.922062937
14496,439,674,13,9,0.000637255,817514,0.9220776
14438,105,571,13,9,0.000637255,817527,0.922092263
15194,19,314,13,9,0.000637255,817540,0.922106925
15145,5,632,13,9,0.000637255,817553,0.922121588
13566,68,503,13,9,0.000637255,817566,0.922136251
7392,638,34,13,9,0.000637255,817579,0.922150914
11320,22,582,13,9,0.000637255,817592,0.922165576
13432,133,473,13,9,0.000637255,817605,0.922180239
15246,558,683,13,9,0.000637255,817618,0.922194902
13639,682,385,13,9,0.000637255,817631,0.922209565
14910,439,663,13,9,0.000637255,817644,0.922224227
14871,269,26,13,9,0.000637255,817657,0.92223889
8513,31,353,13,9,0.000637255,817670,0.922253553
8611,689,663,13,9,0.000637255,817683,0.922268216
7538,640,498,13,9,0.000637255,817696,0.922282878
5577,9,265,13,9,0.000637255,817709,0.922297541
12166,80,560,13,9,0.000637255,817722,0.922312204
16464,404,347,13,9,0.000637255,817735,0.922326867
16828,103,347,13,9,0.000637255,817748,0.922341529
16190,22,397,13,9,0.000637255,817761,0.922356192
12063,394,674,13,9,0.000637255,817774,0.922370855
10242,302,508,13,9,0.000637255,817787,0.922385518
12048,4,398,13,9,0.000637255,817800,0.92240018
16276,503,25,13,9,0.000637255,817813,0.922414843
12413,682,131,13,9,0.000637255,817826,0.922429506
9978,26,471,13,9,0.000637255,817839,0.922444169
12390,334,243,13,9,0.000637255,817852,0.922458831
9759,307,3,13,9,0.000637255,817865,0.922473494
12134,674,501,13,9,0.000637255,817878,0.922488157
9915,640,141,13,9,0.000637255,817891,0.92250282
12352,48,242,13,9,0.000637255,817904,0.922517483
13142,367,708,12,9,0.000588235,817916,0.922531017
16960,230,618,12,9,0.000588235,817928,0.922544552
15581,498,328,12,9,0.000588235,817940,0.922558087
14984,14,471,12,9,0.000588235,817952,0.922571622
11556,392,354,12,9,0.000588235,817964,0.922585157
13165,354,502,12,9,0.000588235,817976,0.922598692
13925,463,26,12,9,0.000588235,817988,0.922612226
14978,689,167,12,9,0.000588235,818000,0.922625761
18137,307,514,12,9,0.000588235,818012,0.922639296
14006,596,714,12,9,0.000588235,818024,0.922652831
14671,392,230,12,9,0.000588235,818036,0.922666366
11789,6,609,12,9,0.000588235,818048,0.922679901
13488,543,723,12,9,0.000588235,818060,0.922693436
18157,562,126,12,9,0.000588235,818072,0.92270697
13481,171,475,12,9,0.000588235,818084,0.922720505
9322,393,158,12,9,0.000588235,818096,0.92273404
12514,586,674,12,9,0.000588235,818108,0.922747575
14712,668,9,12,9,0.000588235,818120,0.92276111
14989,392,107,12,9,0.000588235,818132,0.922774645
16330,163,367,12,9,0.000588235,818144,0.92278818
13812,97,5,12,9,0.000588235,818156,0.922801714
10613,123,364,12,9,0.000588235,818168,0.922815249
11724,498,130,12,9,0.000588235,818180,0.922828784
16435,12,145,12,9,0.000588235,818192,0.922842319
10059,582,171,12,9,0.000588235,818204,0.922855854
13290,26,723,12,9,0.000588235,818216,0.922869389
13295,114,26,12,9,0.000588235,818228,0.922882924
14873,502,23,12,9,0.000588235,818240,0.922896458
18104,588,593,12,9,0.000588235,818252,0.922909993
14925,30,393,12,9,0.000588235,818264,0.922923528
9000,668,313,12,9,0.000588235,818276,0.922937063
12421,107,22,12,9,0.000588235,818288,0.922950598
18425,514,347,12,9,0.000588235,818300,0.922964133
13760,105,332,12,9,0.000588235,818312,0.922977667
13755,56,723,12,9,0.000588235,818324,0.922991202
14909,511,689,12,9,0.000588235,818336,0.923004737
9023,56,246,12,9,0.000588235,818348,0.923018272
11745,261,230,12,9,0.000588235,818360,0.923031807
12263,265,11,12,9,0.000588235,818372,0.923045342
11389,721,243,12,9,0.000588235,818384,0.923058877
13183,655,48,12,9,0.000588235,818396,0.923072411
13909,719,20,12,9,0.000588235,818408,0.923085946
5046,242,80,12,9,0.000588235,818420,0.923099481
11573,614,479,12,9,0.000588235,818432,0.923113016
10754,334,10,12,9,0.000588235,818444,0.923126551
15421,328,170,12,9,0.000588235,818456,0.923140086
10304,383,236,12,9,0.000588235,818468,0.923153621
14864,721,379,12,9,0.000588235,818480,0.923167155
13858,156,354,12,9,0.000588235,818492,0.92318069
11184,498,307,12,9,0.000588235,818504,0.923194225
16363,404,646,12,9,0.000588235,818516,0.92320776
19111,544,689,12,9,0.000588235,818528,0.923221295
9332,1,522,12,9,0.000588235,818540,0.92323483
11880,307,689,12,9,0.000588235,818552,0.923248365
14452,114,31,12,9,0.000588235,818564,0.923261899
11876,12,131,12,9,0.000588235,818576,0.923275434
11650,33,117,12,9,0.000588235,818588,0.923288969
14429,12,56,12,9,0.000588235,818600,0.923302504
16012,250,646,12,9,0.000588235,818612,0.923316039
11937,673,295,12,9,0.000588235,818624,0.923329574
13577,117,313,12,9,0.000588235,818636,0.923343109
12149,295,2,12,9,0.000588235,818648,0.923356643
14214,204,614,12,9,0.000588235,818660,0.923370178
11860,646,331,12,9,0.000588235,818672,0.923383713
15689,314,494,12,9,0.000588235,818684,0.923397248
12597,385,586,12,9,0.000588235,818696,0.923410783
9733,328,242,12,9,0.000588235,818708,0.923424318
11436,501,640,12,9,0.000588235,818720,0.923437852
9489,501,588,12,9,0.000588235,818732,0.923451387
14480,236,661,12,9,0.000588235,818744,0.923464922
15959,43,141,12,9,0.000588235,818756,0.923478457
12798,310,126,12,9,0.000588235,818768,0.923491992
9699,668,123,12,9,0.000588235,818780,0.923505527
18765,158,1,12,9,0.000588235,818792,0.923519062
12104,682,586,12,9,0.000588235,818804,0.923532596
10436,164,32,12,9,0.000588235,818816,0.923546131
17045,528,514,12,9,0.000588235,818828,0.923559666
10879,302,501,12,9,0.000588235,818840,0.923573201
12681,295,156,12,9,0.000588235,818852,0.923586736
16031,1,618,12,9,0.000588235,818864,0.923600271
15079,544,130,12,9,0.000588235,818876,0.923613806
12341,638,535,12,9,0.000588235,818888,0.92362734
11450,532,117,12,9,0.000588235,818900,0.923640875
14269,114,638,12,9,0.000588235,818912,0.92365441
8060,171,674,12,9,0.000588235,818924,0.923667945
16053,1,11,12,9,0.000588235,818936,0.92368148
13513,171,522,12,9,0.000588235,818948,0.923695015
14078,529,33,12,9,0.000588235,818960,0.92370855
9801,379,544,12,9,0.000588235,818972,0.923722084
8873,638,463,12,9,0.000588235,818984,0.923735619
12938,596,246,12,9,0.000588235,818996,0.923749154
9428,544,77,12,9,0.000588235,819008,0.923762689
15793,353,2,12,9,0.000588235,819020,0.923776224
15011,663,207,12,9,0.000588235,819032,0.923789759
14625,544,280,12,9,0.000588235,819044,0.923803293
17769,1,614,12,9,0.000588235,819056,0.923816828
17228,596,493,12,9,0.000588235,819068,0.923830363
18164,56,409,12,9,0.000588235,819080,0.923843898
15697,448,5,12,9,0.000588235,819092,0.923857433
16919,11,552,12,9,0.000588235,819104,0.923870968
15746,354,383,12,9,0.000588235,819116,0.923884503
12987,409,393,12,9,0.000588235,819128,0.923898037
12542,475,114,12,9,0.000588235,819140,0.923911572
14056,394,663,12,9,0.000588235,819152,0.923925107
13003,3,683,12,9,0.000588235,819164,0.923938642
15033,130,193,12,9,0.000588235,819176,0.923952177
14107,20,532,12,9,0.000588235,819188,0.923965712
11842,471,236,12,9,0.000588235,819200,0.923979247
15862,605,674,12,9,0.000588235,819212,0.923992781
13543,353,155,12,9,0.000588235,819224,0.924006316
16236,250,652,12,9,0.000588235,819236,0.924019851
16696,588,646,12,9,0.000588235,819248,0.924033386
16242,84,126,12,9,0.000588235,819260,0.924046921
10161,274,114,12,9,0.000588235,819272,0.924060456
17634,43,114,12,9,0.000588235,819284,0.924073991
14542,682,236,12,9,0.000588235,819296,0.924087525
11512,655,463,12,9,0.000588235,819308,0.92410106
10010,224,64,11,9,0.000539216,819319,0.924113467
15030,34,552,11,9,0.000539216,819330,0.924125874
16489,588,673,11,9,0.000539216,819341,0.924138281
16507,264,354,11,9,0.000539216,819352,0.924150688
10727,517,334,11,9,0.000539216,819363,0.924163095
18417,708,544,11,9,0.000539216,819374,0.924175502
13745,562,30,11,9,0.000539216,819385,0.924187909
11351,20,522,11,9,0.000539216,819396,0.924200316
14953,156,311,11,9,0.000539216,819407,0.924212723
11597,14,311,11,9,0.000539216,819418,0.92422513
18421,473,571,11,9,0.000539216,819429,0.924237537
18422,5,294,11,9,0.000539216,819440,0.924249944
11623,14,354,11,9,0.000539216,819451,0.924262351
7603,4,77,11,9,0.000539216,819462,0.924274758
10903,347,84,11,9,0.000539216,819473,0.924287164
16678,720,31,11,9,0.000539216,819484,0.924299571
14140,107,618,11,9,0.000539216,819495,0.924311978
14504,1,171,11,9,0.000539216,819506,0.924324385
10826,250,638,11,9,0.000539216,819517,0.924336792
14501,10,155,11,9,0.000539216,819528,0.924349199
11497,582,448,11,9,0.000539216,819539,0.924361606
14123,164,514,11,9,0.000539216,819550,0.924374013
14547,48,502,11,9,0.000539216,819561,0.92438642
14602,95,552,11,9,0.000539216,819572,0.924398827
16646,427,15,11,9,0.000539216,819583,0.924411234
14598,427,638,11,9,0.000539216,819594,0.924423641
10912,242,264,11,9,0.000539216,819605,0.924436048
14095,719,32,11,9,0.000539216,819616,0.924448455
16669,514,398,11,9,0.000539216,819627,0.924460862
8236,582,140,11,9,0.000539216,819638,0.924473269
14552,593,307,11,9,0.000539216,819649,0.924485676
14489,562,517,11,9,0.000539216,819660,0.924498083
16714,160,107,11,9,0.000539216,819671,0.92451049
18850,364,471,11,9,0.000539216,819682,0.924522896
14277,16,5,11,9,0.000539216,819693,0.924535303
16754,646,404,11,9,0.000539216,819704,0.92454771
12114,12,68,11,9,0.000539216,819715,0.924560117
14290,130,682,11,9,0.000539216,819726,0.924572524
8016,307,393,11,9,0.000539216,819737,0.924584931
16763,544,609,11,9,0.000539216,819748,0.924597338
14327,663,414,11,9,0.000539216,819759,0.924609745
18907,97,207,11,9,0.000539216,819770,0.924622152
12110,497,614,11,9,0.000539216,819781,0.924634559
16809,68,493,11,9,0.000539216,819792,0.924646966
16741,77,181,11,9,0.000539216,819803,0.924659373
14476,514,471,11,9,0.000539216,819814,0.92467178
14471,719,230,11,9,0.000539216,819825,0.924684187
14205,107,511,11,9,0.000539216,819836,0.924696594
10859,32,328,11,9,0.000539216,819847,0.924709001
14433,427,77,11,9,0.000539216,819858,0.924721408
14413,638,398,11,9,0.000539216,819869,0.924733815
14058,586,307,11,9,0.000539216,819880,0.924746222
13860,133,265,11,9,0.000539216,819891,0.924758628
14867,107,652,11,9,0.000539216,819902,0.924771035
14848,22,236,11,9,0.000539216,819913,0.924783442
16967,224,174,11,9,0.000539216,819924,0.924795849
14057,26,439,11,9,0.000539216,819935,0.924808256
10939,133,397,11,9,0.000539216,819946,0.924820663
13884,156,6,11,9,0.000539216,819957,0.92483307
18516,124,6,11,9,0.000539216,819968,0.924845477
14778,202,27,11,9,0.000539216,819979,0.924857884
16573,163,310,11,9,0.000539216,819990,0.924870291
14879,588,701,11,9,0.000539216,820001,0.924882698
14914,164,535,11,9,0.000539216,820012,0.924895105
18451,171,5,11,9,0.000539216,820023,0.924907512
16562,463,398,11,9,0.000539216,820034,0.924919919
14882,23,243,11,9,0.000539216,820045,0.924932326
11584,13,311,11,9,0.000539216,820056,0.924944733
14880,280,673,11,9,0.000539216,820067,0.92495714
14772,379,646,11,9,0.000539216,820078,0.924969547
14771,668,354,11,9,0.000539216,820089,0.924981954
14007,236,392,11,9,0.000539216,820100,0.92499436
10117,638,84,11,9,0.000539216,820111,0.925006767
14009,473,392,11,9,0.000539216,820122,0.925019174
14665,393,64,11,9,0.000539216,820133,0.925031581
14663,15,274,11,9,0.000539216,820144,0.925043988
14022,364,77,11,9,0.000539216,820155,0.925056395
22078,85,701,11,9,0.000539216,820166,0.925068802
10126,528,9,11,9,0.000539216,820177,0.925081209
7855,9,20,11,9,0.000539216,820188,0.925093616
12219,264,10,11,9,0.000539216,820199,0.925106023
14050,314,571,11,9,0.000539216,820210,0.92511843
14763,124,20,11,9,0.000539216,820221,0.925130837
16954,265,347,11,9,0.000539216,820232,0.925143244
14762,511,443,11,9,0.000539216,820243,0.925155651
8414,397,295,11,9,0.000539216,820254,0.925168058
16949,328,164,11,9,0.000539216,820265,0.925180465
13972,668,31,11,9,0.000539216,820276,0.925192872
13975,668,335,11,9,0.000539216,820287,0.925205279
12811,95,50,11,9,0.000539216,820298,0.925217686
20384,502,673,11,9,0.000539216,820309,0.925230092
12466,26,328,11,9,0.000539216,820320,0.925242499
15437,193,95,11,9,0.000539216,820331,0.925254906
13262,34,164,11,9,0.000539216,820342,0.925267313
17522,10,181,11,9,0.000539216,820353,0.92527972
9547,95,236,11,9,0.000539216,820364,0.925292127
13248,193,131,11,9,0.000539216,820375,0.925304534
15944,328,25,11,9,0.000539216,820386,0.925316941
10582,29,27,11,9,0.000539216,820397,0.925329348
11736,196,145,11,9,0.000539216,820408,0.925341755
11227,107,640,11,9,0.000539216,820419,0.925354162
15426,492,397,11,9,0.000539216,820430,0.925366569
15940,160,443,11,9,0.000539216,820441,0.925378976
11254,97,219,11,9,0.000539216,820452,0.925391383
10426,331,482,11,9,0.000539216,820463,0.92540379
9054,25,9,11,9,0.000539216,820474,0.925416197
12767,156,77,11,9,0.000539216,820485,0.925428604
11710,242,586,11,9,0.000539216,820496,0.925441011
13036,638,130,11,9,0.000539216,820507,0.925453418
13038,708,723,11,9,0.000539216,820518,0.925465824
13275,398,463,11,9,0.000539216,820529,0.925478231
15420,517,196,11,9,0.000539216,820540,0.925490638
9439,20,638,11,9,0.000539216,820551,0.925503045
13286,145,614,11,9,0.000539216,820562,0.925515452
16372,103,348,11,9,0.000539216,820573,0.925527859
12785,95,614,11,9,0.000539216,820584,0.925540266
13342,605,498,11,9,0.000539216,820595,0.925552673
16335,243,708,11,9,0.000539216,820606,0.92556508
11771,22,443,11,9,0.000539216,820617,0.925577487
17858,121,367,11,9,0.000539216,820628,0.925589894
17591,364,522,11,9,0.000539216,820639,0.925602301
13140,95,543,11,9,0.000539216,820650,0.925614708
15579,145,501,11,9,0.000539216,820661,0.925627115
13125,123,126,11,9,0.000539216,820672,0.925639522
12885,160,498,11,9,0.000539216,820683,0.925651929
15633,562,97,11,9,0.000539216,820694,0.925664336
12569,295,511,11,9,0.000539216,820705,0.925676743
15620,335,332,11,9,0.000539216,820716,0.92568915
12890,31,674,11,9,0.000539216,820727,0.925701557
11981,394,25,11,9,0.000539216,820738,0.925713963
11778,562,393,11,9,0.000539216,820749,0.92572637
12593,274,674,11,9,0.000539216,820760,0.925738777
11979,32,155,11,9,0.000539216,820771,0.925751184
12918,158,34,11,9,0.000539216,820782,0.925763591
6489,640,158,11,9,0.000539216,820793,0.925775998
11257,674,30,11,9,0.000539216,820804,0.925788405
13059,638,618,11,9,0.000539216,820815,0.925800812
12523,532,12,11,9,0.000539216,820826,0.925813219
15933,50,15,11,9,0.000539216,820837,0.925825626
17550,348,414,11,9,0.000539216,820848,0.925838033
13177,311,167,11,9,0.000539216,820859,0.92585044
15574,501,708,11,9,0.000539216,820870,0.925862847
12589,383,264,11,9,0.000539216,820881,0.925875254
15564,1,443,11,9,0.000539216,820892,0.925887661
13166,475,250,11,9,0.000539216,820903,0.925900068
10314,4,535,11,9,0.000539216,820914,0.925912475
11989,443,646,11,9,0.000539216,820925,0.925924882
15350,708,236,11,9,0.000539216,820936,0.925937289
12673,443,34,11,9,0.000539216,820947,0.925949695
12957,295,171,11,9,0.000539216,820958,0.925962102
11334,280,708,11,9,0.000539216,820969,0.925974509
15740,158,632,11,9,0.000539216,820980,0.925986916
13532,14,243,11,9,0.000539216,820991,0.925999323
9984,609,471,11,9,0.000539216,821002,0.92601173
15175,367,552,11,9,0.000539216,821013,0.926024137
11231,33,22,11,9,0.000539216,821024,0.926036544
15789,10,103,11,9,0.000539216,821035,0.926048951
12647,295,22,11,9,0.000539216,821046,0.926061358
12639,605,311,11,9,0.000539216,821057,0.926073765
16092,170,655,11,9,0.000539216,821068,0.926086172
15775,507,25,11,9,0.000539216,821079,0.926098579
18255,562,514,11,9,0.000539216,821090,0.926110986
16483,145,552,11,9,0.000539216,821101,0.926123393
17362,20,552,11,9,0.000539216,821112,0.9261358
10693,586,117,11,9,0.000539216,821123,0.926148207
15773,56,714,11,9,0.000539216,821134,0.926160614
15106,242,68,11,9,0.000539216,821145,0.926173021
6219,242,158,11,9,0.000539216,821156,0.926185427
16271,274,269,11,9,0.000539216,821167,0.926197834
13576,10,171,11,9,0.000539216,821178,0.926210241
17365,15,294,11,9,0.000539216,821189,0.926222648
12657,20,331,11,9,0.000539216,821200,0.926235055
15161,708,354,11,9,0.000539216,821211,0.926247462
18225,202,663,11,9,0.000539216,821222,0.926259869
15150,354,20,11,9,0.000539216,821233,0.926272276
16116,5,243,11,9,0.000539216,821244,0.926284683
17042,155,196,11,9,0.000539216,821255,0.92629709
10980,16,126,11,9,0.000539216,821266,0.926309497
10504,347,77,11,9,0.000539216,821277,0.926321904
15321,5,145,11,9,0.000539216,821288,0.926334311
17121,479,167,11,9,0.000539216,821299,0.926346718
11010,632,64,11,9,0.000539216,821310,0.926359125
12744,593,558,11,9,0.000539216,821321,0.926371532
16016,535,544,11,9,0.000539216,821332,0.926383939
16179,34,683,11,9,0.000539216,821343,0.926396346
16281,347,243,11,9,0.000539216,821354,0.926408753
12749,497,586,11,9,0.000539216,821365,0.926421159
18080,121,354,11,9,0.000539216,821376,0.926433566
15710,22,33,11,9,0.000539216,821387,0.926445973
17480,117,107,11,9,0.000539216,821398,0.92645838
9587,133,394,11,9,0.000539216,821409,0.926470787
17123,107,171,11,9,0.000539216,821420,0.926483194
13367,15,170,11,9,0.000539216,821431,0.926495601
12736,195,20,11,9,0.000539216,821442,0.926508008
16431,689,723,11,9,0.000539216,821453,0.926520415
16040,674,167,11,9,0.000539216,821464,0.926532822
13415,475,443,11,9,0.000539216,821475,0.926545229
12703,398,25,11,9,0.000539216,821486,0.926557636
11825,414,302,11,9,0.000539216,821497,0.926570043
17743,364,3,11,9,0.000539216,821508,0.92658245
15256,33,682,11,9,0.000539216,821519,0.926594857
16172,171,588,11,9,0.000539216,821530,0.926607264
17444,439,475,11,9,0.000539216,821541,0.926619671
11204,397,392,11,9,0.000539216,821552,0.926632078
16462,393,85,11,9,0.000539216,821563,0.926644485
14578,528,302,10,9,0.000490196,821573,0.926655764
16656,720,347,10,9,0.000490196,821583,0.926667043
15826,334,307,10,9,0.000490196,821593,0.926678322
17654,236,174,10,9,0.000490196,821603,0.926689601
18655,19,224,10,9,0.000490196,821613,0.92670088
16893,528,130,10,9,0.000490196,821623,0.926712159
14571,19,582,10,9,0.000490196,821633,0.926723438
16898,10,624,10,9,0.000490196,821643,0.926734717
7919,439,479,10,9,0.000490196,821653,0.926745996
15782,632,532,10,9,0.000490196,821663,0.926757275
17694,11,632,10,9,0.000490196,821673,0.926768554
16057,264,502,10,9,0.000490196,821683,0.926779833
16046,250,164,10,9,0.000490196,821693,0.926791112
17459,95,4,10,9,0.000490196,821703,0.926802391
14398,77,133,10,9,0.000490196,821713,0.92681367
16177,295,328,10,9,0.000490196,821723,0.926824949
17335,90,311,10,9,0.000490196,821733,0.926836228
16001,674,673,10,9,0.000490196,821743,0.926847507
16166,156,295,10,9,0.000490196,821753,0.926858786
17433,13,522,10,9,0.000490196,821763,0.926870065
11243,64,33,10,9,0.000490196,821773,0.926881344
16147,34,25,10,9,0.000490196,821783,0.926892624
11238,655,663,10,9,0.000490196,821793,0.926903903
16120,295,13,10,9,0.000490196,821803,0.926915182
16114,414,54,10,9,0.000490196,821813,0.926926461
16113,1,529,10,9,0.000490196,821823,0.92693774
14361,171,463,10,9,0.000490196,821833,0.926949019
11240,243,674,10,9,0.000490196,821843,0.926960298
16824,10,493,10,9,0.000490196,821853,0.926971577
17557,458,131,10,9,0.000490196,821863,0.926982856
16702,155,33,10,9,0.000490196,821873,0.926994135
11263,398,522,10,9,0.000490196,821883,0.927005414
15893,392,393,10,9,0.000490196,821893,0.927016693
15881,246,397,10,9,0.000490196,821903,0.927027972
17601,64,123,10,9,0.000490196,821913,0.927039251
16244,614,364,10,9,0.000490196,821923,0.92705053
15874,140,379,10,9,0.000490196,821933,0.927061809
15929,392,473,10,9,0.000490196,821943,0.927073088
18763,243,332,10,9,0.000490196,821953,0.927084367
14454,689,243,10,9,0.000490196,821963,0.927095646
16648,367,126,10,9,0.000490196,821973,0.927106925
15958,605,121,10,9,0.000490196,821983,0.927118204
14486,498,508,10,9,0.000490196,821993,0.927129483
15772,34,385,10,9,0.000490196,822003,0.927140762
16415,721,10,10,9,0.000490196,822013,0.927152042
14916,19,348,10,9,0.000490196,822023,0.927163321
16402,280,618,10,9,0.000490196,822033,0.9271746
16547,274,605,10,9,0.000490196,822043,0.927185879
14929,54,380,10,9,0.000490196,822053,0.927197158
16406,174,311,10,9,0.000490196,822063,0.927208437
14942,528,663,10,9,0.000490196,822073,0.927219716
15306,13,638,10,9,0.000490196,822083,0.927230995
17097,522,571,10,9,0.000490196,822093,0.927242274
18420,269,532,10,9,0.000490196,822103,0.927253553
17130,479,652,10,9,0.000490196,822113,0.927264832
16558,674,4,10,9,0.000490196,822123,0.927276111
14897,48,683,10,9,0.000490196,822133,0.92728739
18006,552,121,10,9,0.000490196,822143,0.927298669
15430,525,310,10,9,0.000490196,822153,0.927309948
15418,56,364,10,9,0.000490196,822163,0.927321227
18022,224,448,10,9,0.000490196,822173,0.927332506
18028,207,471,10,9,0.000490196,822183,0.927343785
16378,3,195,10,9,0.000490196,822193,0.927355064
11378,331,140,10,9,0.000490196,822203,0.927366343
18029,14,560,10,9,0.000490196,822213,0.927377622
18406,347,250,10,9,0.000490196,822223,0.927388901
15060,427,596,10,9,0.000490196,822233,0.92740018
18208,156,479,10,9,0.000490196,822243,0.92741146
15179,624,558,10,9,0.000490196,822253,0.927422739
15171,632,84,10,9,0.000490196,822263,0.927434018
10961,12,302,10,9,0.000490196,822273,0.927445297
15165,708,22,10,9,0.000490196,822283,0.927456576
15160,404,497,10,9,0.000490196,822293,0.927467855
15153,473,103,10,9,0.000490196,822303,0.927479134
15062,302,552,10,9,0.000490196,822313,0.927490413
15066,145,22,10,9,0.000490196,822323,0.927501692
15138,609,674,10,9,0.000490196,822333,0.927512971
15123,683,230,10,9,0.000490196,822343,0.92752425
18302,307,364,10,9,0.000490196,822353,0.927535529
16516,674,414,10,9,0.000490196,822363,0.927546808
11325,511,230,10,9,0.000490196,822373,0.927558087
16460,145,167,10,9,0.000490196,822383,0.927569366
15258,427,397,10,9,0.000490196,822393,0.927580645
18140,117,427,10,9,0.000490196,822403,0.927591924
15247,158,609,10,9,0.000490196,822413,0.927603203
16991,347,114,10,9,0.000490196,822423,0.927614482
15243,552,156,10,9,0.000490196,822433,0.927625761
16468,97,596,10,9,0.000490196,822443,0.92763704
18377,348,646,10,9,0.000490196,822453,0.927648319
11295,12,25,10,9,0.000490196,822463,0.927659598
17794,90,335,10,9,0.000490196,822473,0.927670878
14659,640,502,10,9,0.000490196,822483,0.927682157
18599,13,596,10,9,0.000490196,822493,0.927693436
15657,517,243,10,9,0.000490196,822503,0.927704715
14687,295,501,10,9,0.000490196,822513,0.927715994
7727,640,3,10,9,0.000490196,822523,0.927727273
15638,95,265,10,9,0.000490196,822533,0.927738552
15634,2,614,10,9,0.000490196,822543,0.927749831
15623,56,683,10,9,0.000490196,822553,0.92776111
17833,328,502,10,9,0.000490196,822563,0.927772389
16324,719,5,10,9,0.000490196,822573,0.927783668
15766,174,508,10,9,0.000490196,822583,0.927794947
15764,167,68,10,9,0.000490196,822593,0.927806226
14607,535,511,10,9,0.000490196,822603,0.927817505
17233,145,242,10,9,0.000490196,822613,0.927828784
17756,482,582,10,9,0.000490196,822623,0.927840063
15705,84,29,10,9,0.000490196,822633,0.927851342
15704,80,652,10,9,0.000490196,822643,0.927862621
14647,160,532,10,9,0.000490196,822653,0.9278739
16587,682,723,10,9,0.000490196,822663,0.927885179
11288,95,674,10,9,0.000490196,822673,0.927896458
14793,596,64,10,9,0.000490196,822683,0.927907737
14806,498,640,10,9,0.000490196,822693,0.927919016
11024,689,353,10,9,0.000490196,822703,0.927930296
15488,385,4,10,9,0.000490196,822713,0.927941575
17981,517,204,10,9,0.000490196,822723,0.927952854
17156,719,16,10,9,0.000490196,822733,0.927964133
17147,427,6,10,9,0.000490196,822743,0.927975412
14827,475,655,10,9,0.000490196,822753,0.927986691
14831,77,171,10,9,0.000490196,822763,0.92799797
14776,655,503,10,9,0.000490196,822773,0.928009249
17928,632,560,10,9,0.000490196,822783,0.928020528
15591,219,528,10,9,0.000490196,822793,0.928031807
14729,379,587,10,9,0.000490196,822803,0.928043086
15587,668,331,10,9,0.000490196,822813,0.928054365
14732,482,379,10,9,0.000490196,822823,0.928065644
14733,230,482,10,9,0.000490196,822833,0.928076923
16342,25,503,10,9,0.000490196,822843,0.928088202
14767,307,141,10,9,0.000490196,822853,0.928099481
15531,164,596,10,9,0.000490196,822863,0.92811076
11630,385,68,10,9,0.000490196,822873,0.928122039
14065,307,170,10,9,0.000490196,822883,0.928133318
8306,720,20,10,9,0.000490196,822893,0.928144597
13457,307,250,10,9,0.000490196,822903,0.928155876
12586,123,587,10,9,0.000490196,822913,0.928167155
13204,501,156,10,9,0.000490196,822923,0.928178434
13205,502,473,10,9,0.000490196,822933,0.928189714
12862,26,12,10,9,0.000490196,822943,0.928200993
19241,195,294,10,9,0.000490196,822953,0.928212272
12162,668,588,10,9,0.000490196,822963,0.928223551
14041,501,385,10,9,0.000490196,822973,0.92823483
13607,219,404,10,9,0.000490196,822983,0.928246109
13475,618,723,10,9,0.000490196,822993,0.928257388
9504,274,586,10,9,0.000490196,823003,0.928268667
20788,50,392,10,9,0.000490196,823013,0.928279946
14043,335,103,10,9,0.000490196,823023,0.928291225
14053,314,624,10,9,0.000490196,823033,0.928302504
10077,9,507,10,9,0.000490196,823043,0.928313783
12431,12,463,10,9,0.000490196,823053,0.928325062
13090,160,243,10,9,0.000490196,823063,0.928336341
14049,242,614,10,9,0.000490196,823073,0.92834762
9480,11,475,10,9,0.000490196,823083,0.928358899
19689,230,319,10,9,0.000490196,823093,0.928370178
19042,471,414,10,9,0.000490196,823103,0.928381457
13070,145,121,10,9,0.000490196,823113,0.928392736
11788,295,130,10,9,0.000490196,823123,0.928404015
19621,532,5,10,9,0.000490196,823133,0.928415294
11826,105,195,10,9,0.000490196,823143,0.928426573
11703,32,25,10,9,0.000490196,823153,0.928437852
21534,393,181,10,9,0.000490196,823163,0.928449132
14113,133,354,10,9,0.000490196,823173,0.928460411
12380,439,50,10,9,0.000490196,823183,0.92847169
20059,121,663,10,9,0.000490196,823193,0.928482969
13825,463,517,10,9,0.000490196,823203,0.928494248
12756,30,674,10,9,0.000490196,823213,0.928505527
12281,640,439,10,9,0.000490196,823223,0.928516806
13567,661,27,10,9,0.000490196,823233,0.928528085
13154,385,26,10,9,0.000490196,823243,0.928539364
10491,265,107,10,9,0.000490196,823253,0.928550643
12101,544,6,10,9,0.000490196,823263,0.928561922
19201,243,640,10,9,0.000490196,823273,0.928573201
12247,367,25,10,9,0.000490196,823283,0.92858448
13978,663,528,10,9,0.000490196,823293,0.928595759
11869,529,22,10,9,0.000490196,823303,0.928607038
21792,124,33,10,9,0.000490196,823313,0.928618317
13990,26,552,10,9,0.000490196,823323,0.928629596
11564,3,605,10,9,0.000490196,823333,0.928640875
13923,414,638,10,9,0.000490196,823343,0.928652154
13919,56,501,10,9,0.000490196,823353,0.928663433
13943,632,11,10,9,0.000490196,823363,0.928674712
21819,714,443,10,9,0.000490196,823373,0.928685991
10169,25,582,10,9,0.000490196,823383,0.92869727
12338,310,605,10,9,0.000490196,823393,0.92870855
13525,593,334,10,9,0.000490196,823403,0.928719829
12958,280,97,10,9,0.000490196,823413,0.928731108
14017,404,236,10,9,0.000490196,823423,0.928742387
12023,295,497,10,9,0.000490196,823433,0.928753666
12253,80,661,10,9,0.000490196,823443,0.928764945
9514,682,123,10,9,0.000490196,823453,0.928776224
19229,427,544,10,9,0.000490196,823463,0.928787503
13891,525,473,10,9,0.000490196,823473,0.928798782
11537,439,393,10,9,0.000490196,823483,0.928810061
13591,158,6,10,9,0.000490196,823493,0.92882134
14003,596,54,10,9,0.000490196,823503,0.928832619
9359,497,334,10,9,0.000490196,823513,0.928843898
12823,719,314,10,9,0.000490196,823523,0.928855177
13508,164,335,10,9,0.000490196,823533,0.928866456
13506,163,236,10,9,0.000490196,823543,0.928877735
13504,331,618,10,9,0.000490196,823553,0.928889014
13770,632,13,10,9,0.000490196,823563,0.928900293
11593,224,171,10,9,0.000490196,823573,0.928911572
14226,443,632,10,9,0.000490196,823583,0.928922851
12140,498,427,10,9,0.000490196,823593,0.92893413
13267,458,473,10,9,0.000490196,823603,0.928945409
13022,596,560,10,9,0.000490196,823613,0.928956688
12735,632,562,10,9,0.000490196,823623,0.928967968
13710,522,652,10,9,0.000490196,823633,0.928979247
12717,582,155,10,9,0.000490196,823643,0.928990526
14212,302,195,10,9,0.000490196,823653,0.929001805
19549,394,269,10,9,0.000490196,823663,0.929013084
14303,138,224,10,9,0.000490196,823673,0.929024363
10477,331,261,10,9,0.000490196,823683,0.929035642
10243,48,544,10,9,0.000490196,823693,0.929046921
14239,246,354,10,9,0.000490196,823703,0.9290582
12710,582,193,10,9,0.000490196,823713,0.929069479
21013,290,29,10,9,0.000490196,823723,0.929080758
12377,507,367,10,9,0.000490196,823733,0.929092037
9078,145,77,10,9,0.000490196,823743,0.929103316
12019,29,302,10,9,0.000490196,823753,0.929114595
14249,507,243,10,9,0.000490196,823763,0.929125874
13294,5,640,10,9,0.000490196,823773,0.929137153
13752,682,107,10,9,0.000490196,823783,0.929148432
14211,310,156,10,9,0.000490196,823793,0.929159711
12226,196,114,10,9,0.000490196,823803,0.92917099
13162,242,107,10,9,0.000490196,823813,0.929182269
12737,313,673,10,9,0.000490196,823823,0.929193548
13249,397,97,10,9,0.000490196,823833,0.929204827
11759,721,532,10,9,0.000490196,823843,0.929216106
10228,605,32,10,9,0.000490196,823853,0.929227386
19311,571,145,10,9,0.000490196,823863,0.929238665
13671,250,246,10,9,0.000490196,823873,0.929249944
13241,446,27,10,9,0.000490196,823883,0.929261223
8663,640,174,10,9,0.000490196,823893,0.929272502
10832,265,230,10,9,0.000490196,823903,0.929283781
14186,393,145,10,9,0.000490196,823913,0.92929506
14180,195,68,10,9,0.000490196,823923,0.929306339
13053,22,379,10,9,0.000490196,823933,0.929317618
10721,473,164,10,9,0.000490196,823943,0.929328897
19023,528,385,10,9,0.000490196,823953,0.929340176
13238,160,280,10,9,0.000490196,823963,0.929351455
14312,14,638,10,9,0.000490196,823973,0.929362734
19780,178,131,10,9,0.000490196,823983,0.929374013
11760,498,414,10,9,0.000490196,823993,0.929385292
13659,50,529,10,9,0.000490196,824003,0.929396571
12539,5,97,10,9,0.000490196,824013,0.92940785
13219,367,543,10,9,0.000490196,824023,0.929419129
17506,6,714,9,9,0.000441176,824032,0.92942928
18243,171,560,9,9,0.000441176,824041,0.929439432
18256,311,290,9,9,0.000441176,824050,0.929449583
11645,32,502,9,9,0.000441176,824059,0.929459734
17105,164,167,9,9,0.000441176,824068,0.929469885
21370,156,503,9,9,0.000441176,824077,0.929480036
18310,12,347,9,9,0.000441176,824086,0.929490187
12322,242,497,9,9,0.000441176,824095,0.929500338
11625,9,294,9,9,0.000441176,824104,0.92951049
11629,54,335,9,9,0.000441176,824113,0.929520641
17487,219,171,9,9,0.000441176,824122,0.929530792
21874,463,605,9,9,0.000441176,824131,0.929540943
11620,250,4,9,9,0.000441176,824140,0.929551094
18343,163,68,9,9,0.000441176,824149,0.929561245
18337,158,613,9,9,0.000441176,824158,0.929571396
18322,311,171,9,9,0.000441176,824167,0.929581547
8677,683,314,9,9,0.000441176,824176,0.929591699
11894,507,334,9,9,0.000441176,824185,0.92960185
11069,498,683,9,9,0.000441176,824194,0.929612001
15001,48,274,9,9,0.000441176,824203,0.929622152
17500,5,353,9,9,0.000441176,824212,0.929632303
15093,511,22,9,9,0.000441176,824221,0.929642454
12761,31,543,9,9,0.000441176,824230,0.929652605
18293,50,243,9,9,0.000441176,824239,0.929662757
13615,618,302,9,9,0.000441176,824248,0.929672908
15088,475,427,9,9,0.000441176,824257,0.929683059
17943,364,311,9,9,0.000441176,824266,0.92969321
12889,302,25,9,9,0.000441176,824275,0.929703361
9455,141,80,9,9,0.000441176,824284,0.929713512
15492,23,532,9,9,0.000441176,824293,0.929723663
18100,492,404,9,9,0.000441176,824302,0.929733815
17596,265,385,9,9,0.000441176,824311,0.929743966
15496,14,586,9,9,0.000441176,824320,0.929754117
15323,528,655,9,9,0.000441176,824329,0.929764268
15878,331,195,9,9,0.000441176,824338,0.929774419
15876,178,68,9,9,0.000441176,824347,0.92978457
11291,638,107,9,9,0.000441176,824356,0.929794721
19590,668,367,9,9,0.000441176,824365,0.929804873
18013,25,414,9,9,0.000441176,824374,0.929815024
17651,348,587,9,9,0.000441176,824383,0.929825175
17994,364,32,9,9,0.000441176,824392,0.929835326
15459,156,97,9,9,0.000441176,824401,0.929845477
12293,393,638,9,9,0.000441176,824410,0.929855628
13312,12,663,9,9,0.000441176,824419,0.929865779
15804,552,242,9,9,0.000441176,824428,0.929875931
15807,13,29,9,9,0.000441176,824437,0.929886082
12298,90,77,9,9,0.000441176,824446,0.929896233
15840,501,439,9,9,0.000441176,824455,0.929906384
11847,34,141,9,9,0.000441176,824464,0.929916535
21738,34,43,9,9,0.000441176,824473,0.929926686
15953,385,25,9,9,0.000441176,824482,0.929936837
13519,593,50,9,9,0.000441176,824491,0.929946988
15211,463,25,9,9,0.000441176,824500,0.92995714
15518,56,632,9,9,0.000441176,824509,0.929967291
15969,475,497,9,9,0.000441176,824518,0.929977442
12075,502,264,9,9,0.000441176,824527,0.929987593
10682,264,529,9,9,0.000441176,824536,0.929997744
10679,103,123,9,9,0.000441176,824545,0.930007895
17516,682,97,9,9,0.000441176,824554,0.930018046
12807,532,593,9,9,0.000441176,824563,0.930028198
12861,682,84,9,9,0.000441176,824572,0.930038349
15273,196,280,9,9,0.000441176,824581,0.9300485
13425,367,156,9,9,0.000441176,824590,0.930058651
13419,12,121,9,9,0.000441176,824599,0.930068802
21130,471,569,9,9,0.000441176,824608,0.930078953
15289,34,562,9,9,0.000441176,824617,0.930089104
17589,14,609,9,9,0.000441176,824626,0.930099256
15297,332,529,9,9,0.000441176,824635,0.930109407
18110,673,562,9,9,0.000441176,824644,0.930119558
13440,596,708,9,9,0.000441176,824653,0.930129709
20352,33,178,9,9,0.000441176,824662,0.93013986
13450,307,614,9,9,0.000441176,824671,0.930150011
15508,195,15,9,9,0.000441176,824680,0.930160162
12583,84,661,9,9,0.000441176,824689,0.930170314
17266,427,674,9,9,0.000441176,824698,0.930180465
16718,448,32,9,9,0.000441176,824707,0.930190616
14099,250,274,9,9,0.000441176,824716,0.930200767
14575,30,236,9,9,0.000441176,824725,0.930210918
14092,302,618,9,9,0.000441176,824734,0.930221069
14503,543,164,9,9,0.000441176,824743,0.93023122
14158,107,482,9,9,0.000441176,824752,0.930241372
18736,532,290,9,9,0.000441176,824761,0.930251523
14150,34,171,9,9,0.000441176,824770,0.930261674
14148,392,16,9,9,0.000441176,824779,0.930271825
16834,673,502,9,9,0.000441176,824788,0.930281976
13065,332,443,9,9,0.000441176,824797,0.930292127
14528,528,334,9,9,0.000441176,824806,0.930302278
18705,48,618,9,9,0.000441176,824815,0.93031243
14540,43,97,9,9,0.000441176,824824,0.930322581
12172,473,507,9,9,0.000441176,824833,0.930332732
14646,543,632,9,9,0.000441176,824842,0.930342883
22518,348,613,9,9,0.000441176,824851,0.930353034
17307,48,503,9,9,0.000441176,824860,0.930363185
14024,586,723,9,9,0.000441176,824869,0.930373336
17828,80,20,9,9,0.000441176,824878,0.930383487
14657,397,593,9,9,0.000441176,824887,0.930393639
15728,20,334,9,9,0.000441176,824896,0.93040379
9716,95,158,9,9,0.000441176,824905,0.930413941
16846,114,514,9,9,0.000441176,824914,0.930424092
12585,529,535,9,9,0.000441176,824923,0.930434243
17144,302,207,9,9,0.000441176,824932,0.930444394
16226,6,482,9,9,0.000441176,824941,0.930454545
14068,140,393,9,9,0.000441176,824950,0.930464697
18642,155,655,9,9,0.000441176,824959,0.930474848
9742,310,22,9,9,0.000441176,824968,0.930484999
11176,517,11,9,9,0.000441176,824977,0.93049515
15687,1,498,9,9,0.000441176,824986,0.930505301
12501,507,655,9,9,0.000441176,824995,0.930515452
14266,511,532,9,9,0.000441176,825004,0.930525603
17193,335,624,9,9,0.000441176,825013,0.930535755
12504,502,558,9,9,0.000441176,825022,0.930545906
14244,529,414,9,9,0.000441176,825031,0.930556057
13041,11,638,9,9,0.000441176,825040,0.930566208
16317,364,131,9,9,0.000441176,825049,0.930576359
14418,224,155,9,9,0.000441176,825058,0.93058651
17788,1,141,9,9,0.000441176,825067,0.930596661
17164,307,552,9,9,0.000441176,825076,0.930606813
11044,689,443,9,9,0.000441176,825085,0.930616964
14301,525,95,9,9,0.000441176,825094,0.930627115
20621,156,502,9,9,0.000441176,825103,0.930637266
16289,471,708,9,9,0.000441176,825112,0.930647417
21082,117,544,9,9,0.000441176,825121,0.930657568
18768,140,347,9,9,0.000441176,825130,0.930667719
13054,507,311,9,9,0.000441176,825139,0.930677871
17040,124,473,9,9,0.000441176,825148,0.930688022
10341,673,398,9,9,0.000441176,825157,0.930698173
17148,335,319,9,9,0.000441176,825166,0.930708324
16312,364,48,9,9,0.000441176,825175,0.930718475
18824,243,383,9,9,0.000441176,825184,0.930728626
14439,497,145,9,9,0.000441176,825193,0.930738777
13045,242,32,9,9,0.000441176,825202,0.930748928
15675,97,535,9,9,0.000441176,825211,0.93075908
14222,640,126,9,9,0.000441176,825220,0.930769231
21080,492,393,9,9,0.000441176,825229,0.930779382
15671,383,265,9,9,0.000441176,825238,0.930789533
17312,501,714,9,9,0.000441176,825247,0.930799684
13857,261,123,9,9,0.000441176,825256,0.930809835
11919,195,32,9,9,0.000441176,825265,0.930819986
18485,683,10,9,9,0.000441176,825274,0.930830138
19244,121,596,9,9,0.000441176,825283,0.930840289
13849,1,543,9,9,0.000441176,825292,0.93085044
9211,689,20,9,9,0.000441176,825301,0.930860591
16667,335,23,9,9,0.000441176,825310,0.930870742
13863,507,397,9,9,0.000441176,825319,0.930880893
20319,236,571,9,9,0.000441176,825328,0.930891044
16647,404,33,9,9,0.000441176,825337,0.930901196
15745,77,446,9,9,0.000441176,825346,0.930911347
14810,1,535,9,9,0.000441176,825355,0.930921498
11813,12,535,9,9,0.000441176,825364,0.930931649
20020,204,514,9,9,0.000441176,825373,0.9309418
22004,544,613,9,9,0.000441176,825382,0.930951951
17400,562,265,9,9,0.000441176,825391,0.930962102
15758,124,16,9,9,0.000441176,825400,0.930972254
10948,624,32,9,9,0.000441176,825409,0.930982405
8590,646,80,9,9,0.000441176,825418,0.930992556
17446,632,107,9,9,0.000441176,825427,0.931002707
9626,196,158,9,9,0.000441176,825436,0.931012858
14918,721,68,9,9,0.000441176,825445,0.931023009
12088,404,265,9,9,0.000441176,825454,0.93103316
14895,5,331,9,9,0.000441176,825463,0.931043312
16097,708,532,9,9,0.000441176,825472,0.931053463
21990,25,167,9,9,0.000441176,825481,0.931063614
12428,164,501,9,9,0.000441176,825490,0.931073765
13810,14,236,9,9,0.000441176,825499,0.931083916
11376,638,158,9,9,0.000441176,825508,0.931094067
13806,14,29,9,9,0.000441176,825517,0.931104218
16476,511,655,9,9,0.000441176,825526,0.93111437
11363,123,20,9,9,0.000441176,825535,0.931124521
11399,302,683,9,9,0.000441176,825544,0.931134672
17838,15,614,9,9,0.000441176,825553,0.931144823
16041,171,543,9,9,0.000441176,825562,0.931154974
16173,77,155,9,9,0.000441176,825571,0.931165125
14697,632,167,9,9,0.000441176,825580,0.931175276
10372,394,158,9,9,0.000441176,825589,0.931185427
11540,614,398,9,9,0.000441176,825598,0.931195579
13984,353,261,9,9,0.000441176,825607,0.93120573
15553,528,558,9,9,0.000441176,825616,0.931215881
10932,30,84,9,9,0.000441176,825625,0.931226032
15765,280,171,9,9,0.000441176,825634,0.931236183
12008,543,84,9,9,0.000441176,825643,0.931246334
14780,721,335,9,9,0.000441176,825652,0.931256485
14785,1,427,9,9,0.000441176,825661,0.931266637
15742,84,30,9,9,0.000441176,825670,0.931276788
16677,655,605,9,9,0.000441176,825679,0.931286939
14961,719,9,9,9,0.000441176,825688,0.93129709
13939,2,535,9,9,0.000441176,825697,0.931307241
15606,394,204,9,9,0.000441176,825706,0.931317392
13920,130,544,9,9,0.000441176,825715,0.931327543
16063,701,31,9,9,0.000441176,825724,0.931337695
7148,6,624,17,8,0.000833333,825741,0.931356869
12949,193,558,16,8,0.000784314,825757,0.931374915
12061,20,141,15,8,0.000735294,825772,0.931391834
12803,479,673,15,8,0.000735294,825787,0.931408753
10958,133,443,15,8,0.000735294,825802,0.931425671
18979,364,347,15,8,0.000735294,825817,0.93144259
12315,95,661,14,8,0.000686275,825831,0.93145838
13145,20,588,14,8,0.000686275,825845,0.931474171
15315,97,723,14,8,0.000686275,825859,0.931489962
14971,443,332,14,8,0.000686275,825873,0.931505752
17524,64,224,13,8,0.000637255,825886,0.931520415
9496,171,80,13,8,0.000637255,825899,0.931535078
11166,638,121,13,8,0.000637255,825912,0.931549741
9286,535,85,13,8,0.000637255,825925,0.931564403
13107,261,50,13,8,0.000637255,825938,0.931579066
15837,22,367,13,8,0.000637255,825951,0.931593729
11822,133,77,13,8,0.000637255,825964,0.931608392
18658,463,493,13,8,0.000637255,825977,0.931623054
8076,367,141,13,8,0.000637255,825990,0.931637717
15287,314,178,13,8,0.000637255,826003,0.93165238
15112,204,242,13,8,0.000637255,826016,0.931667043
13638,328,562,13,8,0.000637255,826029,0.931681705
13461,130,1,13,8,0.000637255,826042,0.931696368
13837,156,529,13,8,0.000637255,826055,0.931711031
14850,280,261,13,8,0.000637255,826068,0.931725694
12666,2,170,13,8,0.000637255,826081,0.931740356
16353,463,117,13,8,0.000637255,826094,0.931755019
16858,414,528,13,8,0.000637255,826107,0.931769682
12064,274,479,13,8,0.000637255,826120,0.931784345
15585,117,558,12,8,0.000588235,826132,0.93179788
12494,393,261,12,8,0.000588235,826144,0.931811414
19455,25,332,12,8,0.000588235,826156,0.931824949
11773,140,596,12,8,0.000588235,826168,0.931838484
15003,12,6,12,8,0.000588235,826180,0.931852019
15669,56,502,12,8,0.000588235,826192,0.931865554
10781,532,507,12,8,0.000588235,826204,0.931879089
13102,95,596,12,8,0.000588235,826216,0.931892624
14883,246,331,12,8,0.000588235,826228,0.931906158
9069,614,544,12,8,0.000588235,826240,0.931919693
18114,26,126,12,8,0.000588235,826252,0.931933228
13802,348,328,12,8,0.000588235,826264,0.931946763
13369,482,354,12,8,0.000588235,826276,0.931960298
15349,174,97,12,8,0.000588235,826288,0.931973833
16392,674,155,12,8,0.000588235,826300,0.931987367
17166,290,224,12,8,0.000588235,826312,0.932000902
11299,398,471,12,8,0.000588235,826324,0.932014437
12271,124,196,12,8,0.000588235,826336,0.932027972
13836,471,723,12,8,0.000588235,826348,0.932041507
14841,133,295,12,8,0.000588235,826360,0.932055042
17501,498,126,12,8,0.000588235,826372,0.932068577
9573,582,508,12,8,0.000588235,826384,0.932082111
9520,105,171,12,8,0.000588235,826396,0.932095646
12801,14,30,12,8,0.000588235,826408,0.932109181
11913,528,354,12,8,0.000588235,826420,0.932122716
13597,10,618,12,8,0.000588235,826432,0.932136251
8020,265,393,12,8,0.000588235,826444,0.932149786
10394,638,532,12,8,0.000588235,826456,0.932163321
11903,701,6,12,8,0.000588235,826468,0.932176855
10987,632,1,12,8,0.000588235,826480,0.93219039
11815,204,393,12,8,0.000588235,826492,0.932203925
13505,3,560,12,8,0.000588235,826504,0.93221746
10038,145,586,12,8,0.000588235,826516,0.932230995
9974,9,392,12,8,0.000588235,826528,0.93224453
15025,174,195,12,8,0.000588235,826540,0.932258065
13693,514,517,12,8,0.000588235,826552,0.932271599
12373,385,522,12,8,0.000588235,826564,0.932285134
6786,640,379,12,8,0.000588235,826576,0.932298669
12540,56,242,12,8,0.000588235,826588,0.932312204
12561,250,307,12,8,0.000588235,826600,0.932325739
12921,354,646,12,8,0.000588235,826612,0.932339274
20226,364,348,11,8,0.000539216,826623,0.932351681
13759,310,507,11,8,0.000539216,826634,0.932364088
7493,31,158,11,8,0.000539216,826645,0.932376494
14966,473,503,11,8,0.000539216,826656,0.932388901
12325,290,27,11,8,0.000539216,826667,0.932401308
12301,43,674,11,8,0.000539216,826678,0.932413715
16980,171,155,11,8,0.000539216,826689,0.932426122
12328,90,380,11,8,0.000539216,826700,0.932438529
17014,167,14,11,8,0.000539216,826711,0.932450936
15071,131,193,11,8,0.000539216,826722,0.932463343
16935,347,596,11,8,0.000539216,826733,0.93247575
12186,497,498,11,8,0.000539216,826744,0.932488157
14529,140,558,11,8,0.000539216,826755,0.932500564
12181,145,164,11,8,0.000539216,826766,0.932512971
14513,156,367,11,8,0.000539216,826777,0.932525378
14505,683,310,11,8,0.000539216,826788,0.932537785
10825,4,131,11,8,0.000539216,826799,0.932550192
10831,682,264,11,8,0.000539216,826810,0.932562599
14604,236,140,11,8,0.000539216,826821,0.932575006
14557,174,95,11,8,0.000539216,826832,0.932587413
14393,443,503,11,8,0.000539216,826843,0.93259982
14371,414,502,11,8,0.000539216,826854,0.932612226
14307,507,348,11,8,0.000539216,826865,0.932624633
14258,158,156,11,8,0.000539216,826876,0.93263704
20479,503,596,11,8,0.000539216,826887,0.932649447
10188,562,535,11,8,0.000539216,826898,0.932661854
16643,624,224,11,8,0.000539216,826909,0.932674261
14612,397,54,11,8,0.000539216,826920,0.932686668
10231,383,224,11,8,0.000539216,826931,0.932699075
13841,264,242,11,8,0.000539216,826942,0.932711482
13847,689,280,11,8,0.000539216,826953,0.932723889
12069,32,624,11,8,0.000539216,826964,0.932736296
13881,31,114,11,8,0.000539216,826975,0.932748703
12262,12,158,11,8,0.000539216,826986,0.93276111
20458,114,508,11,8,0.000539216,826997,0.932773517
16549,95,2,11,8,0.000539216,827008,0.932785924
13777,334,498,11,8,0.000539216,827019,0.932798331
13784,624,15,11,8,0.000539216,827030,0.932810738
7672,683,27,11,8,0.000539216,827041,0.932823145
14889,535,22,11,8,0.000539216,827052,0.932835552
16974,103,131,11,8,0.000539216,827063,0.932847958
13999,27,668,11,8,0.000539216,827074,0.932860365
14645,640,571,11,8,0.000539216,827085,0.932872772
14634,655,167,11,8,0.000539216,827096,0.932885179
14616,655,348,11,8,0.000539216,827107,0.932897586
14690,145,13,11,8,0.000539216,827118,0.932909993
18530,13,11,11,8,0.000539216,827129,0.9329224
16603,29,204,11,8,0.000539216,827140,0.932934807
13976,543,535,11,8,0.000539216,827151,0.932947214
14701,427,107,11,8,0.000539216,827162,0.932959621
15091,632,164,11,8,0.000539216,827173,0.932972028
13250,586,295,11,8,0.000539216,827184,0.932984435
15434,367,167,11,8,0.000539216,827195,0.932996842
15950,624,167,11,8,0.000539216,827206,0.933009249
15951,156,723,11,8,0.000539216,827217,0.933021656
15834,202,582,11,8,0.000539216,827228,0.933034063
13239,398,141,11,8,0.000539216,827239,0.93304647
13245,562,243,11,8,0.000539216,827250,0.933058877
18052,511,313,11,8,0.000539216,827261,0.933071284
17200,264,50,11,8,0.000539216,827272,0.933083691
15686,397,723,11,8,0.000539216,827283,0.933096097
15978,427,498,11,8,0.000539216,827294,0.933108504
17142,335,571,11,8,0.000539216,827305,0.933120911
13297,156,170,11,8,0.000539216,827316,0.933133318
17503,463,155,11,8,0.000539216,827327,0.933145725
12525,493,331,11,8,0.000539216,827338,0.933158132
15604,593,347,11,8,0.000539216,827349,0.933170539
17599,385,471,11,8,0.000539216,827360,0.933182946
13073,90,16,11,8,0.000539216,827371,0.933195353
16309,605,31,11,8,0.000539216,827382,0.93320776
16323,427,243,11,8,0.000539216,827393,0.933220167
11779,34,609,11,8,0.000539216,827404,0.933232574
13193,107,632,11,8,0.000539216,827415,0.933244981
15528,674,514,11,8,0.000539216,827426,0.933257388
9492,2,638,11,8,0.000539216,827437,0.933269795
16347,12,544,11,8,0.000539216,827448,0.933282202
15572,90,331,11,8,0.000539216,827459,0.933294609
17046,140,264,11,8,0.000539216,827470,0.933307016
12675,397,479,11,8,0.000539216,827481,0.933319423
17048,121,230,11,8,0.000539216,827492,0.933331829
15220,385,347,11,8,0.000539216,827503,0.933344236
12676,473,701,11,8,0.000539216,827514,0.933356643
15209,20,571,11,8,0.000539216,827525,0.93336905
15208,3,502,11,8,0.000539216,827536,0.933381457
16071,155,353,11,8,0.000539216,827547,0.933393864
15774,243,593,11,8,0.000539216,827558,0.933406271
9997,80,2,11,8,0.000539216,827569,0.933418678
15109,246,310,11,8,0.000539216,827580,0.933431085
16487,15,242,11,8,0.000539216,827591,0.933443492
12985,493,84,11,8,0.000539216,827602,0.933455899
12363,507,84,11,8,0.000539216,827613,0.933468306
16115,43,532,11,8,0.000539216,827624,0.933480713
10684,507,302,11,8,0.000539216,827635,0.93349312
16069,673,552,11,8,0.000539216,827646,0.933505527
15712,126,27,11,8,0.000539216,827657,0.933517934
17117,243,156,11,8,0.000539216,827668,0.933530341
11004,640,397,11,8,0.000539216,827679,0.933542748
13406,160,26,11,8,0.000539216,827690,0.933555155
16024,558,528,11,8,0.000539216,827701,0.933567561
15328,558,13,11,8,0.000539216,827712,0.933579968
13365,721,9,11,8,0.000539216,827723,0.933592375
11115,16,714,11,8,0.000539216,827734,0.933604782
17456,347,264,11,8,0.000539216,827745,0.933617189
13007,582,493,11,8,0.000539216,827756,0.933629596
16059,54,334,11,8,0.000539216,827767,0.933642003
11908,529,398,11,8,0.000539216,827778,0.93365441
15271,614,528,11,8,0.000539216,827789,0.933666817
11809,543,141,11,8,0.000539216,827800,0.933679224
10259,2,77,11,8,0.000539216,827811,0.933691631
15835,26,383,10,8,0.000490196,827821,0.93370291
16675,156,50,10,8,0.000490196,827831,0.933714189
18683,15,117,10,8,0.000490196,827841,0.933725468
17449,14,294,10,8,0.000490196,827851,0.933736747
16035,43,463,10,8,0.000490196,827861,0.933748026
16033,624,131,10,8,0.000490196,827871,0.933759305
16801,497,15,10,8,0.000490196,827881,0.933770584
11251,414,558,10,8,0.000490196,827891,0.933781863
16250,97,280,10,8,0.000490196,827901,0.933793142
14336,295,609,10,8,0.000490196,827911,0.933804421
14337,439,443,10,8,0.000490196,827921,0.9338157
10882,544,588,10,8,0.000490196,827931,0.933826979
16128,133,385,10,8,0.000490196,827941,0.933838259
11081,174,582,10,8,0.000490196,827951,0.933849538
22264,14,155,10,8,0.000490196,827961,0.933860817
14359,501,167,10,8,0.000490196,827971,0.933872096
15982,19,9,10,8,0.000490196,827981,0.933883375
15981,207,6,10,8,0.000490196,827991,0.933894654
18795,503,219,10,8,0.000490196,828001,0.933905933
16238,624,64,10,8,0.000490196,828011,0.933917212
18737,683,443,10,8,0.000490196,828021,0.933928491
15888,160,582,10,8,0.000490196,828031,0.93393977
14519,155,6,10,8,0.000490196,828041,0.933951049
16681,43,250,10,8,0.000490196,828051,0.933962328
15975,552,543,10,8,0.000490196,828061,0.933973607
16210,140,130,10,8,0.000490196,828071,0.933984886
14477,311,613,10,8,0.000490196,828081,0.933996165
15946,514,663,10,8,0.000490196,828091,0.934007444
14591,475,532,10,8,0.000490196,828101,0.934018723
14926,97,618,10,8,0.000490196,828111,0.934030002
14934,367,682,10,8,0.000490196,828121,0.934041281
14949,48,562,10,8,0.000490196,828131,0.93405256
16423,48,181,10,8,0.000490196,828141,0.934063839
15295,3,482,10,8,0.000490196,828151,0.934075118
17094,155,638,10,8,0.000490196,828161,0.934086397
15277,107,661,10,8,0.000490196,828171,0.934097677
16556,605,514,10,8,0.000490196,828181,0.934108956
14858,517,348,10,8,0.000490196,828191,0.934120235
16364,307,385,10,8,0.000490196,828201,0.934131514
18019,14,103,10,8,0.000490196,828211,0.934142793
18053,64,97,10,8,0.000490196,828221,0.934154072
16388,84,482,10,8,0.000490196,828231,0.934165351
15275,204,427,10,8,0.000490196,828241,0.93417663
15183,145,171,10,8,0.000490196,828251,0.934187909
18222,33,290,10,8,0.000490196,828261,0.934199188
11124,383,334,10,8,0.000490196,828271,0.934210467
16504,195,31,10,8,0.000490196,828281,0.934221746
17039,613,335,10,8,0.000490196,828291,0.934233025
15119,588,140,10,8,0.000490196,828301,0.934244304
15117,427,640,10,8,0.000490196,828311,0.934255583
16523,552,427,10,8,0.000490196,828321,0.934266862
16524,114,392,10,8,0.000490196,828331,0.934278141
16459,15,265,10,8,0.000490196,828341,0.93428942
15261,265,723,10,8,0.000490196,828351,0.934300699
14977,30,107,10,8,0.000490196,828361,0.934311978
18391,130,652,10,8,0.000490196,828371,0.934323257
16985,155,511,10,8,0.000490196,828381,0.934334536
11196,708,543,10,8,0.000490196,828391,0.934345815
18152,502,163,10,8,0.000490196,828401,0.934357095
18172,719,295,10,8,0.000490196,828411,0.934368374
18373,720,348,10,8,0.000490196,828421,0.934379653
15677,219,23,10,8,0.000490196,828431,0.934390932
11042,446,20,10,8,0.000490196,828441,0.934402211
15662,684,105,10,8,0.000490196,828451,0.93441349
14679,511,394,10,8,0.000490196,828461,0.934424769
14686,414,497,10,8,0.000490196,828471,0.934436048
15650,243,427,10,8,0.000490196,828481,0.934447327
15627,164,354,10,8,0.000490196,828491,0.934458606
14708,16,155,10,8,0.000490196,828501,0.934469885
11033,15,77,10,8,0.000490196,828511,0.934481164
15682,335,90,10,8,0.000490196,828521,0.934492443
14603,5,354,10,8,0.000490196,828531,0.934503722
14608,13,588,10,8,0.000490196,828541,0.934515001
17741,34,13,10,8,0.000490196,828551,0.93452628
16285,397,22,10,8,0.000490196,828561,0.934537559
17221,1,511,10,8,0.000490196,828571,0.934548838
14644,84,22,10,8,0.000490196,828581,0.934560117
18276,171,313,10,8,0.000490196,828591,0.934571396
18514,364,638,10,8,0.000490196,828601,0.934582675
17961,117,130,10,8,0.000490196,828611,0.934593954
14788,532,140,10,8,0.000490196,828621,0.934605233
14790,174,33,10,8,0.000490196,828631,0.934616513
11025,558,121,10,8,0.000490196,828641,0.934627792
14807,397,682,10,8,0.000490196,828651,0.934639071
17986,3,618,10,8,0.000490196,828661,0.93465035
17159,479,701,10,8,0.000490196,828671,0.934661629
14822,50,443,10,8,0.000490196,828681,0.934672908
14824,25,10,10,8,0.000490196,828691,0.934684187
18519,588,493,10,8,0.000490196,828701,0.934695466
18561,124,145,10,8,0.000490196,828711,0.934706745
15601,414,295,10,8,0.000490196,828721,0.934718024
16341,12,682,10,8,0.000490196,828731,0.934729303
14724,50,264,10,8,0.000490196,828741,0.934740582
15595,140,131,10,8,0.000490196,828751,0.934751861
14738,12,114,10,8,0.000490196,828761,0.93476314
15580,236,652,10,8,0.000490196,828771,0.934774419
14747,13,313,10,8,0.000490196,828781,0.934785698
11141,334,50,10,8,0.000490196,828791,0.934796977
14758,3,140,10,8,0.000490196,828801,0.934808256
15557,22,560,10,8,0.000490196,828811,0.934819535
15467,393,689,10,8,0.000490196,828821,0.934830814
13394,379,170,10,8,0.000490196,828831,0.934842093
14075,398,614,10,8,0.000490196,828841,0.934853372
13854,243,117,10,8,0.000490196,828851,0.934864651
11916,145,529,10,8,0.000490196,828861,0.934875931
14086,1,126,10,8,0.000490196,828871,0.93488721
19906,155,97,10,8,0.000490196,828881,0.934898489
11861,174,145,10,8,0.000490196,828891,0.934909768
14038,20,174,10,8,0.000490196,828901,0.934921047
14047,463,170,10,8,0.000490196,828911,0.934932326
19254,121,558,10,8,0.000490196,828921,0.934943605
13371,10,195,10,8,0.000490196,828931,0.934954884
14130,586,34,10,8,0.000490196,828941,0.934966163
14097,347,174,10,8,0.000490196,828951,0.934977442
14105,593,313,10,8,0.000490196,828961,0.934988721
13640,532,646,10,8,0.000490196,828971,0.935
11956,265,354,10,8,0.000490196,828981,0.935011279
13407,497,295,10,8,0.000490196,828991,0.935022558
13075,196,11,10,8,0.000490196,829001,0.935033837
11637,269,443,10,8,0.000490196,829011,0.935045116
9371,332,158,10,8,0.000490196,829021,0.935056395
13966,522,140,10,8,0.000490196,829031,0.935067674
13108,332,26,10,8,0.000490196,829041,0.935078953
9665,689,394,10,8,0.000490196,829051,0.935090232
13531,50,689,10,8,0.000490196,829061,0.935101511
13988,535,392,10,8,0.000490196,829071,0.93511279
13544,529,511,10,8,0.000490196,829081,0.935124069
11775,33,501,10,8,0.000490196,829091,0.935135349
12994,95,427,10,8,0.000490196,829101,0.935146628
12797,3,265,10,8,0.000490196,829111,0.935157907
13955,638,560,10,8,0.000490196,829121,0.935169186
13195,236,261,10,8,0.000490196,829131,0.935180465
13950,156,674,10,8,0.000490196,829141,0.935191744
13547,689,427,10,8,0.000490196,829151,0.935203023
11939,22,105,10,8,0.000490196,829161,0.935214302
13503,164,379,10,8,0.000490196,829171,0.935225581
13885,613,224,10,8,0.000490196,829181,0.93523686
13500,204,50,10,8,0.000490196,829191,0.935248139
13180,95,632,10,8,0.000490196,829201,0.935259418
11672,261,77,10,8,0.000490196,829211,0.935270697
14026,295,250,10,8,0.000490196,829221,0.935281976
19123,219,163,10,8,0.000490196,829231,0.935293255
9219,97,3,10,8,0.000490196,829241,0.935304534
10176,14,353,10,8,0.000490196,829251,0.935315813
11945,655,164,10,8,0.000490196,829261,0.935327092
13589,380,20,10,8,0.000490196,829271,0.935338371
11749,105,193,10,8,0.000490196,829281,0.93534965
11769,655,145,10,8,0.000490196,829291,0.935360929
12613,517,394,10,8,0.000490196,829301,0.935372208
12405,414,307,10,8,0.000490196,829311,0.935383487
13780,174,219,10,8,0.000490196,829321,0.935394767
12728,529,130,10,8,0.000490196,829331,0.935406046
12358,274,95,10,8,0.000490196,829341,0.935417325
12910,721,314,10,8,0.000490196,829351,0.935428604
21675,596,13,10,8,0.000490196,829361,0.935439883
12519,242,11,10,8,0.000490196,829371,0.935451162
13683,543,393,10,8,0.000490196,829381,0.935462441
14306,164,311,10,8,0.000490196,829391,0.93547372
10204,638,543,10,8,0.000490196,829401,0.935484999
14300,25,398,10,8,0.000490196,829411,0.935496278
13761,302,661,10,8,0.000490196,829421,0.935507557
14263,544,354,10,8,0.000490196,829431,0.935518836
12130,20,560,10,8,0.000490196,829441,0.935530115
13169,529,114,10,8,0.000490196,829451,0.935541394
13268,107,587,10,8,0.000490196,829461,0.935552673
20741,492,30,10,8,0.000490196,829471,0.935563952
14279,475,535,10,8,0.000490196,829481,0.935575231
12202,614,121,10,8,0.000490196,829491,0.93558651
12115,379,64,10,8,0.000490196,829501,0.935597789
14294,171,397,10,8,0.000490196,829511,0.935609068
13300,673,265,10,8,0.000490196,829521,0.935620347
14292,1,103,10,8,0.000490196,829531,0.935631626
12471,174,34,10,8,0.000490196,829541,0.935642905
12481,479,514,10,8,0.000490196,829551,0.935654185
19862,117,121,10,8,0.000490196,829561,0.935665464
19533,34,269,10,8,0.000490196,829571,0.935676743
12743,638,609,10,8,0.000490196,829581,0.935688022
10148,133,158,10,8,0.000490196,829591,0.935699301
10058,514,123,10,8,0.000490196,829601,0.93571058
14330,1,114,10,8,0.000490196,829611,0.935721859
13656,443,156,10,8,0.000490196,829621,0.935733138
12939,398,348,10,8,0.000490196,829631,0.935744417
12495,56,638,10,8,0.000490196,829641,0.935755696
12693,699,27,10,8,0.000490196,829651,0.935766975
8650,638,196,10,8,0.000490196,829661,0.935778254
14185,463,130,10,8,0.000490196,829671,0.935789533
13732,398,121,10,8,0.000490196,829681,0.935800812
19539,492,10,10,8,0.000490196,829691,0.935812091
19016,174,618,10,8,0.000490196,829701,0.93582337
10050,243,473,9,8,0.000441176,829710,0.935833521
15141,15,22,9,8,0.000441176,829719,0.935843672
19329,13,446,9,8,0.000441176,829728,0.935853824
15551,156,164,9,8,0.000441176,829737,0.935863975
15126,80,29,9,8,0.000441176,829746,0.935874126
16932,242,663,9,8,0.000441176,829755,0.935884277
16613,640,265,9,8,0.000441176,829764,0.935894428
13711,19,32,9,8,0.000441176,829773,0.935904579
12786,511,68,9,8,0.000441176,829782,0.93591473
15977,471,130,9,8,0.000441176,829791,0.935924882
20790,290,443,9,8,0.000441176,829800,0.935935033
16032,68,593,9,8,0.000441176,829809,0.935945184
12731,6,552,9,8,0.000441176,829818,0.935955335
14986,663,155,9,8,0.000441176,829827,0.935965486
19405,43,126,9,8,0.000441176,829836,0.935975637
12238,473,511,9,8,0.000441176,829845,0.935985788
18258,14,708,9,8,0.000441176,829854,0.93599594
16999,269,397,9,8,0.000441176,829863,0.936006091
18358,117,385,9,8,0.000441176,829872,0.936016242
15070,720,588,9,8,0.000441176,829881,0.936026393
16426,427,54,9,8,0.000441176,829890,0.936036544
15074,397,646,9,8,0.000441176,829899,0.936046695
15769,133,107,9,8,0.000441176,829908,0.936056846
10110,95,394,9,8,0.000441176,829917,0.936066998
15039,80,64,9,8,0.000441176,829926,0.936077149
20580,720,14,9,8,0.000441176,829935,0.9360873
18327,22,23,9,8,0.000441176,829944,0.936097451
10960,632,586,9,8,0.000441176,829953,0.936107602
18301,646,230,9,8,0.000441176,829962,0.936117753
15014,250,409,9,8,0.000441176,829971,0.936127904
18277,334,414,9,8,0.000441176,829980,0.936138055
11070,514,354,9,8,0.000441176,829989,0.936148207
13603,475,130,9,8,0.000441176,829998,0.936158358
21904,11,618,9,8,0.000441176,830007,0.936168509
18294,511,497,9,8,0.000441176,830016,0.93617866
15104,155,313,9,8,0.000441176,830025,0.936188811
15002,265,50,9,8,0.000441176,830034,0.936198962
17491,5,498,9,8,0.000441176,830043,0.936209113
13687,264,514,9,8,0.000441176,830052,0.936219265
8756,640,394,9,8,0.000441176,830061,0.936229416
10414,475,64,9,8,0.000441176,830070,0.936239567
15539,140,265,9,8,0.000441176,830079,0.936249718
17469,618,243,9,8,0.000441176,830088,0.936259869
13686,624,105,9,8,0.000441176,830097,0.93627002
13613,721,131,9,8,0.000441176,830106,0.936280171
15361,196,439,9,8,0.000441176,830115,0.936290323
18078,492,354,9,8,0.000441176,830124,0.936300474
13341,674,439,9,8,0.000441176,830133,0.936310625
18068,30,155,9,8,0.000441176,830142,0.936320776
15356,261,655,9,8,0.000441176,830151,0.936330927
11712,334,26,9,8,0.000441176,830160,0.936341078
15309,383,114,9,8,0.000441176,830169,0.936351229
20006,528,1,9,8,0.000441176,830178,0.936361381
15369,367,1,9,8,0.000441176,830187,0.936371532
18055,385,364,9,8,0.000441176,830196,0.936381683
15482,596,517,9,8,0.000441176,830205,0.936391834
13346,507,11,9,8,0.000441176,830214,0.936401985
15342,624,20,9,8,0.000441176,830223,0.936412136
13366,33,274,9,8,0.000441176,830232,0.936422287
15329,15,624,9,8,0.000441176,830241,0.936432439
17600,124,314,9,8,0.000441176,830250,0.93644259
15334,31,655,9,8,0.000441176,830259,0.936452741
15335,117,250,9,8,0.000441176,830268,0.936462892
20825,195,331,9,8,0.000441176,830277,0.936473043
11707,80,543,9,8,0.000441176,830286,0.936483194
17641,517,398,9,8,0.000441176,830295,0.936493345
17644,140,10,9,8,0.000441176,830304,0.936503497
10595,48,264,9,8,0.000441176,830313,0.936513648
17649,131,328,9,8,0.000441176,830322,0.936523799
13227,708,48,9,8,0.000441176,830331,0.93653395
13229,511,586,9,8,0.000441176,830340,0.936544101
16543,196,586,9,8,0.000441176,830349,0.936554252
19579,701,32,9,8,0.000441176,830358,0.936564403
17662,50,674,9,8,0.000441176,830367,0.936574554
13251,394,164,9,8,0.000441176,830376,0.936584706
20671,114,5,9,8,0.000441176,830385,0.936594857
15424,12,638,9,8,0.000441176,830394,0.936605008
20359,175,723,9,8,0.000441176,830403,0.936615159
18033,544,404,9,8,0.000441176,830412,0.93662531
13305,13,230,9,8,0.000441176,830421,0.936635461
12295,133,586,9,8,0.000441176,830430,0.936645612
16455,19,68,9,8,0.000441176,830439,0.936655764
15402,196,13,9,8,0.000441176,830448,0.936665915
13284,302,294,9,8,0.000441176,830457,0.936676066
12920,97,1,9,8,0.000441176,830466,0.936686217
8827,383,123,9,8,0.000441176,830475,0.936696368
20348,609,689,9,8,0.000441176,830484,0.936706519
15188,50,196,9,8,0.000441176,830493,0.93671667
13528,552,562,9,8,0.000441176,830502,0.936726822
21787,236,207,9,8,0.000441176,830511,0.936736973
17940,230,701,9,8,0.000441176,830520,0.936747124
9515,655,522,9,8,0.000441176,830529,0.936757275
15177,313,593,9,8,0.000441176,830538,0.936767426
15176,30,655,9,8,0.000441176,830547,0.936777577
19815,609,204,9,8,0.000441176,830556,0.936787728
13555,80,683,9,8,0.000441176,830565,0.93679788
20538,367,5,9,8,0.000441176,830574,0.936808031
19611,522,23,9,8,0.000441176,830583,0.936818182
19426,145,54,9,8,0.000441176,830592,0.936828333
20103,492,219,9,8,0.000441176,830601,0.936838484
17705,392,596,9,8,0.000441176,830610,0.936848635
15932,328,683,9,8,0.000441176,830619,0.936858786
10087,307,236,9,8,0.000441176,830628,0.936868938
16957,582,494,9,8,0.000441176,830637,0.936879089
12954,699,105,9,8,0.000441176,830646,0.93688924
17070,552,155,9,8,0.000441176,830655,0.936899391
17579,68,163,9,8,0.000441176,830664,0.936909542
13207,393,497,9,8,0.000441176,830673,0.936919693
8972,264,77,9,8,0.000441176,830682,0.936929844
18113,236,155,9,8,0.000441176,830691,0.936939995
11849,32,265,9,8,0.000441176,830700,0.936950147
18103,463,507,9,8,0.000441176,830709,0.936960298
16966,332,68,9,8,0.000441176,830718,0.936970449
12831,393,723,9,8,0.000441176,830727,0.9369806
9491,158,543,9,8,0.000441176,830736,0.936990751
15244,511,31,9,8,0.000441176,830745,0.937000902
19453,517,5,9,8,0.000441176,830754,0.937011053
17700,204,501,9,8,0.000441176,830763,0.937021205
12848,596,511,9,8,0.000441176,830772,0.937031356
18134,517,562,9,8,0.000441176,830781,0.937041507
21216,178,638,9,8,0.000441176,830790,0.937051658
15263,196,562,9,8,0.000441176,830799,0.937061809
15264,50,498,9,8,0.000441176,830808,0.93707196
16079,668,311,9,8,0.000441176,830817,0.937082111
17021,507,596,9,8,0.000441176,830826,0.937092263
14117,280,560,9,8,0.000441176,830835,0.937102414
10184,26,4,9,8,0.000441176,830844,0.937112565
17267,494,354,9,8,0.000441176,830853,0.937122716
16245,12,364,9,8,0.000441176,830862,0.937132867
14103,133,302,9,8,0.000441176,830871,0.937143018
16240,16,163,9,8,0.000441176,830880,0.937153169
7926,48,117,9,8,0.000441176,830889,0.937163321
12345,638,170,9,8,0.000441176,830898,0.937173472
10901,26,6,9,8,0.000441176,830907,0.937183623
15659,632,121,9,8,0.000441176,830916,0.937193774
18717,471,701,9,8,0.000441176,830925,0.937203925
14121,532,632,9,8,0.000441176,830934,0.937214076
13071,379,632,9,8,0.000441176,830943,0.937224227
15714,178,473,9,8,0.000441176,830952,0.937234379
18706,609,164,9,8,0.000441176,830961,0.93724453
14126,14,1,9,8,0.000441176,830970,0.937254681
12564,624,30,9,8,0.000441176,830979,0.937264832
12457,543,443,9,8,0.000441176,830988,0.937274983
12102,517,638,9,8,0.000441176,830997,0.937285134
14034,721,393,9,8,0.000441176,831006,0.937295285
10299,307,196,9,8,0.000441176,831015,0.937305436
14650,141,77,9,8,0.000441176,831024,0.937315588
15628,507,473,9,8,0.000441176,831033,0.937325739
16868,164,242,9,8,0.000441176,831042,0.93733589
14632,517,532,9,8,0.000441176,831051,0.937346041
19112,596,126,9,8,0.000441176,831060,0.937356192
16229,219,552,9,8,0.000441176,831069,0.937366343
11418,313,683,9,8,0.000441176,831078,0.937376494
14074,274,250,9,8,0.000441176,831087,0.937386646
19090,204,404,9,8,0.000441176,831096,0.937396797
11225,529,588,9,8,0.000441176,831105,0.937406948
14605,16,171,9,8,0.000441176,831114,0.937417099
14063,414,265,9,8,0.000441176,831123,0.93742725
9720,307,543,9,8,0.000441176,831132,0.937437401
17820,532,571,9,8,0.000441176,831141,0.937447552
18638,155,302,9,8,0.000441176,831150,0.937457704
16499,130,482,9,8,0.000441176,831159,0.937467855
17026,588,12,9,8,0.000441176,831168,0.937478006
14173,414,274,9,8,0.000441176,831177,0.937488157
12499,196,393,9,8,0.000441176,831186,0.937498308
12503,242,334,9,8,0.000441176,831195,0.937508459
17192,181,582,9,8,0.000441176,831204,0.93751861
14402,543,114,9,8,0.000441176,831213,0.937528762
10198,562,588,9,8,0.000441176,831222,0.937538913
16321,14,50,9,8,0.000441176,831231,0.937549064
14242,586,145,9,8,0.000441176,831240,0.937559215
16318,31,195,9,8,0.000441176,831249,0.937569366
12042,522,56,9,8,0.000441176,831258,0.937579517
17177,48,605,9,8,0.000441176,831267,0.937589668
14373,525,331,9,8,0.000441176,831276,0.93759982
18902,409,473,9,8,0.000441176,831285,0.937609971
18892,311,701,9,8,0.000441176,831294,0.937620122
14319,439,6,9,8,0.000441176,831303,0.937630273
16779,684,68,9,8,0.000441176,831312,0.937640424
10880,302,20,9,8,0.000441176,831321,0.937650575
17169,207,48,9,8,0.000441176,831330,0.937660726
14356,655,269,9,8,0.000441176,831339,0.937670878
12474,230,246,9,8,0.000441176,831348,0.937681029
14311,674,117,9,8,0.000441176,831357,0.93769118
18867,593,427,9,8,0.000441176,831366,0.937701331
18865,511,34,9,8,0.000441176,831375,0.937711482
11995,558,117,9,8,0.000441176,831384,0.937721633
14463,529,328,9,8,0.000441176,831393,0.937731784
11215,158,77,9,8,0.000441176,831402,0.937741935
16812,114,689,9,8,0.000441176,831411,0.937752087
12109,638,26,9,8,0.000441176,831420,0.937762238
18759,68,332,9,8,0.000441176,831429,0.937772389
14197,398,514,9,8,0.000441176,831438,0.93778254
17218,614,155,9,8,0.000441176,831447,0.937792691
17027,463,56,9,8,0.000441176,831456,0.937802842
16827,117,3,9,8,0.000441176,831465,0.937812993
19013,443,2,9,8,0.000441176,831474,0.937823145
19926,64,155,9,8,0.000441176,831483,0.937833296
9813,9,514,9,8,0.000441176,831492,0.937843447
11982,193,34,9,8,0.000441176,831501,0.937853598
17804,5,723,9,8,0.000441176,831510,0.937863749
17154,14,48,9,8,0.000441176,831519,0.9378739
12517,307,532,9,8,0.000441176,831528,0.937884051
11213,242,354,9,8,0.000441176,831537,0.937894203
11214,618,471,9,8,0.000441176,831546,0.937904354
9344,511,80,9,8,0.000441176,831555,0.937914505
17217,30,701,9,8,0.000441176,831564,0.937924656
14216,439,107,9,8,0.000441176,831573,0.937934807
19233,141,397,9,8,0.000441176,831582,0.937944958
8473,379,4,9,8,0.000441176,831591,0.937955109
14837,29,145,9,8,0.000441176,831600,0.937965261
12708,367,714,9,8,0.000441176,831609,0.937975412
15751,140,385,9,8,0.000441176,831618,0.937985563
16670,171,97,9,8,0.000441176,831627,0.937995714
10755,14,280,9,8,0.000441176,831636,0.938005865
15752,30,294,9,8,0.000441176,831645,0.938016016
16650,385,514,9,8,0.000441176,831654,0.938026167
13850,95,117,9,8,0.000441176,831663,0.938036319
11765,618,131,9,8,0.000441176,831672,0.93804647
12672,414,501,9,8,0.000441176,831681,0.938056621
16897,84,560,9,8,0.000441176,831690,0.938066772
16512,614,507,9,8,0.000441176,831699,0.938076923
17445,562,632,9,8,0.000441176,831708,0.938087074
20508,19,347,9,8,0.000441176,831717,0.938097225
8636,655,674,9,8,0.000441176,831726,0.938107376
18503,684,380,9,8,0.000441176,831735,0.938117528
16123,107,163,9,8,0.000441176,831744,0.938127679
12713,156,15,9,8,0.000441176,831753,0.93813783
12188,20,354,9,8,0.000441176,831762,0.938147981
18490,511,243,9,8,0.000441176,831771,0.938158132
11566,302,511,9,8,0.000441176,831780,0.938168283
13872,138,380,9,8,0.000441176,831789,0.938178434
20128,463,682,9,8,0.000441176,831798,0.938188586
18493,529,204,9,8,0.000441176,831807,0.938198737
17012,167,558,9,8,0.000441176,831816,0.938208888
14828,497,250,9,8,0.000441176,831825,0.938219039
13148,164,393,9,8,0.000441176,831834,0.93822919
16098,114,479,9,8,0.000441176,831843,0.938239341
14896,174,64,9,8,0.000441176,831852,0.938249492
15756,274,414,9,8,0.000441176,831861,0.938259644
14932,158,163,9,8,0.000441176,831870,0.938269795
20457,29,10,9,8,0.000441176,831879,0.938279946
14913,307,501,9,8,0.000441176,831888,0.938290097
20325,560,307,9,8,0.000441176,831897,0.938300248
16652,43,5,9,8,0.000441176,831906,0.938310399
12055,682,10,9,8,0.000441176,831915,0.93832055
12429,20,511,9,8,0.000441176,831924,0.938330702
17408,334,31,9,8,0.000441176,831933,0.938340853
17722,13,394,9,8,0.000441176,831942,0.938351004
14935,133,558,9,8,0.000441176,831951,0.938361155
16662,30,103,9,8,0.000441176,831960,0.938371306
9202,25,22,9,8,0.000441176,831969,0.938381457
13818,392,397,9,8,0.000441176,831978,0.938391608
16085,427,295,9,8,0.000441176,831987,0.93840176
12197,593,68,9,8,0.000441176,831996,0.938411911
12422,525,230,9,8,0.000441176,832005,0.938422062
10561,497,354,9,8,0.000441176,832014,0.938432213
13808,529,471,9,8,0.000441176,832023,0.938442364
19225,9,124,9,8,0.000441176,832032,0.938452515
17368,354,652,9,8,0.000441176,832041,0.938462666
16396,618,479,9,8,0.000441176,832050,0.938472818
18566,511,250,9,8,0.000441176,832059,0.938482969
12636,242,596,9,8,0.000441176,832068,0.93849312
13733,404,471,9,8,0.000441176,832077,0.938503271
19149,124,632,9,8,0.000441176,832086,0.938513422
12638,414,264,9,8,0.000441176,832095,0.938523573
12005,655,473,9,8,0.000441176,832104,0.938533724
13948,26,196,9,8,0.000441176,832113,0.938543875
16685,54,471,9,8,0.000441176,832122,0.938554027
12995,404,280,9,8,0.000441176,832131,0.938564178
17350,353,160,9,8,0.000441176,832140,0.938574329
17451,682,11,9,8,0.000441176,832149,0.93858448
12211,313,12,9,8,0.000441176,832158,0.938594631
17339,689,242,9,8,0.000441176,832167,0.938604782
14975,632,596,9,8,0.000441176,832176,0.938614933
15731,463,508,9,8,0.000441176,832185,0.938625085
17831,164,250,9,8,0.000441176,832194,0.938635236
17328,475,398,9,8,0.000441176,832203,0.938645387
14684,586,12,9,8,0.000441176,832212,0.938655538
19971,493,14,9,8,0.000441176,832221,0.938665689
16875,475,404,9,8,0.000441176,832230,0.93867584
17333,443,171,9,8,0.000441176,832239,0.938685991
20748,471,167,9,8,0.000441176,832248,0.938696143
20904,155,236,9,8,0.000441176,832257,0.938706294
16180,364,11,9,8,0.000441176,832266,0.938716445
20636,167,655,9,8,0.000441176,832275,0.938726596
7835,605,123,9,8,0.000441176,832284,0.938736747
13730,332,131,9,8,0.000441176,832293,0.938746898
18567,131,383,9,8,0.000441176,832302,0.938757049
16416,123,383,9,8,0.000441176,832311,0.938767201
17454,117,593,9,8,0.000441176,832320,0.938777352
12180,394,130,9,8,0.000441176,832329,0.938787503
13127,264,397,9,8,0.000441176,832338,0.938797654
13907,655,121,9,8,0.000441176,832347,0.938807805
19205,160,274,9,8,0.000441176,832356,0.938817956
13896,503,443,9,8,0.000441176,832365,0.938828107
12654,492,9,9,8,0.000441176,832374,0.938838259
16132,668,243,9,8,0.000441176,832383,0.93884841
11085,463,84,9,8,0.000441176,832392,0.938858561
17357,404,3,9,8,0.000441176,832401,0.938868712
14766,97,475,9,8,0.000441176,832410,0.938878863
16506,141,582,9,8,0.000441176,832419,0.938889014
16157,242,145,9,8,0.000441176,832428,0.938899165
19310,131,673,9,8,0.000441176,832437,0.938909316
14958,156,586,9,8,0.000441176,832446,0.938919468
12646,307,663,9,8,0.000441176,832455,0.938929619
13927,334,145,9,8,0.000441176,832464,0.93893977
9386,392,80,8,8,0.000392157,832472,0.938948793
12976,29,105,8,8,0.000392157,832480,0.938957816
17708,511,544,8,8,0.000392157,832488,0.93896684
17707,163,265,8,8,0.000392157,832496,0.938975863
23279,494,250,8,8,0.000392157,832504,0.938984886
12955,525,16,8,8,0.000392157,832512,0.938993909
23923,427,409,8,8,0.000392157,832520,0.939002933
17766,11,508,8,8,0.000392157,832528,0.939011956
17752,250,126,8,8,0.000392157,832536,0.939020979
12963,609,32,8,8,0.000392157,832544,0.939030002
12943,261,56,8,8,0.000392157,832552,0.939039025
17049,582,90,8,8,0.000392157,832560,0.939048049
12981,133,335,8,8,0.000392157,832568,0.939057072
12936,613,314,8,8,0.000392157,832576,0.939066095
12378,140,655,8,8,0.000392157,832584,0.939075118
12965,280,30,8,8,0.000392157,832592,0.939084142
17895,682,347,8,8,0.000392157,832600,0.939093165
16158,156,614,8,8,0.000392157,832608,0.939102188
16162,140,532,8,8,0.000392157,832616,0.939111211
17340,394,689,8,8,0.000392157,832624,0.939120235
16182,404,307,8,8,0.000392157,832632,0.939129258
17330,14,126,8,8,0.000392157,832640,0.939138281
16193,414,689,8,8,0.000392157,832648,0.939147304
9894,682,498,8,8,0.000392157,832656,0.939156328
16211,311,448,8,8,0.000392157,832664,0.939165351
21248,364,655,8,8,0.000392157,832672,0.939174374
19876,196,43,8,8,0.000392157,832680,0.939183397
17388,708,497,8,8,0.000392157,832688,0.93919242
9641,265,609,8,8,0.000392157,832696,0.939201444
16111,114,427,8,8,0.000392157,832704,0.939210467
17375,528,614,8,8,0.000392157,832712,0.93921949
17371,708,307,8,8,0.000392157,832720,0.939228513
21236,207,15,8,8,0.000392157,832728,0.939237537
16150,492,224,8,8,0.000392157,832736,0.93924656
12456,3,164,8,8,0.000392157,832744,0.939255583
15820,43,34,8,8,0.000392157,832752,0.939264606
17214,307,126,8,8,0.000392157,832760,0.93927363
12520,475,543,8,8,0.000392157,832768,0.939282653
16311,64,380,8,8,0.000392157,832776,0.939291676
17196,640,414,8,8,0.000392157,832784,0.939300699
17191,64,310,8,8,0.000392157,832792,0.939309723
17187,497,404,8,8,0.000392157,832800,0.939318746
16346,3,714,8,8,0.000392157,832808,0.939327769
16227,43,498,8,8,0.000392157,832816,0.939336792
16246,347,544,8,8,0.000392157,832824,0.939345815
19908,126,31,8,8,0.000392157,832832,0.939354839
16369,493,596,8,8,0.000392157,832840,0.939363862
12458,269,655,8,8,0.000392157,832848,0.939372885
12553,274,3,8,8,0.000392157,832856,0.939381908
21283,43,562,8,8,0.000392157,832864,0.939390932
16277,404,264,8,8,0.000392157,832872,0.939399955
21335,50,156,8,8,0.000392157,832880,0.939408978
17404,295,155,8,8,0.000392157,832888,0.939418001
19803,532,54,8,8,0.000392157,832896,0.939427025
15890,22,394,8,8,0.000392157,832904,0.939436048
16446,243,439,8,8,0.000392157,832912,0.939445071
17587,13,517,8,8,0.000392157,832920,0.939454094
12866,347,158,8,8,0.000392157,832928,0.939463118
17569,117,532,8,8,0.000392157,832936,0.939472141
12843,492,394,8,8,0.000392157,832944,0.939481164
12841,552,84,8,8,0.000392157,832952,0.939490187
20962,13,427,8,8,0.000392157,832960,0.93949921
12826,193,64,8,8,0.000392157,832968,0.939508234
12886,475,126,8,8,0.000392157,832976,0.939517257
17124,448,708,8,8,0.000392157,832984,0.93952628
17059,33,13,8,8,0.000392157,832992,0.939535303
20241,114,682,8,8,0.000392157,833000,0.939544327
23399,54,404,8,8,0.000392157,833008,0.93955335
19800,156,682,8,8,0.000392157,833016,0.939562373
19801,673,482,8,8,0.000392157,833024,0.939571396
17538,586,605,8,8,0.000392157,833032,0.93958042
17111,68,673,8,8,0.000392157,833040,0.939589443
17453,14,84,8,8,0.000392157,833048,0.939598466
12712,529,156,8,8,0.000392157,833056,0.939607489
19843,155,618,8,8,0.000392157,833064,0.939616513
21359,674,269,8,8,0.000392157,833072,0.939625536
19853,535,508,8,8,0.000392157,833080,0.939634559
21352,313,668,8,8,0.000392157,833088,0.939643582
17118,171,1,8,8,0.000392157,833096,0.939652605
21337,502,503,8,8,0.000392157,833104,0.939661629
12821,16,4,8,8,0.000392157,833112,0.939670652
11862,158,334,8,8,0.000392157,833120,0.939679675
17078,331,13,8,8,0.000392157,833128,0.939688698
11068,458,314,8,8,0.000392157,833136,0.939697722
16432,160,655,8,8,0.000392157,833144,0.939706745
11879,535,30,8,8,0.000392157,833152,0.939715768
20956,493,328,8,8,0.000392157,833160,0.939724791
11888,12,497,8,8,0.000392157,833168,0.939733815
17472,334,354,8,8,0.000392157,833176,0.939742838
21225,54,10,8,8,0.000392157,833184,0.939751861
11109,250,158,8,8,0.000392157,833192,0.939760884
13864,310,587,8,8,0.000392157,833200,0.939769908
14803,95,5,8,8,0.000392157,833208,0.939778931
18480,236,195,8,8,0.000392157,833216,0.939787954
19226,397,23,8,8,0.000392157,833224,0.939796977
16901,632,517,8,8,0.000392157,833232,0.939806
13823,502,269,8,8,0.000392157,833240,0.939815024
19249,126,2,8,8,0.000392157,833248,0.939824047
14801,562,723,8,8,0.000392157,833256,0.93983307
18533,392,250,8,8,0.000392157,833264,0.939842093
18536,525,498,8,8,0.000392157,833272,0.939851117
14734,103,16,8,8,0.000392157,833280,0.93986014
13952,219,117,8,8,0.000392157,833288,0.939869163
13954,243,95,8,8,0.000392157,833296,0.939878186
13935,443,593,8,8,0.000392157,833304,0.93988721
18510,502,204,8,8,0.000392157,833312,0.939896233
10936,493,335,8,8,0.000392157,833320,0.939905256
18511,274,503,8,8,0.000392157,833328,0.939914279
16676,174,26,8,8,0.000392157,833336,0.939923303
14782,593,32,8,8,0.000392157,833344,0.939932326
10768,261,311,8,8,0.000392157,833352,0.939941349
18523,204,264,8,8,0.000392157,833360,0.939950372
13815,511,130,8,8,0.000392157,833368,0.939959395
19262,34,502,8,8,0.000392157,833376,0.939968419
13675,543,50,8,8,0.000392157,833384,0.939977442
21910,446,558,8,8,0.000392157,833392,0.939986465
18400,97,141,8,8,0.000392157,833400,0.939995488
19348,347,117,8,8,0.000392157,833408,0.940004512
13670,655,20,8,8,0.000392157,833416,0.940013535
19363,684,302,8,8,0.000392157,833424,0.940022558
16616,34,193,8,8,0.000392157,833432,0.940031581
16929,614,517,8,8,0.000392157,833440,0.940040605
18344,22,14,8,8,0.000392157,833448,0.940049628
16926,11,543,8,8,0.000392157,833456,0.940058651
13735,48,29,8,8,0.000392157,833464,0.940067674
14922,398,85,8,8,0.000392157,833472,0.940076697
14907,26,640,8,8,0.000392157,833480,0.940085721
19268,26,133,8,8,0.000392157,833488,0.940094744
13803,593,514,8,8,0.000392157,833496,0.940103767
14888,164,33,8,8,0.000392157,833504,0.94011279
20450,463,22,8,8,0.000392157,833512,0.940121814
16653,497,3,8,8,0.000392157,833520,0.940130837
13772,393,15,8,8,0.000392157,833528,0.94013986
10150,29,80,8,8,0.000392157,833536,0.940148883
14946,640,170,8,8,0.000392157,833544,0.940157907
13764,507,443,8,8,0.000392157,833552,0.94016693
18427,689,562,8,8,0.000392157,833560,0.940175953
8398,246,105,8,8,0.000392157,833568,0.940184976
14481,586,475,8,8,0.000392157,833576,0.940194
14190,242,265,8,8,0.000392157,833584,0.940203023
14193,84,723,8,8,0.000392157,833592,0.940212046
10186,123,85,8,8,0.000392157,833600,0.940221069
12107,511,335,8,8,0.000392157,833608,0.940230092
14206,242,10,8,8,0.000392157,833616,0.940239116
11485,404,158,8,8,0.000392157,833624,0.940248139
18990,719,708,8,8,0.000392157,833632,0.940257162
14451,107,503,8,8,0.000392157,833640,0.940266185
20504,124,123,8,8,0.000392157,833648,0.940275209
14223,492,11,8,8,0.000392157,833656,0.940284232
18753,160,230,8,8,0.000392157,833664,0.940293255
18714,511,25,8,8,0.000392157,833672,0.940302278
19037,414,640,8,8,0.000392157,833680,0.940311302
12106,280,126,8,8,0.000392157,833688,0.940320325
14157,219,20,8,8,0.000392157,833696,0.940329348
18563,427,723,8,8,0.000392157,833704,0.940338371
22226,479,13,8,8,0.000392157,833712,0.940347395
14375,535,640,8,8,0.000392157,833720,0.940356418
14299,14,640,8,8,0.000392157,833728,0.940365441
18876,354,12,8,8,0.000392157,833736,0.940374464
14355,507,280,8,8,0.000392157,833744,0.940383487
14314,15,511,8,8,0.000392157,833752,0.940392511
18894,543,56,8,8,0.000392157,833760,0.940401534
12133,307,14,8,8,0.000392157,833768,0.940410557
18954,310,163,8,8,0.000392157,833776,0.94041958
20727,204,569,8,8,0.000392157,833784,0.940428604
18838,596,140,8,8,0.000392157,833792,0.940437627
16750,29,354,8,8,0.000392157,833800,0.94044665
16755,448,15,8,8,0.000392157,833808,0.940455673
14257,379,12,8,8,0.000392157,833816,0.940464697
19062,558,605,8,8,0.000392157,833824,0.94047372
14013,511,280,8,8,0.000392157,833832,0.940482743
16701,501,544,8,8,0.000392157,833840,0.940491766
14655,385,32,8,8,0.000392157,833848,0.94050079
22071,354,23,8,8,0.000392157,833856,0.940509813
14640,103,380,8,8,0.000392157,833864,0.940518836
19119,25,31,8,8,0.000392157,833872,0.940527859
14046,334,236,8,8,0.000392157,833880,0.940536882
10815,95,243,8,8,0.000392157,833888,0.940545906
14710,156,507,8,8,0.000392157,833896,0.940554929
14702,511,26,8,8,0.000392157,833904,0.940563952
18572,348,155,8,8,0.000392157,833912,0.940572975
20723,64,219,8,8,0.000392157,833920,0.940581999
13994,605,404,8,8,0.000392157,833928,0.940591022
13995,593,614,8,8,0.000392157,833936,0.940600045
14001,295,265,8,8,0.000392157,833944,0.940609068
19110,195,475,8,8,0.000392157,833952,0.940618092
14094,502,295,8,8,0.000392157,833960,0.940627115
14569,171,379,8,8,0.000392157,833968,0.940636138
22447,503,498,8,8,0.000392157,833976,0.940645161
14116,393,463,8,8,0.000392157,833984,0.940654185
14088,392,310,8,8,0.000392157,833992,0.940663208
14052,280,4,8,8,0.000392157,834000,0.940672231
16844,243,552,8,8,0.000392157,834008,0.940681254
14594,4,364,8,8,0.000392157,834016,0.940690277
22485,117,517,8,8,0.000392157,834024,0.940699301
19078,16,269,8,8,0.000392157,834032,0.940708324
21863,171,48,8,8,0.000392157,834040,0.940717347
13621,393,204,8,8,0.000392157,834048,0.94072637
20062,155,175,8,8,0.000392157,834056,0.940735394
17953,13,618,8,8,0.000392157,834064,0.940744417
19593,5,126,8,8,0.000392157,834072,0.94075344
15486,13,663,8,8,0.000392157,834080,0.940762463
15490,5,3,8,8,0.000392157,834088,0.940771487
13261,353,552,8,8,0.000392157,834096,0.94078051
16554,274,117,8,8,0.000392157,834104,0.940789533
20071,439,517,8,8,0.000392157,834112,0.940798556
12289,409,335,8,8,0.000392157,834120,0.94080758
21157,511,242,8,8,0.000392157,834128,0.940816603
13276,261,532,8,8,0.000392157,834136,0.940825626
18014,562,427,8,8,0.000392157,834144,0.940834649
15422,392,311,8,8,0.000392157,834152,0.940843672
23077,404,517,8,8,0.000392157,834160,0.940852696
9114,6,682,8,8,0.000392157,834168,0.940861719
9109,4,498,8,8,0.000392157,834176,0.940870742
21860,64,265,8,8,0.000392157,834184,0.940879765
18027,9,446,8,8,0.000392157,834192,0.940888789
11746,663,683,8,8,0.000392157,834200,0.940897812
13095,632,170,8,8,0.000392157,834208,0.940906835
17830,609,439,8,8,0.000392157,834216,0.940915858
15625,302,652,8,8,0.000392157,834224,0.940924882
17837,140,97,8,8,0.000392157,834232,0.940933905
13087,14,588,8,8,0.000392157,834240,0.940942928
15688,12,427,8,8,0.000392157,834248,0.940951951
21188,328,482,8,8,0.000392157,834256,0.940960975
15668,463,529,8,8,0.000392157,834264,0.940969998
17846,11,126,8,8,0.000392157,834272,0.940979021
19603,364,68,8,8,0.000392157,834280,0.940988044
20052,124,80,8,8,0.000392157,834288,0.940997067
18903,140,11,8,8,0.000392157,834296,0.941006091
17005,511,347,8,8,0.000392157,834304,0.941015114
15544,507,15,8,8,0.000392157,834312,0.941024137
16994,310,593,8,8,0.000392157,834320,0.94103316
13182,84,246,8,8,0.000392157,834328,0.941042184
19607,156,328,8,8,0.000392157,834336,0.941051207
12058,379,54,8,8,0.000392157,834344,0.94106023
17938,668,347,8,8,0.000392157,834352,0.941069253
13134,640,501,8,8,0.000392157,834360,0.941078277
17849,638,54,8,8,0.000392157,834368,0.9410873
13138,682,334,8,8,0.000392157,834376,0.941096323
15569,97,532,8,8,0.000392157,834384,0.941105346
21612,613,596,8,8,0.000392157,834392,0.94111437
20389,689,171,8,8,0.000392157,834400,0.941123393
18182,525,586,8,8,0.000392157,834408,0.941132416
18217,663,646,8,8,0.000392157,834416,0.941141439
18213,307,140,8,8,0.000392157,834424,0.941150462
15181,614,117,8,8,0.000392157,834432,0.941159486
15225,295,385,8,8,0.000392157,834440,0.941168509
18162,2,562,8,8,0.000392157,834448,0.941177532
15232,274,6,8,8,0.000392157,834456,0.941186555
15236,586,204,8,8,0.000392157,834464,0.941195579
7253,383,77,8,8,0.000392157,834472,0.941204602
15248,605,502,8,8,0.000392157,834480,0.941213625
13537,14,334,8,8,0.000392157,834488,0.941222648
19458,155,174,8,8,0.000392157,834496,0.941231672
19402,668,97,8,8,0.000392157,834504,0.941240695
18270,364,498,8,8,0.000392157,834512,0.941249718
15130,655,640,8,8,0.000392157,834520,0.941258741
18233,439,398,8,8,0.000392157,834528,0.941267764
10983,133,379,8,8,0.000392157,834536,0.941276788
15147,30,26,8,8,0.000392157,834544,0.941285811
13560,265,558,8,8,0.000392157,834552,0.941294834
15155,673,204,8,8,0.000392157,834560,0.941303857
13549,313,613,8,8,0.000392157,834568,0.941312881
15162,31,280,8,8,0.000392157,834576,0.941321904
11658,393,646,8,8,0.000392157,834584,0.941330927
15288,290,314,8,8,0.000392157,834592,0.94133995
21143,124,689,8,8,0.000392157,834600,0.941348974
15299,525,397,8,8,0.000392157,834608,0.941357997
13389,43,204,8,8,0.000392157,834616,0.94136702
12284,33,25,8,8,0.000392157,834624,0.941376043
15324,609,544,8,8,0.000392157,834632,0.941385067
16564,507,347,8,8,0.000392157,834640,0.94139409
15345,204,156,8,8,0.000392157,834648,0.941403113
18069,385,274,8,8,0.000392157,834656,0.941412136
15270,2,543,8,8,0.000392157,834664,0.941421159
16963,10,90,8,8,0.000392157,834672,0.941430183
17047,236,624,17,7,0.000833333,834689,0.941449357
15132,701,2,17,7,0.000833333,834706,0.941468531
8850,543,311,14,7,0.000686275,834720,0.941484322
11222,3,392,13,7,0.000637255,834733,0.941498985
18552,27,371,12,7,0.000588235,834745,0.94151252
13951,145,29,12,7,0.000588235,834757,0.941526055
14746,543,64,12,7,0.000588235,834769,0.941539589
13049,721,367,12,7,0.000588235,834781,0.941553124
12076,463,394,12,7,0.000588235,834793,0.941566659
17137,618,236,12,7,0.000588235,834805,0.941580194
16552,68,514,12,7,0.000588235,834817,0.941593729
13187,131,414,12,7,0.000588235,834829,0.941607264
15460,354,22,12,7,0.000588235,834841,0.941620799
13240,514,522,12,7,0.000588235,834853,0.941634333
13578,133,242,12,7,0.000588235,834865,0.941647868
16055,683,367,12,7,0.000588235,834877,0.941661403
6608,721,265,12,7,0.000588235,834889,0.941674938
11189,307,394,12,7,0.000588235,834901,0.941688473
14164,33,207,12,7,0.000588235,834913,0.941702008
17275,328,708,12,7,0.000588235,834925,0.941715543
13701,543,614,11,7,0.000539216,834936,0.941727949
16501,164,23,11,7,0.000539216,834947,0.941740356
16545,68,448,11,7,0.000539216,834958,0.941752763
13666,367,164,11,7,0.000539216,834969,0.94176517
14959,497,463,11,7,0.000539216,834980,0.941777577
14184,479,20,11,7,0.000539216,834991,0.941789984
16907,126,68,11,7,0.000539216,835002,0.941802391
10208,31,3,11,7,0.000539216,835013,0.941814798
13873,105,448,11,7,0.000539216,835024,0.941827205
14906,721,398,11,7,0.000539216,835035,0.941839612
16563,507,497,11,7,0.000539216,835046,0.941852019
13963,471,404,11,7,0.000539216,835057,0.941864426
11404,720,27,11,7,0.000539216,835068,0.941876833
13987,204,250,11,7,0.000539216,835079,0.94188924
15491,97,11,11,7,0.000539216,835090,0.941901647
15478,171,274,11,7,0.000539216,835101,0.941914054
16218,673,632,11,7,0.000539216,835112,0.941926461
11723,582,383,11,7,0.000539216,835123,0.941938868
15360,367,2,11,7,0.000539216,835134,0.941951275
11255,158,3,11,7,0.000539216,835145,0.941963681
15409,475,446,11,7,0.000539216,835156,0.941976088
9852,307,114,11,7,0.000539216,835167,0.941988495
15900,544,398,11,7,0.000539216,835178,0.942000902
15554,193,158,11,7,0.000539216,835189,0.942013309
13585,507,663,11,7,0.000539216,835200,0.942025716
12661,29,33,11,7,0.000539216,835211,0.942038123
13561,43,397,11,7,0.000539216,835222,0.94205053
16408,124,14,11,7,0.000539216,835233,0.942062937
16261,155,156,11,7,0.000539216,835244,0.942075344
17338,720,204,11,7,0.000539216,835255,0.942087751
16174,517,427,11,7,0.000539216,835266,0.942100158
16896,353,1,10,7,0.000490196,835276,0.942111437
16906,64,50,10,7,0.000490196,835286,0.942122716
17631,170,219,10,7,0.000490196,835296,0.942133995
16787,613,353,10,7,0.000490196,835306,0.942145274
14403,482,314,10,7,0.000490196,835316,0.942156553
16141,383,347,10,7,0.000490196,835326,0.942167832
16782,313,174,10,7,0.000490196,835336,0.942179111
15916,463,167,10,7,0.000490196,835346,0.94219039
17282,528,475,10,7,0.000490196,835356,0.942201669
14508,43,596,10,7,0.000490196,835366,0.942212948
14510,439,33,10,7,0.000490196,835376,0.942224227
15873,522,103,10,7,0.000490196,835386,0.942235506
17552,310,290,10,7,0.000490196,835396,0.942246785
16826,398,145,10,7,0.000490196,835406,0.942258065
17300,543,560,10,7,0.000490196,835416,0.942269344
14475,517,250,10,7,0.000490196,835426,0.942280623
20560,130,290,10,7,0.000490196,835436,0.942291902
18754,117,354,10,7,0.000490196,835446,0.942303181
14915,33,4,10,7,0.000490196,835456,0.94231446
17126,155,471,10,7,0.000490196,835466,0.942325739
14969,640,107,10,7,0.000490196,835476,0.942337018
14951,158,114,10,7,0.000490196,835486,0.942348297
15285,367,544,10,7,0.000490196,835496,0.942359576
20592,117,714,10,7,0.000490196,835506,0.942370855
18039,380,155,10,7,0.000490196,835516,0.942382134
11375,307,586,10,7,0.000490196,835526,0.942393413
10911,689,463,10,7,0.000490196,835536,0.942404692
15136,721,609,10,7,0.000490196,835546,0.942415971
15116,663,618,10,7,0.000490196,835556,0.94242725
15022,274,167,10,7,0.000490196,835566,0.942438529
14988,443,54,10,7,0.000490196,835576,0.942449808
15238,156,171,10,7,0.000490196,835586,0.942461087
20638,64,663,10,7,0.000490196,835596,0.942472366
15010,274,385,10,7,0.000490196,835606,0.942483645
14835,528,131,10,7,0.000490196,835616,0.942494924
11039,624,31,10,7,0.000490196,835626,0.942506203
16614,140,280,10,7,0.000490196,835636,0.942517483
16624,1,517,10,7,0.000490196,835646,0.942528762
15736,593,596,10,7,0.000490196,835656,0.942540041
6796,29,314,10,7,0.000490196,835666,0.94255132
14619,614,50,10,7,0.000490196,835676,0.942562599
14718,30,609,10,7,0.000490196,835686,0.942573878
15607,20,207,10,7,0.000490196,835696,0.942585157
17161,114,196,10,7,0.000490196,835706,0.942596436
14826,30,529,10,7,0.000490196,835716,0.942607715
14751,130,571,10,7,0.000490196,835726,0.942618994
18532,64,145,10,7,0.000490196,835736,0.942630273
16956,204,560,10,7,0.000490196,835746,0.942641552
13433,133,11,10,7,0.000490196,835756,0.942652831
13460,507,586,10,7,0.000490196,835766,0.94266411
13013,43,196,10,7,0.000490196,835776,0.942675389
13871,15,544,10,7,0.000490196,835786,0.942686668
12602,596,22,10,7,0.000490196,835796,0.942697947
13376,193,13,10,7,0.000490196,835806,0.942709226
12946,394,145,10,7,0.000490196,835816,0.942720505
13385,43,353,10,7,0.000490196,835826,0.942731784
14147,56,145,10,7,0.000490196,835836,0.942743063
9471,689,522,10,7,0.000490196,835846,0.942754342
19141,689,56,10,7,0.000490196,835856,0.942765621
10373,605,11,10,7,0.000490196,835866,0.942776901
13570,243,170,10,7,0.000490196,835876,0.94278818
12788,294,68,10,7,0.000490196,835886,0.942799459
19132,347,164,10,7,0.000490196,835896,0.942810738
12988,302,514,10,7,0.000490196,835906,0.942822017
14156,246,335,10,7,0.000490196,835916,0.942833296
20042,163,23,10,7,0.000490196,835926,0.942844575
13310,141,224,10,7,0.000490196,835936,0.942855854
19283,13,202,10,7,0.000490196,835946,0.942867133
14236,543,479,10,7,0.000490196,835956,0.942878412
13758,224,140,10,7,0.000490196,835966,0.942889691
11474,618,224,10,7,0.000490196,835976,0.94290097
19289,158,2,10,7,0.000490196,835986,0.942912249
13663,543,30,10,7,0.000490196,835996,0.942923528
11496,14,313,10,7,0.000490196,836006,0.942934807
13801,12,295,10,7,0.000490196,836016,0.942946086
12741,334,596,10,7,0.000490196,836026,0.942957365
14320,163,586,10,7,0.000490196,836036,0.942968644
14183,6,117,10,7,0.000490196,836046,0.942979923
14208,471,34,10,7,0.000490196,836056,0.942991202
20732,609,503,10,7,0.000490196,836066,0.943002481
17509,34,439,9,7,0.000441176,836075,0.943012633
19409,552,587,9,7,0.000441176,836084,0.943022784
15983,156,508,9,7,0.000441176,836093,0.943032935
21113,54,15,9,7,0.000441176,836102,0.943043086
16036,719,131,9,7,0.000441176,836111,0.943053237
10722,103,20,9,7,0.000441176,836120,0.943063388
15121,511,204,9,7,0.000441176,836129,0.943073539
18393,269,10,9,7,0.000441176,836138,0.943083691
12964,414,663,9,7,0.000441176,836147,0.943093842
10690,32,140,9,7,0.000441176,836156,0.943103993
17505,242,50,9,7,0.000441176,836165,0.943114144
12780,640,243,9,7,0.000441176,836174,0.943124295
16014,655,708,9,7,0.000441176,836183,0.943134446
12056,103,310,9,7,0.000441176,836192,0.943144597
13676,34,50,9,7,0.000441176,836201,0.943154748
17086,543,398,9,7,0.000441176,836210,0.9431649
13682,334,586,9,7,0.000441176,836219,0.943175051
13644,207,335,9,7,0.000441176,836228,0.943185202
20360,117,392,9,7,0.000441176,836237,0.943195353
18348,174,5,9,7,0.000441176,836246,0.943205504
15037,471,141,9,7,0.000441176,836255,0.943215655
15053,265,502,9,7,0.000441176,836264,0.943225806
17099,479,392,9,7,0.000441176,836273,0.943235958
15549,164,170,9,7,0.000441176,836282,0.943246109
16027,640,294,9,7,0.000441176,836291,0.94325626
15005,16,613,9,7,0.000441176,836300,0.943266411
15986,274,23,9,7,0.000441176,836309,0.943276562
15020,171,25,9,7,0.000441176,836318,0.943286713
15080,682,588,9,7,0.000441176,836327,0.943296864
16000,682,663,9,7,0.000441176,836336,0.943307016
16924,471,532,9,7,0.000441176,836345,0.943317167
17781,427,532,9,7,0.000441176,836354,0.943327318
11709,511,663,9,7,0.000441176,836363,0.943337469
9034,640,236,9,7,0.000441176,836372,0.94334762
15869,517,443,9,7,0.000441176,836381,0.943357771
15359,367,482,9,7,0.000441176,836390,0.943367922
15373,482,224,9,7,0.000441176,836399,0.943378074
12399,31,689,9,7,0.000441176,836408,0.943388225
15378,13,471,9,7,0.000441176,836417,0.943398376
20390,124,230,9,7,0.000441176,836426,0.943408527
15886,280,613,9,7,0.000441176,836435,0.943418678
12877,14,174,9,7,0.000441176,836444,0.943428829
15326,242,250,9,7,0.000441176,836453,0.94343898
15327,77,492,9,7,0.000441176,836462,0.943449132
16566,15,560,9,7,0.000441176,836471,0.943459283
19527,511,708,9,7,0.000441176,836480,0.943469434
12882,511,473,9,7,0.000441176,836489,0.943479585
15481,689,29,9,7,0.000441176,836498,0.943489736
11720,708,1,9,7,0.000441176,836507,0.943499887
13271,414,95,9,7,0.000441176,836516,0.943510038
11020,14,3,9,7,0.000441176,836525,0.943520189
18009,12,269,9,7,0.000441176,836534,0.943530341
15444,103,331,9,7,0.000441176,836543,0.943540492
18005,155,230,9,7,0.000441176,836552,0.943550643
15819,15,427,9,7,0.000441176,836561,0.943560794
15817,708,155,9,7,0.000441176,836570,0.943570945
11829,2,393,9,7,0.000441176,836579,0.943581096
15849,383,4,9,7,0.000441176,836588,0.943591247
15844,498,544,9,7,0.000441176,836597,0.943601399
19561,117,328,9,7,0.000441176,836606,0.94361155
18026,522,90,9,7,0.000441176,836615,0.943621701
19567,535,269,9,7,0.000441176,836624,0.943631852
16989,517,30,9,7,0.000441176,836633,0.943642003
17535,22,31,9,7,0.000441176,836642,0.943652154
18201,230,569,9,7,0.000441176,836651,0.943662305
10090,97,638,9,7,0.000441176,836660,0.943672457
15889,97,29,9,7,0.000441176,836669,0.943682608
13512,313,383,9,7,0.000441176,836678,0.943692759
15520,398,479,9,7,0.000441176,836687,0.94370291
8879,529,473,9,7,0.000441176,836696,0.943713061
15215,14,394,9,7,0.000441176,836705,0.943723212
12212,638,280,9,7,0.000441176,836714,0.943733363
17945,525,393,9,7,0.000441176,836723,0.943743515
16940,164,383,9,7,0.000441176,836732,0.943753666
17518,130,646,9,7,0.000441176,836741,0.943763817
18228,13,393,9,7,0.000441176,836750,0.943773968
15152,13,126,9,7,0.000441176,836759,0.943784119
18226,261,328,9,7,0.000441176,836768,0.94379427
11751,398,307,9,7,0.000441176,836777,0.943804421
15960,12,4,9,7,0.000441176,836786,0.943814573
17932,335,175,9,7,0.000441176,836795,0.943824724
15897,446,31,9,7,0.000441176,836804,0.943834875
15293,290,68,9,7,0.000441176,836813,0.943845026
15302,683,353,9,7,0.000441176,836822,0.943855177
15498,689,26,9,7,0.000441176,836831,0.943865328
15931,443,475,9,7,0.000441176,836840,0.943875479
12265,471,114,9,7,0.000441176,836849,0.94388563
21777,64,529,9,7,0.000441176,836858,0.943895782
12956,427,334,9,7,0.000441176,836867,0.943905933
12844,514,501,9,7,0.000441176,836876,0.943916084
18146,596,613,9,7,0.000441176,836885,0.943926235
15245,261,48,9,7,0.000441176,836894,0.943936386
15786,156,596,9,7,0.000441176,836903,0.943946537
17559,3,181,9,7,0.000441176,836912,0.943956688
18144,605,163,9,7,0.000441176,836921,0.94396684
13453,123,714,9,7,0.000441176,836930,0.943976991
18693,4,503,9,7,0.000441176,836939,0.943987142
17268,16,409,9,7,0.000441176,836948,0.943997293
15647,525,10,9,7,0.000441176,836957,0.944007444
14101,30,130,9,7,0.000441176,836966,0.944017595
15645,6,507,9,7,0.000441176,836975,0.944027746
12575,398,95,9,7,0.000441176,836984,0.944037898
18672,80,448,9,7,0.000441176,836993,0.944048049
18671,155,443,9,7,0.000441176,837002,0.9440582
14087,471,11,9,7,0.000441176,837011,0.944068351
13077,655,535,9,7,0.000441176,837020,0.944078502
19034,307,167,9,7,0.000441176,837029,0.944088653
14533,471,632,9,7,0.000441176,837038,0.944098804
10821,250,56,9,7,0.000441176,837047,0.944108956
12560,497,33,9,7,0.000441176,837056,0.944119107
16871,164,614,9,7,0.000441176,837065,0.944129258
20034,121,280,9,7,0.000441176,837074,0.944139409
17303,164,156,9,7,0.000441176,837083,0.94414956
10918,9,171,9,7,0.000441176,837092,0.944159711
16199,1,280,9,7,0.000441176,837101,0.944169862
14667,673,385,9,7,0.000441176,837110,0.944180014
12612,397,261,9,7,0.000441176,837119,0.944190165
14011,20,367,9,7,0.000441176,837128,0.944200316
14082,479,85,9,7,0.000441176,837137,0.944210467
17281,475,501,9,7,0.000441176,837146,0.944220618
11048,501,145,9,7,0.000441176,837155,0.944230769
20299,207,14,9,7,0.000441176,837164,0.94424092
14061,383,280,9,7,0.000441176,837173,0.944251072
14499,80,673,9,7,0.000441176,837182,0.944261223
13033,624,16,9,7,0.000441176,837191,0.944271374
18952,558,652,9,7,0.000441176,837200,0.944281525
14395,50,535,9,7,0.000441176,837209,0.944291676
12505,522,64,9,7,0.000441176,837218,0.944301827
14415,507,295,9,7,0.000441176,837227,0.944311978
17167,140,68,9,7,0.000441176,837236,0.944322129
14329,84,64,9,7,0.000441176,837245,0.944332281
18915,528,348,9,7,0.000441176,837254,0.944342432
8026,493,80,9,7,0.000441176,837263,0.944352583
10313,26,20,9,7,0.000441176,837272,0.944362734
14315,274,502,9,7,0.000441176,837281,0.944372885
17172,632,130,9,7,0.000441176,837290,0.944383036
14308,95,56,9,7,0.000441176,837299,0.944393187
16340,397,562,9,7,0.000441176,837308,0.944403339
14421,117,655,9,7,0.000441176,837317,0.94441349
13025,614,511,9,7,0.000441176,837326,0.944423641
17227,84,508,9,7,0.000441176,837335,0.944433792
19003,175,708,9,7,0.000441176,837344,0.944443943
16278,158,640,9,7,0.000441176,837353,0.944454094
14462,280,632,9,7,0.000441176,837362,0.944464245
14440,207,558,9,7,0.000441176,837371,0.944474397
14232,6,274,9,7,0.000441176,837380,0.944484548
14231,385,663,9,7,0.000441176,837389,0.944494699
20486,448,689,9,7,0.000441176,837398,0.94450485
19701,117,141,9,7,0.000441176,837407,0.944515001
15707,117,31,9,7,0.000441176,837416,0.944525152
19967,202,2,9,7,0.000441176,837425,0.944535303
10756,307,535,9,7,0.000441176,837434,0.944545455
16110,195,131,9,7,0.000441176,837443,0.944555606
17129,558,174,9,7,0.000441176,837452,0.944565757
14937,80,493,9,7,0.000441176,837461,0.944575908
15562,13,3,9,7,0.000441176,837470,0.944586059
14804,593,463,9,7,0.000441176,837479,0.94459621
17448,174,498,9,7,0.000441176,837488,0.944606361
12696,439,32,9,7,0.000441176,837497,0.944616513
12417,532,364,9,7,0.000441176,837506,0.944626664
16659,414,64,9,7,0.000441176,837515,0.944636815
15566,393,14,9,7,0.000441176,837524,0.944646966
16080,274,475,9,7,0.000441176,837533,0.944657117
18436,158,587,9,7,0.000441176,837542,0.944667268
17881,328,560,9,7,0.000441176,837551,0.944677419
13833,443,20,9,7,0.000441176,837560,0.94468757
13804,497,164,9,7,0.000441176,837569,0.944697722
18454,586,170,9,7,0.000441176,837578,0.944707873
16518,439,56,9,7,0.000441176,837587,0.944718024
14741,328,517,9,7,0.000441176,837596,0.944728175
17734,178,347,9,7,0.000441176,837605,0.944738326
13959,689,114,9,7,0.000441176,837614,0.944748477
16168,379,85,9,7,0.000441176,837623,0.944758628
18556,502,605,9,7,0.000441176,837632,0.94476878
14730,640,398,9,7,0.000441176,837641,0.944778931
10502,383,26,9,7,0.000441176,837650,0.944789082
15621,140,522,9,7,0.000441176,837659,0.944799233
16876,54,230,9,7,0.000441176,837668,0.944809384
19176,502,130,9,7,0.000441176,837677,0.944819535
12415,84,170,9,7,0.000441176,837686,0.944829686
19182,507,689,9,7,0.000441176,837695,0.944839838
15602,383,586,9,7,0.000441176,837704,0.944849989
12991,4,85,9,7,0.000441176,837713,0.94486014
12650,264,443,9,7,0.000441176,837722,0.944870291
16131,224,12,9,7,0.000441176,837731,0.944880442
12645,131,404,9,7,0.000441176,837740,0.944890593
16159,14,632,9,7,0.000441176,837749,0.944900744
20302,364,95,9,7,0.000441176,837758,0.944910896
19167,5,393,9,7,0.000441176,837767,0.944921047
14760,640,614,9,7,0.000441176,837776,0.944931198
16151,674,328,9,7,0.000441176,837785,0.944941349
11555,280,683,9,7,0.000441176,837794,0.9449515
15699,544,170,8,7,0.000392157,837802,0.944960523
15762,207,348,8,7,0.000392157,837810,0.944969547
17777,646,84,8,7,0.000392157,837818,0.94497857
17669,242,22,8,7,0.000392157,837826,0.944987593
15718,174,230,8,7,0.000392157,837834,0.944996616
12962,498,543,8,7,0.000392157,837842,0.94500564
21195,364,514,8,7,0.000392157,837850,0.945014663
15785,475,171,8,7,0.000392157,837858,0.945023686
11808,501,295,8,7,0.000392157,837866,0.945032709
15780,582,163,8,7,0.000392157,837874,0.945041732
17681,20,124,8,7,0.000392157,837882,0.945050756
17731,43,497,8,7,0.000392157,837890,0.945059779
20030,48,43,8,7,0.000392157,837898,0.945068802
17670,655,517,8,7,0.000392157,837906,0.945077825
17718,14,107,8,7,0.000392157,837914,0.945086849
17727,392,243,8,7,0.000392157,837922,0.945095872
20016,155,64,8,7,0.000392157,837930,0.945104895
17679,380,171,8,7,0.000392157,837938,0.945113918
20028,50,385,8,7,0.000392157,837946,0.945122942
17771,219,54,8,7,0.000392157,837954,0.945131965
21435,439,246,8,7,0.000392157,837962,0.945140988
21458,261,54,8,7,0.000392157,837970,0.945150011
15815,204,502,8,7,0.000392157,837978,0.945159035
21316,121,674,8,7,0.000392157,837986,0.945168058
17341,22,11,8,7,0.000392157,837994,0.945177081
16387,543,689,8,7,0.000392157,838002,0.945186104
12444,15,64,8,7,0.000392157,838010,0.945195127
17327,385,535,8,7,0.000392157,838018,0.945204151
12609,280,682,8,7,0.000392157,838026,0.945213174
16381,404,663,8,7,0.000392157,838034,0.945222197
19902,43,652,8,7,0.000392157,838042,0.94523122
17349,507,242,8,7,0.000392157,838050,0.945240244
16156,544,26,8,7,0.000392157,838058,0.945249267
17383,22,393,8,7,0.000392157,838066,0.94525829
12656,105,446,8,7,0.000392157,838074,0.945267313
16125,632,552,8,7,0.000392157,838082,0.945276337
17367,720,310,8,7,0.000392157,838090,0.94528536
16134,614,723,8,7,0.000392157,838098,0.945294383
10379,133,123,8,7,0.000392157,838106,0.945303406
11926,507,331,8,7,0.000392157,838114,0.94531243
17353,522,624,8,7,0.000392157,838122,0.945321453
16374,409,250,8,7,0.000392157,838130,0.945330476
21278,126,302,8,7,0.000392157,838138,0.945339499
16299,34,427,8,7,0.000392157,838146,0.945348522
17210,163,558,8,7,0.000392157,838154,0.945357546
12513,609,274,8,7,0.000392157,838162,0.945366569
17203,207,331,8,7,0.000392157,838170,0.945375592
19931,328,12,8,7,0.000392157,838178,0.945384615
17199,511,14,8,7,0.000392157,838186,0.945393639
12507,3,22,8,7,0.000392157,838194,0.945402662
16326,95,439,8,7,0.000392157,838202,0.945411685
16358,471,56,8,7,0.000392157,838210,0.945420708
11106,353,30,8,7,0.000392157,838218,0.945429732
16351,404,50,8,7,0.000392157,838226,0.945438755
16290,131,171,8,7,0.000392157,838234,0.945447778
11104,605,655,8,7,0.000392157,838242,0.945456801
20293,528,15,8,7,0.000392157,838250,0.945465824
12598,30,121,8,7,0.000392157,838258,0.945474848
16228,123,103,8,7,0.000392157,838266,0.945483871
9764,586,497,8,7,0.000392157,838274,0.945492894
17273,517,535,8,7,0.000392157,838282,0.945501917
17146,103,471,8,7,0.000392157,838290,0.945510941
16370,552,586,8,7,0.000392157,838298,0.945519964
17257,528,264,8,7,0.000392157,838306,0.945528987
17255,517,544,8,7,0.000392157,838314,0.94553801
19913,117,114,8,7,0.000392157,838322,0.945547034
16269,517,385,8,7,0.000392157,838330,0.945556057
16282,6,502,8,7,0.000392157,838338,0.94556508
20950,471,383,8,7,0.000392157,838346,0.945574103
17605,562,64,8,7,0.000392157,838354,0.945583127
19805,517,587,8,7,0.000392157,838362,0.94559215
17573,117,95,8,7,0.000392157,838370,0.945601173
12859,32,605,8,7,0.000392157,838378,0.945610196
17568,404,514,8,7,0.000392157,838386,0.945619219
15914,1,508,8,7,0.000392157,838394,0.945628243
15921,264,586,8,7,0.000392157,838402,0.945637266
17558,682,163,8,7,0.000392157,838410,0.945646289
15934,114,439,8,7,0.000392157,838418,0.945655312
17547,145,398,8,7,0.000392157,838426,0.945664336
15823,482,380,8,7,0.000392157,838434,0.945673359
20014,114,674,8,7,0.000392157,838442,0.945682382
12387,443,511,8,7,0.000392157,838450,0.945691405
15832,1,394,8,7,0.000392157,838458,0.945700429
17640,11,20,8,7,0.000392157,838466,0.945709452
12917,354,511,8,7,0.000392157,838474,0.945718475
17633,448,310,8,7,0.000392157,838482,0.945727498
12913,674,708,8,7,0.000392157,838490,0.945736522
15847,618,674,8,7,0.000392157,838498,0.945745545
17629,632,501,8,7,0.000392157,838506,0.945754568
19796,29,219,8,7,0.000392157,838514,0.945763591
20639,64,10,8,7,0.000392157,838522,0.945772614
16449,311,446,8,7,0.000392157,838530,0.945781638
15866,311,207,8,7,0.000392157,838538,0.945790661
15871,43,663,8,7,0.000392157,838546,0.945799684
9947,14,80,8,7,0.000392157,838554,0.945808707
16436,364,302,8,7,0.000392157,838562,0.945817731
17530,528,463,8,7,0.000392157,838570,0.945826754
17461,155,543,8,7,0.000392157,838578,0.945835777
11899,663,404,8,7,0.000392157,838586,0.9458448
16048,605,25,8,7,0.000392157,838594,0.945853824
16414,632,397,8,7,0.000392157,838602,0.945862847
16058,140,313,8,7,0.000392157,838610,0.94587187
17442,269,16,8,7,0.000392157,838618,0.945880893
17441,397,640,8,7,0.000392157,838626,0.945889917
16075,618,84,8,7,0.000392157,838634,0.94589894
12687,310,514,8,7,0.000392157,838642,0.945907963
12420,10,508,8,7,0.000392157,838650,0.945916986
17122,224,652,8,7,0.000392157,838658,0.945926009
17412,463,50,8,7,0.000392157,838666,0.945935033
11107,294,20,8,7,0.000392157,838674,0.945944056
9946,525,27,8,7,0.000392157,838682,0.945953079
12806,397,196,8,7,0.000392157,838690,0.945962102
15963,224,193,8,7,0.000392157,838698,0.945971126
17081,708,84,8,7,0.000392157,838706,0.945980149
17496,133,596,8,7,0.000392157,838714,0.945989172
17494,145,385,8,7,0.000392157,838722,0.945998195
12768,2,11,8,7,0.000392157,838730,0.946007219
20344,13,280,8,7,0.000392157,838738,0.946016242
17095,158,5,8,7,0.000392157,838746,0.946025265
16009,582,569,8,7,0.000392157,838754,0.946034288
19830,13,121,8,7,0.000392157,838762,0.946043312
23527,85,80,8,7,0.000392157,838770,0.946052335
18081,708,2,8,7,0.000392157,838778,0.946061358
17036,544,11,8,7,0.000392157,838786,0.946070381
18481,618,508,8,7,0.000392157,838794,0.946079404
22660,492,498,8,7,0.000392157,838802,0.946088428
14843,50,158,8,7,0.000392157,838810,0.946097451
14839,614,587,8,7,0.000392157,838818,0.946106474
13865,56,14,8,7,0.000392157,838826,0.946115497
19237,124,30,8,7,0.000392157,838834,0.946124521
18492,364,107,8,7,0.000392157,838842,0.946133544
14817,385,3,8,7,0.000392157,838850,0.946142567
12187,313,701,8,7,0.000392157,838858,0.94615159
14802,15,126,8,7,0.000392157,838866,0.946160614
14852,164,586,8,7,0.000392157,838874,0.946169637
19258,114,54,8,7,0.000392157,838882,0.94617866
14876,95,511,8,7,0.000392157,838890,0.946187683
20763,294,5,8,7,0.000392157,838898,0.946196707
12092,313,195,8,7,0.000392157,838906,0.94620573
14862,398,646,8,7,0.000392157,838914,0.946214753
18463,22,674,8,7,0.000392157,838922,0.946223776
20754,560,5,8,7,0.000392157,838930,0.946232799
18466,507,708,8,7,0.000392157,838938,0.946241823
11381,605,334,8,7,0.000392157,838946,0.946250846
16683,43,586,8,7,0.000392157,838954,0.946259869
13945,544,334,8,7,0.000392157,838962,0.946268892
13953,618,463,8,7,0.000392157,838970,0.946277916
14791,195,473,8,7,0.000392157,838978,0.946286939
18522,246,250,8,7,0.000392157,838986,0.946295962
18526,163,242,8,7,0.000392157,838994,0.946304985
13918,193,123,8,7,0.000392157,839002,0.946314009
14764,614,682,8,7,0.000392157,839010,0.946323032
13685,164,11,8,7,0.000392157,839018,0.946332055
16923,207,131,8,7,0.000392157,839026,0.946341078
15000,517,498,8,7,0.000392157,839034,0.946350102
22724,243,673,8,7,0.000392157,839042,0.946359125
14994,493,367,8,7,0.000392157,839050,0.946368148
13715,507,22,8,7,0.000392157,839058,0.946377171
22711,720,517,8,7,0.000392157,839066,0.946386194
16625,517,145,8,7,0.000392157,839074,0.946395218
19376,473,492,8,7,0.000392157,839082,0.946404241
18296,224,290,8,7,0.000392157,839090,0.946413264
16618,427,50,8,7,0.000392157,839098,0.946422287
15064,230,171,8,7,0.000392157,839106,0.946431311
13642,140,250,8,7,0.000392157,839114,0.946440334
19359,15,140,8,7,0.000392157,839122,0.946449357
14973,593,398,8,7,0.000392157,839130,0.94645838
16913,582,43,8,7,0.000392157,839138,0.946467404
19275,328,5,8,7,0.000392157,839146,0.946476427
16904,364,219,8,7,0.000392157,839154,0.94648545
21947,492,497,8,7,0.000392157,839162,0.946494473
13739,618,313,8,7,0.000392157,839170,0.946503497
19307,131,23,8,7,0.000392157,839178,0.94651252
21109,673,23,8,7,0.000392157,839186,0.946521543
13753,33,552,8,7,0.000392157,839194,0.946530566
14947,655,34,8,7,0.000392157,839202,0.946539589
18431,167,310,8,7,0.000392157,839210,0.946548613
14943,246,311,8,7,0.000392157,839218,0.946557636
11595,379,560,8,7,0.000392157,839226,0.946566659
20432,640,175,8,7,0.000392157,839234,0.946575682
14472,668,219,8,7,0.000392157,839242,0.946584706
14458,22,335,8,7,0.000392157,839250,0.946593729
14218,123,652,8,7,0.000392157,839258,0.946602752
16732,379,508,8,7,0.000392157,839266,0.946611775
14492,383,397,8,7,0.000392157,839274,0.946620799
14136,609,348,8,7,0.000392157,839282,0.946629822
12105,33,385,8,7,0.000392157,839290,0.946638845
19035,15,56,8,7,0.000392157,839298,0.946647868
10899,586,3,8,7,0.000392157,839306,0.946656891
11435,33,264,8,7,0.000392157,839314,0.946665915
18745,171,265,8,7,0.000392157,839322,0.946674938
22405,124,498,8,7,0.000392157,839330,0.946683961
11437,174,158,8,7,0.000392157,839338,0.946692984
18798,528,121,8,7,0.000392157,839346,0.946702008
20159,13,535,8,7,0.000392157,839354,0.946711031
14388,439,347,8,7,0.000392157,839362,0.946720054
18851,543,414,8,7,0.000392157,839370,0.946729077
14288,624,618,8,7,0.000392157,839378,0.946738101
16783,501,364,8,7,0.000392157,839386,0.946747124
18880,171,501,8,7,0.000392157,839394,0.946756147
22232,64,632,8,7,0.000392157,839402,0.94676517
16768,54,393,8,7,0.000392157,839410,0.946774194
18947,354,593,8,7,0.000392157,839418,0.946783217
18800,514,332,8,7,0.000392157,839426,0.94679224
18825,562,439,8,7,0.000392157,839434,0.946801263
14427,1,393,8,7,0.000392157,839442,0.946810286
14425,586,646,8,7,0.000392157,839450,0.94681931
14417,632,50,8,7,0.000392157,839458,0.946828333
16751,393,517,8,7,0.000392157,839466,0.946837356
18977,114,517,8,7,0.000392157,839474,0.946846379
14412,397,552,8,7,0.000392157,839482,0.946855403
14246,1,121,8,7,0.000392157,839490,0.946864426
20730,43,714,8,7,0.000392157,839498,0.946873449
14676,26,171,8,7,0.000392157,839506,0.946882472
18595,280,383,8,7,0.000392157,839514,0.946891496
18615,347,171,8,7,0.000392157,839522,0.946900519
18618,29,723,8,7,0.000392157,839530,0.946909542
14642,640,511,8,7,0.000392157,839538,0.946918565
22506,31,103,8,7,0.000392157,839546,0.946927589
18629,471,294,8,7,0.000392157,839554,0.946936612
18590,332,471,8,7,0.000392157,839562,0.946945635
11548,164,10,8,7,0.000392157,839570,0.946954658
16878,207,334,8,7,0.000392157,839578,0.946963681
13993,397,714,8,7,0.000392157,839586,0.946972705
14005,397,528,8,7,0.000392157,839594,0.946981728
18631,290,638,8,7,0.000392157,839602,0.946990751
14624,586,562,8,7,0.000392157,839610,0.946999774
11515,385,655,8,7,0.000392157,839618,0.947008798
14110,511,543,8,7,0.000392157,839626,0.947017821
16716,529,348,8,7,0.000392157,839634,0.947026844
16717,414,605,8,7,0.000392157,839642,0.947035867
14556,196,26,8,7,0.000392157,839650,0.947044891
16839,562,587,8,7,0.000392157,839658,0.947053914
16721,155,170,8,7,0.000392157,839666,0.947062937
14548,12,479,8,7,0.000392157,839674,0.94707196
21063,50,126,8,7,0.000392157,839682,0.947080984
19087,117,663,8,7,0.000392157,839690,0.947090007
11526,414,25,8,7,0.000392157,839698,0.94709903
22486,427,5,8,7,0.000392157,839706,0.947108053
19081,663,493,8,7,0.000392157,839714,0.947117076
18654,131,503,8,7,0.000392157,839722,0.9471261
14083,48,164,8,7,0.000392157,839730,0.947135123
15017,95,54,8,7,0.000392157,839738,0.947144146
18011,717,68,8,7,0.000392157,839746,0.947153169
17975,528,364,8,7,0.000392157,839754,0.947162193
17977,14,130,8,7,0.000392157,839762,0.947171216
13222,280,689,8,7,0.000392157,839770,0.947180239
16541,133,348,8,7,0.000392157,839778,0.947189262
16981,130,174,8,7,0.000392157,839786,0.947198286
15449,558,181,8,7,0.000392157,839794,0.947207309
13258,558,398,8,7,0.000392157,839802,0.947216332
15485,511,334,8,7,0.000392157,839810,0.947225355
15501,103,196,8,7,0.000392157,839818,0.947234379
15512,609,605,8,7,0.000392157,839826,0.947243402
17955,22,15,8,7,0.000392157,839834,0.947252425
17956,2,130,8,7,0.000392157,839842,0.947261448
13210,32,682,8,7,0.000392157,839850,0.947270471
15497,15,1,8,7,0.000392157,839858,0.947279495
15495,475,609,8,7,0.000392157,839866,0.947288518
18012,1,544,8,7,0.000392157,839874,0.947297541
12294,307,443,8,7,0.000392157,839882,0.947306564
15392,332,9,8,7,0.000392157,839890,0.947315588
18036,13,498,8,7,0.000392157,839898,0.947324611
15386,16,482,8,7,0.000392157,839906,0.947333634
13321,364,80,8,7,0.000392157,839914,0.947342657
15377,171,307,8,7,0.000392157,839922,0.947351681
18054,674,605,8,7,0.000392157,839930,0.947360704
13331,16,207,8,7,0.000392157,839938,0.947369727
13332,562,479,8,7,0.000392157,839946,0.94737875
16977,394,196,8,7,0.000392157,839954,0.947387774
23063,64,5,8,7,0.000392157,839962,0.947396797
15428,498,593,8,7,0.000392157,839970,0.94740582
9124,655,156,8,7,0.000392157,839978,0.947414843
15401,397,163,8,7,0.000392157,839986,0.947423866
17947,84,23,8,7,0.000392157,839994,0.94743289
11012,307,48,8,7,0.000392157,840002,0.947441913
15610,219,126,8,7,0.000392157,840010,0.947450936
17821,663,85,8,7,0.000392157,840018,0.947459959
20040,492,131,8,7,0.000392157,840026,0.947468983
19667,124,219,8,7,0.000392157,840034,0.947478006
13109,479,25,8,7,0.000392157,840042,0.947487029
17835,43,1,8,7,0.000392157,840050,0.947496052
17016,68,646,8,7,0.000392157,840058,0.947505076
19707,20,114,8,7,0.000392157,840066,0.947514099
16486,347,394,8,7,0.000392157,840074,0.947523122
13039,661,105,8,7,0.000392157,840082,0.947532145
17797,34,507,8,7,0.000392157,840090,0.947541169
19686,126,5,8,7,0.000392157,840098,0.947550192
16491,193,97,8,7,0.000392157,840106,0.947559215
15661,535,632,8,7,0.000392157,840114,0.947568238
16495,54,310,8,7,0.000392157,840122,0.947577261
16496,307,404,8,7,0.000392157,840130,0.947586285
19658,674,13,8,7,0.000392157,840138,0.947595308
15555,9,103,8,7,0.000392157,840146,0.947604331
13173,141,27,8,7,0.000392157,840154,0.947613354
17901,682,130,8,7,0.000392157,840162,0.947622378
16995,492,311,8,7,0.000392157,840170,0.947631401
17923,107,155,8,7,0.000392157,840178,0.947640424
15533,33,103,8,7,0.000392157,840186,0.947649447
13171,10,246,8,7,0.000392157,840194,0.947658471
13144,586,471,8,7,0.000392157,840202,0.947667494
15596,313,155,8,7,0.000392157,840210,0.947676517
19650,243,508,8,7,0.000392157,840218,0.94768554
17852,22,20,8,7,0.000392157,840226,0.947694564
16514,12,562,8,7,0.000392157,840234,0.947703587
16521,427,56,8,7,0.000392157,840242,0.94771261
16559,618,311,8,7,0.000392157,840250,0.947721633
18168,493,398,8,7,0.000392157,840258,0.947730656
16950,503,26,8,7,0.000392157,840266,0.94773968
13514,163,498,8,7,0.000392157,840274,0.947748703
19441,158,714,8,7,0.000392157,840282,0.947757726
10990,632,77,8,7,0.000392157,840290,0.947766749
12072,156,331,8,7,0.000392157,840298,0.947775773
13469,313,392,8,7,0.000392157,840306,0.947784796
15250,138,16,8,7,0.000392157,840314,0.947793819
13458,164,236,8,7,0.000392157,840322,0.947802842
13456,609,528,8,7,0.000392157,840330,0.947811866
13581,3,544,8,7,0.000392157,840338,0.947820889
15122,15,596,8,7,0.000392157,840346,0.947829912
18268,397,560,8,7,0.000392157,840354,0.947838935
19404,528,517,8,7,0.000392157,840362,0.947847958
15108,16,12,8,7,0.000392157,840370,0.947856982
21844,174,517,8,7,0.000392157,840378,0.947866005
18274,164,274,8,7,0.000392157,840386,0.947875028
21855,124,397,8,7,0.000392157,840394,0.947884051
15095,586,683,8,7,0.000392157,840402,0.947893075
19416,463,514,8,7,0.000392157,840410,0.947902098
16936,130,587,8,7,0.000392157,840418,0.947911121
15260,497,501,8,7,0.000392157,840426,0.947920144
16951,614,632,8,7,0.000392157,840434,0.947929168
12261,12,32,8,7,0.000392157,840442,0.947938191
19469,155,347,8,7,0.000392157,840450,0.947947214
13402,307,632,8,7,0.000392157,840458,0.947956237
19509,364,354,8,7,0.000392157,840466,0.947965261
10632,586,638,8,7,0.000392157,840474,0.947974284
9025,640,84,8,7,0.000392157,840482,0.947983307
18118,586,269,8,7,0.000392157,840490,0.94799233
16352,632,156,8,7,0.000392157,840498,0.948001353
10066,280,507,8,7,0.000392157,840506,0.948010377
19995,514,562,7,7,0.000343137,840513,0.948018272
16792,458,582,7,7,0.000343137,840520,0.948026167
21065,121,9,7,7,0.000343137,840527,0.948034063
20008,103,689,7,7,0.000343137,840534,0.948041958
20025,552,682,7,7,0.000343137,840541,0.948049853
20263,171,479,7,7,0.000343137,840548,0.948057749
16848,446,302,7,7,0.000343137,840555,0.948065644
16775,22,479,7,7,0.000343137,840562,0.948073539
16934,655,97,7,7,0.000343137,840569,0.948081435
16973,261,243,7,7,0.000343137,840576,0.94808933
21014,5,250,7,7,0.000343137,840583,0.948097225
17134,427,11,7,7,0.000343137,840590,0.948105121
17143,43,11,7,7,0.000343137,840597,0.948113016
17160,243,140,7,7,0.000343137,840604,0.948120911
23942,364,30,7,7,0.000343137,840611,0.948128807
20073,3,446,7,7,0.000343137,840618,0.948136702
20109,479,294,7,7,0.000343137,840625,0.948144597
20244,204,517,7,7,0.000343137,840632,0.948152493
21000,204,140,7,7,0.000343137,840639,0.948160388
20096,701,204,7,7,0.000343137,840646,0.948168283
20264,124,331,7,7,0.000343137,840653,0.948176179
20116,15,682,7,7,0.000343137,840660,0.948184074
17114,414,261,7,7,0.000343137,840667,0.948191969
20091,307,503,7,7,0.000343137,840674,0.948199865
21201,498,160,7,7,0.000343137,840681,0.94820776
24017,121,529,7,7,0.000343137,840688,0.948215655
20630,494,596,7,7,0.000343137,840695,0.948223551
16937,1,528,7,7,0.000343137,840702,0.948231446
20098,503,335,7,7,0.000343137,840709,0.948239341
20196,586,64,7,7,0.000343137,840716,0.948247237
16872,673,605,7,7,0.000343137,840723,0.948255132
21097,528,646,7,7,0.000343137,840730,0.948263027
20143,193,463,7,7,0.000343137,840737,0.948270923
17009,25,463,7,7,0.000343137,840744,0.948278818
18370,156,397,7,7,0.000343137,840751,0.948286713
19321,90,95,7,7,0.000343137,840758,0.948294609
18390,501,140,7,7,0.000343137,840765,0.948302504
18378,529,409,7,7,0.000343137,840772,0.948310399
19343,12,261,7,7,0.000343137,840779,0.948318295
19317,50,261,7,7,0.000343137,840786,0.94832619
18357,528,328,7,7,0.000343137,840793,0.948334085
20782,171,250,7,7,0.000343137,840800,0.948341981
18354,31,439,7,7,0.000343137,840807,0.948349876
19352,84,133,7,7,0.000343137,840814,0.948357771
18333,614,56,7,7,0.000343137,840821,0.948365667
21880,668,638,7,7,0.000343137,840828,0.948373562
22710,43,117,7,7,0.000343137,840835,0.948381457
20460,202,302,7,7,0.000343137,840842,0.948389353
18461,250,723,7,7,0.000343137,840849,0.948397248
18449,517,156,7,7,0.000343137,840856,0.948405143
22690,31,328,7,7,0.000343137,840863,0.948413039
18438,204,56,7,7,0.000343137,840870,0.948420934
19312,242,117,7,7,0.000343137,840877,0.948428829
19297,26,54,7,7,0.000343137,840884,0.948436725
19309,514,544,7,7,0.000343137,840891,0.94844462
20531,269,230,7,7,0.000343137,840898,0.948452515
18469,380,446,7,7,0.000343137,840905,0.948460411
20822,202,34,7,7,0.000343137,840912,0.948468306
19485,596,261,7,7,0.000343137,840919,0.948476201
21739,155,723,7,7,0.000343137,840926,0.948484097
20549,32,593,7,7,0.000343137,840933,0.948491992
19498,471,22,7,7,0.000343137,840940,0.948499887
18232,638,207,7,7,0.000343137,840947,0.948507783
19428,528,501,7,7,0.000343137,840954,0.948515678
21796,230,90,7,7,0.000343137,840961,0.948523573
18190,12,204,7,7,0.000343137,840968,0.948531469
18163,310,508,7,7,0.000343137,840975,0.948539364
19446,582,319,7,7,0.000343137,840982,0.948547259
21778,342,663,7,7,0.000343137,840989,0.948555155
18155,156,114,7,7,0.000343137,840996,0.94856305
20266,544,156,7,7,0.000343137,841003,0.948570945
22364,265,507,7,7,0.000343137,841010,0.948578841
18991,29,126,7,7,0.000343137,841017,0.948586736
18993,34,175,7,7,0.000343137,841024,0.948594631
20482,204,605,7,7,0.000343137,841031,0.948602527
18994,332,77,7,7,0.000343137,841038,0.948610422
18998,84,294,7,7,0.000343137,841045,0.948618317
19008,14,497,7,7,0.000343137,841052,0.948626212
18986,196,552,7,7,0.000343137,841059,0.948634108
19014,107,195,7,7,0.000343137,841066,0.948642003
18732,473,720,7,7,0.000343137,841073,0.948649898
18799,511,535,7,7,0.000343137,841080,0.948657794
22283,663,124,7,7,0.000343137,841087,0.948665689
18910,25,14,7,7,0.000343137,841094,0.948673584
18918,684,31,7,7,0.000343137,841101,0.94868148
22262,265,517,7,7,0.000343137,841108,0.948689375
22189,482,398,7,7,0.000343137,841115,0.94869727
20500,614,269,7,7,0.000343137,841122,0.948705166
18974,552,632,7,7,0.000343137,841129,0.948713061
18845,158,475,7,7,0.000343137,841136,0.948720956
18841,193,497,7,7,0.000343137,841143,0.948728852
18981,140,674,7,7,0.000343137,841150,0.948736747
20520,379,163,7,7,0.000343137,841157,0.948744642
19146,195,219,7,7,0.000343137,841164,0.948752538
19165,558,175,7,7,0.000343137,841171,0.948760433
19166,156,30,7,7,0.000343137,841178,0.948768328
20724,398,170,7,7,0.000343137,841185,0.948776224
19232,661,16,7,7,0.000343137,841192,0.948784119
20513,719,313,7,7,0.000343137,841199,0.948792014
19243,290,10,7,7,0.000343137,841206,0.94879991
19140,302,646,7,7,0.000343137,841213,0.948807805
18689,684,219,7,7,0.000343137,841220,0.9488157
18664,22,348,7,7,0.000343137,841227,0.948823596
19071,354,126,7,7,0.000343137,841234,0.948831491
18633,123,448,7,7,0.000343137,841241,0.948839386
18621,243,13,7,7,0.000343137,841248,0.948847282
19138,632,22,7,7,0.000343137,841255,0.948855177
22577,571,141,7,7,0.000343137,841262,0.948863072
18575,347,543,7,7,0.000343137,841269,0.948870968
18076,347,175,7,7,0.000343137,841276,0.948878863
18064,517,2,7,7,0.000343137,841283,0.948886758
17463,475,103,7,7,0.000343137,841290,0.948894654
19826,29,596,7,7,0.000343137,841297,0.948902549
17484,97,586,7,7,0.000343137,841304,0.948910444
17482,448,196,7,7,0.000343137,841311,0.94891834
17499,328,261,7,7,0.000343137,841318,0.948926235
21367,632,175,7,7,0.000343137,841325,0.94893413
17458,689,439,7,7,0.000343137,841332,0.948942026
17452,503,230,7,7,0.000343137,841339,0.948949921
23555,140,663,7,7,0.000343137,841346,0.948957816
17432,532,126,7,7,0.000343137,841353,0.948965712
19872,348,383,7,7,0.000343137,841360,0.948973607
17630,4,511,7,7,0.000343137,841367,0.948981502
17621,19,15,7,7,0.000343137,841374,0.948989398
17617,178,95,7,7,0.000343137,841381,0.948997293
17541,605,348,7,7,0.000343137,841388,0.949005188
17539,19,558,7,7,0.000343137,841395,0.949013084
19810,3,383,7,7,0.000343137,841402,0.949020979
17423,439,141,7,7,0.000343137,841409,0.949028874
19901,114,708,7,7,0.000343137,841416,0.94903677
17301,207,31,7,7,0.000343137,841423,0.949044665
23691,708,398,7,7,0.000343137,841430,0.94905256
17276,145,250,7,7,0.000343137,841437,0.949060456
17246,618,280,7,7,0.000343137,841444,0.949068351
19940,492,107,7,7,0.000343137,841451,0.949076246
17170,354,294,7,7,0.000343137,841458,0.949084142
17420,674,5,7,7,0.000343137,841465,0.949092037
17411,141,314,7,7,0.000343137,841472,0.949099932
17407,32,448,7,7,0.000343137,841479,0.949107828
17402,614,328,7,7,0.000343137,841486,0.949115723
17363,448,31,7,7,0.000343137,841493,0.949123618
17361,552,29,7,7,0.000343137,841500,0.949131514
17310,528,439,7,7,0.000343137,841507,0.949139409
17352,640,609,7,7,0.000343137,841514,0.949147304
19893,307,439,7,7,0.000343137,841521,0.9491552
17343,348,652,7,7,0.000343137,841528,0.949163095
19894,383,427,7,7,0.000343137,841535,0.94917099
17337,497,95,7,7,0.000343137,841542,0.949178886
21395,167,123,7,7,0.000343137,841549,0.949186781
17638,593,114,7,7,0.000343137,841556,0.949194676
19792,511,674,7,7,0.000343137,841563,0.949202572
17896,32,673,7,7,0.000343137,841570,0.949210467
17963,274,560,7,7,0.000343137,841577,0.949218362
17921,32,514,7,7,0.000343137,841584,0.949226258
17888,334,689,7,7,0.000343137,841591,0.949234153
19632,13,158,7,7,0.000343137,841598,0.949242048
17866,11,5,7,7,0.000343137,841605,0.949249944
17968,404,14,7,7,0.000343137,841612,0.949257839
17974,493,397,7,7,0.000343137,841619,0.949265734
17642,20,274,7,7,0.000343137,841626,0.94927363
19546,364,427,7,7,0.000343137,841633,0.949281525
18050,310,493,7,7,0.000343137,841640,0.94928942
18044,29,16,7,7,0.000343137,841647,0.949297316
21654,25,632,7,7,0.000343137,841654,0.949305211
21638,54,68,7,7,0.000343137,841661,0.949313106
21633,721,558,7,7,0.000343137,841668,0.949321002
23095,414,5,7,7,0.000343137,841675,0.949328897
20841,10,269,7,7,0.000343137,841682,0.949336792
17711,20,701,7,7,0.000343137,841689,0.949344688
17772,14,171,7,7,0.000343137,841696,0.949352583
17770,367,632,7,7,0.000343137,841703,0.949360478
17748,1,243,7,7,0.000343137,841710,0.949368374
17737,614,605,7,7,0.000343137,841717,0.949376269
17732,720,68,7,7,0.000343137,841724,0.949384164
19757,458,380,7,7,0.000343137,841731,0.94939206
17728,332,25,7,7,0.000343137,841738,0.949399955
19653,593,196,7,7,0.000343137,841745,0.94940785
23327,13,22,7,7,0.000343137,841752,0.949415746
17701,708,280,7,7,0.000343137,841759,0.949423641
17697,689,250,7,7,0.000343137,841766,0.949431536
20669,683,243,7,7,0.000343137,841773,0.949439432
17652,13,586,7,7,0.000343137,841780,0.949447327
17650,605,522,7,7,0.000343137,841787,0.949455222
17773,525,443,7,7,0.000343137,841794,0.949463118
21485,164,196,7,7,0.000343137,841801,0.949471013
23244,708,517,7,7,0.000343137,841808,0.949478908
20371,624,5,7,7,0.000343137,841815,0.949486804
19697,328,605,7,7,0.000343137,841822,0.949494699
23257,97,290,7,7,0.000343137,841829,0.949502594
19717,167,26,7,7,0.000343137,841836,0.94951049
21501,138,33,7,7,0.000343137,841843,0.949518385
16773,683,311,7,7,0.000343137,841850,0.94952628
12605,140,158,7,7,0.000343137,841857,0.949534176
16338,250,30,7,7,0.000343137,841864,0.949542071
13869,646,311,7,7,0.000343137,841871,0.949549966
13867,582,673,7,7,0.000343137,841878,0.949557861
16331,48,508,7,7,0.000343137,841885,0.949565757
13829,12,3,7,7,0.000343137,841892,0.949573652
15794,529,544,7,7,0.000343137,841899,0.949581547
12028,529,50,7,7,0.000343137,841906,0.949589443
16373,682,348,7,7,0.000343137,841913,0.949597338
10026,123,511,7,7,0.000343137,841920,0.949605233
13787,414,3,7,7,0.000343137,841927,0.949613129
13786,498,97,7,7,0.000343137,841934,0.949621024
13775,618,95,7,7,0.000343137,841941,0.949628919
15790,493,236,7,7,0.000343137,841948,0.949636815
13740,32,569,7,7,0.000343137,841955,0.94964471
7470,409,80,7,7,0.000343137,841962,0.949652605
15056,334,196,7,7,0.000343137,841969,0.949660501
16371,673,20,7,7,0.000343137,841976,0.949668396
14982,507,498,7,7,0.000343137,841983,0.949676291
13893,123,22,7,7,0.000343137,841990,0.949684187
16255,1,655,7,7,0.000343137,841997,0.949692082
14874,668,379,7,7,0.000343137,842004,0.949699977
14025,497,393,7,7,0.000343137,842011,0.949707873
15850,719,105,7,7,0.000343137,842018,0.949715768
15843,674,2,7,7,0.000343137,842025,0.949723663
14903,475,2,7,7,0.000343137,842032,0.949731559
16272,593,274,7,7,0.000343137,842039,0.949739454
13933,295,528,7,7,0.000343137,842046,0.949747349
15828,646,16,7,7,0.000343137,842053,0.949755245
15821,334,638,7,7,0.000343137,842060,0.94976314
16292,409,107,7,7,0.000343137,842067,0.949771035
11654,638,508,7,7,0.000343137,842074,0.949778931
13905,448,380,7,7,0.000343137,842081,0.949786826
14979,26,332,7,7,0.000343137,842088,0.949794721
15812,250,562,7,7,0.000343137,842095,0.949802617
13727,204,586,7,7,0.000343137,842102,0.949810512
12381,618,632,7,7,0.000343137,842109,0.949818407
16439,56,22,7,7,0.000343137,842116,0.949826303
12393,497,265,7,7,0.000343137,842123,0.949834198
13487,174,638,7,7,0.000343137,842130,0.949842093
13468,618,158,7,7,0.000343137,842137,0.949849989
15156,140,311,7,7,0.000343137,842144,0.949857884
15157,313,569,7,7,0.000343137,842151,0.949865779
16474,204,294,7,7,0.000343137,842158,0.949873675
15163,1,64,7,7,0.000343137,842165,0.94988157
15167,32,4,7,7,0.000343137,842172,0.949889465
15124,295,439,7,7,0.000343137,842179,0.949897361
12379,646,314,7,7,0.000343137,842186,0.949905256
15733,123,392,7,7,0.000343137,842193,0.949913151
16385,448,475,7,7,0.000343137,842200,0.949921047
13702,638,414,7,7,0.000343137,842207,0.949928942
15059,331,155,7,7,0.000343137,842214,0.949936837
15063,243,328,7,7,0.000343137,842221,0.949944733
15759,311,174,7,7,0.000343137,842228,0.949952628
16401,511,295,7,7,0.000343137,842235,0.949960523
12020,32,683,7,7,0.000343137,842242,0.949968419
11014,498,511,7,7,0.000343137,842249,0.949976314
9988,609,328,7,7,0.000343137,842256,0.949984209
13601,15,501,7,7,0.000343137,842263,0.949992105
12364,397,164,7,7,0.000343137,842270,0.95
12009,393,307,7,7,0.000343137,842277,0.950007895
13583,562,50,7,7,0.000343137,842284,0.950015791
15738,90,314,7,7,0.000343137,842291,0.950023686
11282,4,265,7,7,0.000343137,842298,0.950031581
13554,586,528,7,7,0.000343137,842305,0.950039477
14851,532,56,7,7,0.000343137,842312,0.950047372
14656,178,32,7,7,0.000343137,842319,0.950055267
14414,302,673,7,7,0.000343137,842326,0.950063163
14593,103,9,7,7,0.000343137,842333,0.950071058
16093,383,50,7,7,0.000343137,842340,0.950078953
11600,638,394,7,7,0.000343137,842347,0.950086849
14372,582,593,7,7,0.000343137,842354,0.950094744
16100,196,404,7,7,0.000343137,842361,0.950102639
15860,10,23,7,7,0.000343137,842368,0.950110535
14345,133,264,7,7,0.000343137,842375,0.95011843
14342,383,473,7,7,0.000343137,842382,0.950126325
14666,269,596,7,7,0.000343137,842389,0.950134221
14316,404,614,7,7,0.000343137,842396,0.950142116
15926,392,588,7,7,0.000343137,842403,0.950150011
10212,196,50,7,7,0.000343137,842410,0.950157907
14518,393,714,7,7,0.000343137,842417,0.950165802
14506,532,328,7,7,0.000343137,842424,0.950173697
15997,269,380,7,7,0.000343137,842431,0.950181593
24759,85,5,7,7,0.000343137,842438,0.950189488
10750,448,314,7,7,0.000343137,842445,0.950197383
14534,397,543,7,7,0.000343137,842452,0.950205279
15988,138,397,7,7,0.000343137,842459,0.950213174
14551,307,497,7,7,0.000343137,842466,0.950221069
10189,582,507,7,7,0.000343137,842473,0.950228965
16068,721,354,7,7,0.000343137,842480,0.95023686
16133,310,171,7,7,0.000343137,842487,0.950244755
15894,439,522,7,7,0.000343137,842494,0.950252651
14777,655,295,7,7,0.000343137,842501,0.950260546
14781,265,114,7,7,0.000343137,842508,0.950268441
14151,528,114,7,7,0.000343137,842515,0.950276337
14786,64,479,7,7,0.000343137,842522,0.950284232
14149,511,562,7,7,0.000343137,842529,0.950292127
16224,514,295,7,7,0.000343137,842536,0.950300023
16225,473,646,7,7,0.000343137,842543,0.950307918
10692,16,20,7,7,0.000343137,842550,0.950315813
14829,448,27,7,7,0.000343137,842557,0.950323709
12257,684,158,7,7,0.000343137,842564,0.950331604
14076,30,195,7,7,0.000343137,842571,0.950339499
16137,193,2,7,7,0.000343137,842578,0.950347395
14769,335,163,7,7,0.000343137,842585,0.95035529
14707,640,529,7,7,0.000343137,842592,0.950363185
16143,32,178,7,7,0.000343137,842599,0.950371081
14267,5,236,7,7,0.000343137,842606,0.950378976
12193,265,471,7,7,0.000343137,842613,0.950386871
15908,103,302,7,7,0.000343137,842620,0.950394767
14737,4,463,7,7,0.000343137,842627,0.950402662
16185,95,587,7,7,0.000343137,842634,0.950410557
14744,114,141,7,7,0.000343137,842641,0.950418453
14749,593,385,7,7,0.000343137,842648,0.950426348
14200,708,443,7,7,0.000343137,842655,0.950434243
14189,331,493,7,7,0.000343137,842662,0.950442139
16599,332,380,7,7,0.000343137,842669,0.950450034
16733,14,307,7,7,0.000343137,842676,0.950457929
13141,498,404,7,7,0.000343137,842683,0.950465824
13135,618,295,7,7,0.000343137,842690,0.95047372
9259,4,10,7,7,0.000343137,842697,0.950481615
16609,243,475,7,7,0.000343137,842704,0.95048951
15301,138,314,7,7,0.000343137,842711,0.950497406
15615,479,646,7,7,0.000343137,842718,0.950505301
12851,517,158,7,7,0.000343137,842725,0.950513196
16598,196,243,7,7,0.000343137,842732,0.950521092
11934,307,107,7,7,0.000343137,842739,0.950528987
15259,242,674,7,7,0.000343137,842746,0.950536882
15237,103,33,7,7,0.000343137,842753,0.950544778
16742,16,593,7,7,0.000343137,842760,0.950552673
11840,394,463,7,7,0.000343137,842767,0.950560568
15472,609,145,7,7,0.000343137,842774,0.950568464
10501,638,587,7,7,0.000343137,842781,0.950576359
12559,295,1,7,7,0.000343137,842788,0.950584254
10596,236,246,7,7,0.000343137,842795,0.95059215
15276,174,302,7,7,0.000343137,842802,0.950600045
11110,243,683,7,7,0.000343137,842809,0.95060794
13150,385,558,7,7,0.000343137,842816,0.950615836
16694,655,170,7,7,0.000343137,842823,0.950623731
11814,4,121,7,7,0.000343137,842830,0.950631626
15461,414,31,7,7,0.000343137,842837,0.950639522
15635,528,3,7,7,0.000343137,842844,0.950647417
9284,242,77,7,7,0.000343137,842851,0.950655312
11967,310,30,7,7,0.000343137,842858,0.950663208
12496,9,332,7,7,0.000343137,842865,0.950671103
15415,117,498,7,7,0.000343137,842872,0.950678998
5599,4,529,7,7,0.000343137,842879,0.950686894
15583,511,123,7,7,0.000343137,842886,0.950694789
11191,673,543,7,7,0.000343137,842893,0.950702684
12506,673,404,7,7,0.000343137,842900,0.95071058
16689,242,535,7,7,0.000343137,842907,0.950718475
15400,163,141,7,7,0.000343137,842914,0.95072637
13031,156,588,7,7,0.000343137,842921,0.950734266
13029,334,114,7,7,0.000343137,842928,0.950742161
11185,331,20,7,7,0.000343137,842935,0.950750056
12854,409,314,7,7,0.000343137,842942,0.950757952
9468,721,80,7,7,0.000343137,842949,0.950765847
13076,543,708,7,7,0.000343137,842956,0.950773742
12904,708,353,7,7,0.000343137,842963,0.950781638
12908,708,29,7,7,0.000343137,842970,0.950789533
12489,31,50,7,7,0.000343137,842977,0.950797428
10541,593,404,7,7,0.000343137,842984,0.950805324
15354,379,683,7,7,0.000343137,842991,0.950813219
15364,673,242,7,7,0.000343137,842998,0.950821114
15366,133,68,7,7,0.000343137,843005,0.95082901
12952,514,302,7,7,0.000343137,843012,0.950836905
16707,507,394,7,7,0.000343137,843019,0.9508448
16574,243,587,7,7,0.000343137,843026,0.950852696
15684,689,1,7,7,0.000343137,843033,0.950860591
11891,493,353,7,7,0.000343137,843040,0.950868486
13354,385,605,7,7,0.000343137,843047,0.950876382
9638,164,80,7,7,0.000343137,843054,0.950884277
15698,274,511,7,7,0.000343137,843061,0.950892172
15700,97,107,7,7,0.000343137,843068,0.950900068
12659,501,543,7,7,0.000343137,843075,0.950907963
16539,114,97,7,7,0.000343137,843082,0.950915858
16747,347,130,7,7,0.000343137,843089,0.950923754
12570,302,242,7,7,0.000343137,843096,0.950931649
16748,682,3,7,7,0.000343137,843103,0.950939544
13327,164,264,7,7,0.000343137,843110,0.95094744
12670,264,379,7,7,0.000343137,843117,0.950955335
12684,383,558,7,7,0.000343137,843124,0.95096323
16519,701,471,7,7,0.000343137,843131,0.950971126
15479,138,522,7,7,0.000343137,843138,0.950979021
16526,571,27,7,7,0.000343137,843145,0.950986916
15683,609,364,7,7,0.000343137,843152,0.950994812
16517,261,117,7,7,0.000343137,843159,0.951002707
15201,16,140,7,7,0.000343137,843166,0.951010602
10598,9,383,7,7,0.000343137,843173,0.951018498
15213,265,22,7,7,0.000343137,843180,0.951026393
16498,22,311,7,7,0.000343137,843187,0.951034288
13391,522,4,7,7,0.000343137,843194,0.951042184
16542,529,121,7,7,0.000343137,843201,0.951050079
13380,261,9,7,7,0.000343137,843208,0.951057974
12606,114,264,7,7,0.000343137,843215,0.95106587
16570,307,508,7,7,0.000343137,843222,0.951073765
13206,156,196,7,7,0.000343137,843229,0.95108166
11182,498,714,22,6,0.001078431,843251,0.951106474
13274,14,397,18,6,0.000882353,843269,0.951126776
14399,294,196,13,6,0.000637255,843282,0.951141439
18059,155,243,12,6,0.000588235,843294,0.951154974
15101,668,15,12,6,0.000588235,843306,0.951168509
18939,107,673,12,6,0.000588235,843318,0.951182044
14532,295,661,12,6,0.000588235,843330,0.951195579
16530,97,117,11,6,0.000539216,843341,0.951207986
10205,11,307,11,6,0.000539216,843352,0.951220393
18848,121,3,11,6,0.000539216,843363,0.951232799
14055,609,97,11,6,0.000539216,843374,0.951245206
14768,22,473,11,6,0.000539216,843385,0.951257613
13611,261,398,11,6,0.000539216,843396,0.95127002
15949,479,503,11,6,0.000539216,843407,0.951282427
17815,314,371,11,6,0.000539216,843418,0.951294834
9416,605,379,11,6,0.000539216,843429,0.951307241
12760,562,15,11,6,0.000539216,843440,0.951319648
19828,121,414,11,6,0.000539216,843451,0.951332055
16673,242,15,10,6,0.000490196,843461,0.951343334
17320,689,364,10,6,0.000490196,843471,0.951354613
17479,525,311,10,6,0.000490196,843481,0.951365892
14358,29,174,10,6,0.000490196,843491,0.951377171
17189,439,31,10,6,0.000490196,843501,0.95138845
14881,6,175,10,6,0.000490196,843511,0.951399729
7197,163,80,10,6,0.000490196,843521,0.951411008
7235,673,394,10,6,0.000490196,843531,0.951422287
11195,618,380,10,6,0.000490196,843541,0.951433566
16910,3,167,10,6,0.000490196,843551,0.951444845
16634,10,569,10,6,0.000490196,843561,0.951456125
17158,552,385,10,6,0.000490196,843571,0.951467404
20625,80,569,10,6,0.000490196,843581,0.951478683
19456,532,624,10,6,0.000490196,843591,0.951489962
19961,269,609,10,6,0.000490196,843601,0.951501241
19255,50,54,10,6,0.000490196,843611,0.95151252
13648,107,560,10,6,0.000490196,843621,0.951523799
13906,243,4,10,6,0.000490196,843631,0.951535078
12624,230,261,10,6,0.000490196,843641,0.951546357
12484,12,528,10,6,0.000490196,843651,0.951557636
13584,661,314,9,6,0.000441176,843660,0.951567787
12777,443,364,9,6,0.000441176,843669,0.951577938
16632,280,508,9,6,0.000441176,843678,0.951588089
16011,13,84,9,6,0.000441176,843687,0.95159824
12318,32,117,9,6,0.000441176,843696,0.951608392
11890,310,25,9,6,0.000441176,843705,0.951618543
19355,175,145,9,6,0.000441176,843714,0.951628694
18331,155,640,9,6,0.000441176,843723,0.951638845
19765,158,4,9,6,0.000441176,843732,0.951648996
13617,264,335,9,6,0.000441176,843741,0.951659147
18286,219,29,9,6,0.000441176,843750,0.951669298
15346,586,511,9,6,0.000441176,843759,0.95167945
15368,6,207,9,6,0.000441176,843768,0.951689601
19544,682,714,9,6,0.000441176,843777,0.951699752
12907,117,236,9,6,0.000441176,843786,0.951709903
15887,171,334,9,6,0.000441176,843795,0.951720054
16567,587,314,9,6,0.000441176,843804,0.951730205
16993,328,689,9,6,0.000441176,843813,0.951740356
13259,31,130,9,6,0.000441176,843822,0.951750508
16979,719,582,9,6,0.000441176,843831,0.951760659
13282,265,334,9,6,0.000441176,843840,0.95177081
15184,427,307,9,6,0.000441176,843849,0.951780961
13518,663,446,9,6,0.000441176,843858,0.951791112
15941,178,14,9,6,0.000441176,843867,0.951801263
17551,9,492,9,6,0.000441176,843876,0.951811414
12795,9,207,9,6,0.000441176,843885,0.951821566
9538,638,14,9,6,0.000441176,843894,0.951831717
15169,503,224,9,6,0.000441176,843903,0.951841868
15791,261,26,9,6,0.000441176,843912,0.951852019
19476,117,439,9,6,0.000441176,843921,0.95186217
15513,5,638,9,6,0.000441176,843930,0.951872321
18403,178,33,9,6,0.000441176,843939,0.951882472
16638,171,77,9,6,0.000441176,843948,0.951892624
7924,4,11,9,6,0.000441176,843957,0.951902775
11958,701,473,9,6,0.000441176,843966,0.951912926
17243,721,514,9,6,0.000441176,843975,0.951923077
18712,655,12,9,6,0.000441176,843984,0.951933228
16235,663,714,9,6,0.000441176,843993,0.951943379
16234,383,250,9,6,0.000441176,844002,0.95195353
16915,140,348,9,6,0.000441176,844011,0.951963681
8359,30,158,9,6,0.000441176,844020,0.951973833
14071,236,632,9,6,0.000441176,844029,0.951983984
11966,609,141,9,6,0.000441176,844038,0.951994135
18940,160,502,9,6,0.000441176,844047,0.952004286
10244,398,158,9,6,0.000441176,844056,0.952014437
18868,354,261,9,6,0.000441176,844065,0.952024588
11798,261,334,9,6,0.000441176,844074,0.952034739
16736,502,385,9,6,0.000441176,844083,0.952044891
9877,398,302,9,6,0.000441176,844092,0.952055042
11480,302,613,9,6,0.000441176,844101,0.952065193
14430,56,261,9,6,0.000441176,844110,0.952075344
13882,618,10,9,6,0.000441176,844119,0.952085495
14912,668,522,9,6,0.000441176,844128,0.952095646
17435,313,290,9,6,0.000441176,844137,0.952105797
16883,673,503,9,6,0.000441176,844146,0.952115949
14691,15,193,9,6,0.000441176,844155,0.9521261
22623,171,517,9,6,0.000441176,844164,0.952136251
12183,274,295,9,6,0.000441176,844173,0.952146402
13941,174,632,9,6,0.000441176,844182,0.952156553
12978,614,156,8,6,0.000392157,844190,0.952165576
13006,721,32,8,6,0.000392157,844198,0.9521746
17668,503,655,8,6,0.000392157,844206,0.952183623
16466,224,673,8,6,0.000392157,844214,0.952192646
9358,133,9,8,6,0.000392157,844222,0.952201669
15721,160,224,8,6,0.000392157,844230,0.952210693
12360,605,50,8,6,0.000392157,844238,0.952219716
19747,25,427,8,6,0.000392157,844246,0.952228739
11830,10,20,8,6,0.000392157,844254,0.952237762
12441,95,25,8,6,0.000392157,844262,0.952246785
16167,274,121,8,6,0.000392157,844270,0.952255809
12637,562,394,8,6,0.000392157,844278,0.952264832
17326,493,558,8,6,0.000392157,844286,0.952273855
19898,294,15,8,6,0.000392157,844294,0.952282878
16194,193,178,8,6,0.000392157,844302,0.952291902
17141,463,439,8,6,0.000392157,844310,0.952300925
16206,163,10,8,6,0.000392157,844318,0.952309948
12452,22,532,8,6,0.000392157,844326,0.952318971
17398,103,3,8,6,0.000392157,844334,0.952327995
12662,33,328,8,6,0.000392157,844342,0.952337018
21324,131,12,8,6,0.000392157,844350,0.952346041
17381,719,354,8,6,0.000392157,844358,0.952355064
12649,475,640,8,6,0.000392157,844366,0.952364088
17360,29,543,8,6,0.000392157,844374,0.952373111
16144,586,163,8,6,0.000392157,844382,0.952382134
16288,11,503,8,6,0.000392157,844390,0.952391157
16291,699,473,8,6,0.000392157,844398,0.95240018
12521,448,479,8,6,0.000392157,844406,0.952409204
17216,558,714,8,6,0.000392157,844414,0.952418227
12518,84,543,8,6,0.000392157,844422,0.95242725
17182,463,64,8,6,0.000392157,844430,0.952436273
17278,334,674,8,6,0.000392157,844438,0.952445297
16260,684,331,8,6,0.000392157,844446,0.95245432
19962,160,204,8,6,0.000392157,844454,0.952463343
16266,95,242,8,6,0.000392157,844462,0.952472366
16267,393,502,8,6,0.000392157,844470,0.95248139
20914,348,246,8,6,0.000392157,844478,0.952490413
15882,404,141,8,6,0.000392157,844486,0.952499436
17593,443,126,8,6,0.000392157,844494,0.952508459
15901,347,398,8,6,0.000392157,844502,0.952517483
12849,15,25,8,6,0.000392157,844510,0.952526506
15919,261,473,8,6,0.000392157,844518,0.952535529
12880,295,552,8,6,0.000392157,844526,0.952544552
17606,196,446,8,6,0.000392157,844534,0.952553575
15824,605,250,8,6,0.000392157,844542,0.952562599
21396,502,392,8,6,0.000392157,844550,0.952571622
16454,682,596,8,6,0.000392157,844558,0.952580645
15855,22,141,8,6,0.000392157,844566,0.952589668
20871,174,354,8,6,0.000392157,844574,0.952598692
23554,514,723,8,6,0.000392157,844582,0.952607715
20324,230,23,8,6,0.000392157,844590,0.952616738
20870,427,204,8,6,0.000392157,844598,0.952625761
11075,682,313,8,6,0.000392157,844606,0.952634785
19822,156,126,8,6,0.000392157,844614,0.952643808
19732,124,522,8,6,0.000392157,844622,0.952652831
22664,124,723,8,6,0.000392157,844630,0.952661854
7724,4,427,8,6,0.000392157,844638,0.952670878
14813,586,543,8,6,0.000392157,844646,0.952679901
20523,170,380,8,6,0.000392157,844654,0.952688924
13826,140,443,8,6,0.000392157,844662,0.952697947
19252,443,673,8,6,0.000392157,844670,0.95270697
18508,269,236,8,6,0.000392157,844678,0.952715994
13968,624,473,8,6,0.000392157,844686,0.952725017
18531,2,497,8,6,0.000392157,844694,0.95273404
16891,593,497,8,6,0.000392157,844702,0.952743063
19164,529,174,8,6,0.000392157,844710,0.952752087
16887,50,364,8,6,0.000392157,844718,0.95276111
14726,331,673,8,6,0.000392157,844726,0.952770133
22058,181,68,8,6,0.000392157,844734,0.952779156
13928,196,674,8,6,0.000392157,844742,0.95278818
19192,95,514,8,6,0.000392157,844750,0.952797203
16679,156,64,8,6,0.000392157,844758,0.952806226
13911,596,30,8,6,0.000392157,844766,0.952815249
14884,202,20,8,6,0.000392157,844774,0.952824273
17784,1,364,8,6,0.000392157,844782,0.952833296
12079,9,23,8,6,0.000392157,844790,0.952842319
13691,404,674,8,6,0.000392157,844798,0.952851342
16922,605,392,8,6,0.000392157,844806,0.952860365
16635,493,68,8,6,0.000392157,844814,0.952869389
13718,43,334,8,6,0.000392157,844822,0.952878412
22681,167,11,8,6,0.000392157,844830,0.952887435
11626,264,280,8,6,0.000392157,844838,0.952896458
13665,97,397,8,6,0.000392157,844846,0.952905482
18410,22,503,8,6,0.000392157,844854,0.952914505
13794,446,68,8,6,0.000392157,844862,0.952923528
14905,528,265,8,6,0.000392157,844870,0.952932551
16902,354,364,8,6,0.000392157,844878,0.952941575
19270,219,661,8,6,0.000392157,844886,0.952950598
13798,302,502,8,6,0.000392157,844894,0.952959621
20527,479,720,8,6,0.000392157,844902,0.952968644
20189,156,632,8,6,0.000392157,844910,0.952977667
16688,613,310,8,6,0.000392157,844918,0.952986691
18740,1,398,8,6,0.000392157,844926,0.952995714
14295,443,479,8,6,0.000392157,844934,0.953004737
16802,427,158,8,6,0.000392157,844942,0.95301376
12159,12,471,8,6,0.000392157,844950,0.953022784
14016,6,4,8,6,0.000392157,844958,0.953031807
16859,56,164,8,6,0.000392157,844966,0.95304083
14677,171,394,8,6,0.000392157,844974,0.953049853
11534,31,84,8,6,0.000392157,844982,0.953058877
16882,552,508,8,6,0.000392157,844990,0.9530679
18571,261,131,8,6,0.000392157,844998,0.953076923
18636,204,385,8,6,0.000392157,845006,0.953085946
20477,517,502,8,6,0.000392157,845014,0.95309497
18676,156,242,8,6,0.000392157,845022,0.953103993
14119,43,84,8,6,0.000392157,845030,0.953113016
14609,328,22,8,6,0.000392157,845038,0.953122039
18644,1,501,8,6,0.000392157,845046,0.953131062
15469,170,158,8,6,0.000392157,845054,0.953140086
13226,163,582,8,6,0.000392157,845062,0.953149109
12305,114,4,8,6,0.000392157,845070,0.953158132
15458,22,398,8,6,0.000392157,845078,0.953167155
17970,684,33,8,6,0.000392157,845086,0.953176179
23111,543,181,8,6,0.000392157,845094,0.953185202
13211,632,655,8,6,0.000392157,845102,0.953194225
12311,9,261,8,6,0.000392157,845110,0.953203248
10053,133,84,8,6,0.000392157,845118,0.953212272
15382,195,33,8,6,0.000392157,845126,0.953221295
15375,156,640,8,6,0.000392157,845134,0.953230318
16976,332,655,8,6,0.000392157,845142,0.953239341
9127,708,80,8,6,0.000392157,845150,0.953248365
13270,32,404,8,6,0.000392157,845158,0.953257388
20601,167,103,8,6,0.000392157,845166,0.953266411
17823,475,562,8,6,0.000392157,845174,0.953275434
17824,48,646,8,6,0.000392157,845182,0.953284457
13092,20,569,8,6,0.000392157,845190,0.953293481
17829,364,123,8,6,0.000392157,845198,0.953302504
19660,544,593,8,6,0.000392157,845206,0.953311527
13081,582,181,8,6,0.000392157,845214,0.95332055
15644,50,280,8,6,0.000392157,845222,0.953329574
15694,498,507,8,6,0.000392157,845230,0.953338597
17791,558,414,8,6,0.000392157,845238,0.95334762
17809,475,26,8,6,0.000392157,845246,0.953356643
15532,719,335,8,6,0.000392157,845254,0.953365667
15559,543,2,8,6,0.000392157,845262,0.95337469
15560,29,64,8,6,0.000392157,845270,0.953383713
19628,294,708,8,6,0.000392157,845278,0.953392736
21613,29,720,8,6,0.000392157,845286,0.95340176
15214,668,145,8,6,0.000392157,845294,0.953410783
15207,427,117,8,6,0.000392157,845302,0.953419806
18173,655,364,8,6,0.000392157,845310,0.953428829
16595,117,638,8,6,0.000392157,845318,0.953437852
16947,668,348,8,6,0.000392157,845326,0.953446876
13502,558,661,8,6,0.000392157,845334,0.953455899
20810,1,13,8,6,0.000392157,845342,0.953464922
11675,2,64,8,6,0.000392157,845350,0.953473945
11677,586,164,8,6,0.000392157,845358,0.953482969
19457,328,85,8,6,0.000392157,845366,0.953491992
15180,33,605,8,6,0.000392157,845374,0.953501015
21837,155,171,8,6,0.000392157,845382,0.953510038
15118,668,10,8,6,0.000392157,845390,0.953519062
18265,605,328,8,6,0.000392157,845398,0.953528085
16938,33,571,8,6,0.000392157,845406,0.953537108
15128,558,404,8,6,0.000392157,845414,0.953546131
15129,310,661,8,6,0.000392157,845422,0.953555155
16610,117,32,8,6,0.000392157,845430,0.953564178
18235,571,15,8,6,0.000392157,845438,0.953573201
18224,501,493,8,6,0.000392157,845446,0.953582224
13418,12,307,8,6,0.000392157,845454,0.953591247
19491,398,674,8,6,0.000392157,845462,0.953600271
15296,80,261,8,6,0.000392157,845470,0.953609294
19494,448,558,8,6,0.000392157,845478,0.953618317
15319,719,123,8,6,0.000392157,845486,0.95362734
20074,207,167,8,6,0.000392157,845494,0.953636364
15338,164,522,8,6,0.000392157,845502,0.953645387
18126,164,171,8,6,0.000392157,845510,0.95365441
13429,95,508,8,6,0.000392157,845518,0.953663433
8968,9,683,8,6,0.000392157,845526,0.953672457
13437,156,471,8,6,0.000392157,845534,0.95368148
16930,544,560,7,6,0.000343137,845541,0.953689375
16794,14,22,7,6,0.000343137,845548,0.95369727
17127,155,9,7,6,0.000343137,845555,0.953705166
21204,155,394,7,6,0.000343137,845562,0.953713061
17020,155,463,7,6,0.000343137,845569,0.953720956
17067,439,280,7,6,0.000343137,845576,0.953728852
21077,174,552,7,6,0.000343137,845583,0.953736747
23886,13,25,7,6,0.000343137,845590,0.953744642
16972,605,347,7,6,0.000343137,845597,0.953752538
20077,525,558,7,6,0.000343137,845604,0.953760433
16990,133,562,7,6,0.000343137,845611,0.953768328
16778,274,708,7,6,0.000343137,845618,0.953776224
19974,243,544,7,6,0.000343137,845625,0.953784119
16789,331,492,7,6,0.000343137,845632,0.953792014
17043,414,479,7,6,0.000343137,845639,0.95379991
16849,121,77,7,6,0.000343137,845646,0.953807805
16869,379,383,7,6,0.000343137,845653,0.9538157
16833,414,15,7,6,0.000343137,845660,0.953823596
21029,167,380,7,6,0.000343137,845667,0.953831491
20167,224,103,7,6,0.000343137,845674,0.953839386
16867,64,335,7,6,0.000343137,845681,0.953847282
17068,517,404,7,6,0.000343137,845688,0.953855177
16836,535,1,7,6,0.000343137,845695,0.953863072
16969,632,443,7,6,0.000343137,845702,0.953870968
19964,328,632,7,6,0.000343137,845709,0.953878863
17075,30,501,7,6,0.000343137,845716,0.953886758
20115,689,560,7,6,0.000343137,845723,0.953894654
16975,514,156,7,6,0.000343137,845730,0.953902549
16955,507,156,7,6,0.000343137,845737,0.953910444
23825,708,364,7,6,0.000343137,845744,0.95391834
20017,354,195,7,6,0.000343137,845751,0.953926235
17060,507,14,7,6,0.000343137,845758,0.95393413
20175,448,331,7,6,0.000343137,845765,0.953942026
16818,314,720,7,6,0.000343137,845772,0.953949921
17013,26,195,7,6,0.000343137,845779,0.953957816
17058,446,347,7,6,0.000343137,845786,0.953965712
20063,167,498,7,6,0.000343137,845793,0.953973607
19959,19,479,7,6,0.000343137,845800,0.953981502
20113,347,624,7,6,0.000343137,845807,0.953989398
16829,528,532,7,6,0.000343137,845814,0.953997293
20019,414,204,7,6,0.000343137,845821,0.954005188
19945,535,5,7,6,0.000343137,845828,0.954013084
18397,668,394,7,6,0.000343137,845835,0.954020979
19325,11,482,7,6,0.000343137,845842,0.954028874
18386,668,11,7,6,0.000343137,845849,0.95403677
18382,517,497,7,6,0.000343137,845856,0.954044665
18362,43,243,7,6,0.000343137,845863,0.95405256
18314,479,156,7,6,0.000343137,845870,0.954060456
18304,30,175,7,6,0.000343137,845877,0.954068351
18303,593,475,7,6,0.000343137,845884,0.954076246
18275,133,95,7,6,0.000343137,845891,0.954084142
19288,193,20,7,6,0.000343137,845898,0.954092037
19266,171,175,7,6,0.000343137,845905,0.954099932
22692,348,720,7,6,0.000343137,845912,0.954107828
18442,593,348,7,6,0.000343137,845919,0.954115723
21956,171,514,7,6,0.000343137,845926,0.954123618
20770,158,30,7,6,0.000343137,845933,0.954131514
18424,383,31,7,6,0.000343137,845940,0.954139409
20773,117,605,7,6,0.000343137,845947,0.954147304
20443,721,50,7,6,0.000343137,845954,0.9541552
21936,482,596,7,6,0.000343137,845961,0.954163095
18269,16,646,7,6,0.000343137,845968,0.95417099
18250,145,332,7,6,0.000343137,845975,0.954178886
18111,674,171,7,6,0.000343137,845982,0.954186781
20408,497,414,7,6,0.000343137,845989,0.954194676
19464,31,624,7,6,0.000343137,845996,0.954202572
18129,204,13,7,6,0.000343137,846003,0.954210467
20397,514,4,7,6,0.000343137,846010,0.954218362
19475,30,507,7,6,0.000343137,846017,0.954226258
18147,264,558,7,6,0.000343137,846024,0.954234153
20544,124,353,7,6,0.000343137,846031,0.954242048
21727,364,398,7,6,0.000343137,846038,0.954249944
19511,394,64,7,6,0.000343137,846045,0.954257839
21723,126,463,7,6,0.000343137,846052,0.954265734
21706,68,19,7,6,0.000343137,846059,0.95427363
18087,3,155,7,6,0.000343137,846066,0.954281525
18239,2,328,7,6,0.000343137,846073,0.95428942
22903,613,682,7,6,0.000343137,846080,0.954297316
20416,624,126,7,6,0.000343137,846087,0.954305211
21812,19,632,7,6,0.000343137,846094,0.954313106
19429,313,23,7,6,0.000343137,846101,0.954321002
19433,562,618,7,6,0.000343137,846108,0.954328897
20806,155,141,7,6,0.000343137,846115,0.954336792
18207,482,313,7,6,0.000343137,846122,0.954344688
18153,331,103,7,6,0.000343137,846129,0.954352583
18206,43,130,7,6,0.000343137,846136,0.954360478
20411,501,508,7,6,0.000343137,846143,0.954368374
18178,2,532,7,6,0.000343137,846150,0.954376269
18165,393,383,7,6,0.000343137,846157,0.954384164
21781,250,140,7,6,0.000343137,846164,0.95439206
19247,257,367,7,6,0.000343137,846171,0.954399955
18757,19,1,7,6,0.000343137,846178,0.95440785
22346,348,493,7,6,0.000343137,846185,0.954415746
22372,230,103,7,6,0.000343137,846192,0.954423641
22159,158,605,7,6,0.000343137,846199,0.954431536
18721,517,439,7,6,0.000343137,846206,0.954439432
19041,243,632,7,6,0.000343137,846213,0.954447327
18711,409,311,7,6,0.000343137,846220,0.954455222
19050,511,97,7,6,0.000343137,846227,0.954463118
18983,492,367,7,6,0.000343137,846234,0.954471013
18694,27,19,7,6,0.000343137,846241,0.954478908
22257,23,663,7,6,0.000343137,846248,0.954486804
18863,20,107,7,6,0.000343137,846255,0.954494699
18925,202,32,7,6,0.000343137,846262,0.954502594
22218,718,473,7,6,0.000343137,846269,0.95451049
18970,475,294,7,6,0.000343137,846276,0.954518385
18978,178,582,7,6,0.000343137,846283,0.95452628
18812,517,117,7,6,0.000343137,846290,0.954534176
19064,5,367,7,6,0.000343137,846297,0.954542071
18520,701,48,7,6,0.000343137,846304,0.954549966
20507,242,204,7,6,0.000343137,846311,0.954557861
20471,56,552,7,6,0.000343137,846318,0.954565757
16771,95,1,7,6,0.000343137,846325,0.954573652
19159,174,130,7,6,0.000343137,846332,0.954581547
19189,158,414,7,6,0.000343137,846339,0.954589443
22038,236,175,7,6,0.000343137,846346,0.954597338
18512,529,392,7,6,0.000343137,846353,0.954605233
18500,689,195,7,6,0.000343137,846360,0.954613129
18498,295,140,7,6,0.000343137,846367,0.954621024
22643,596,446,7,6,0.000343137,846374,0.954628919
18692,64,16,7,6,0.000343137,846381,0.954636815
19113,14,2,7,6,0.000343137,846388,0.95464471
22484,171,294,7,6,0.000343137,846395,0.954652605
18645,511,588,7,6,0.000343137,846402,0.954660501
22097,174,674,7,6,0.000343137,846409,0.954668396
22494,652,475,7,6,0.000343137,846416,0.954676291
19102,348,163,7,6,0.000343137,846423,0.954684187
18623,558,328,7,6,0.000343137,846430,0.954692082
19139,32,528,7,6,0.000343137,846437,0.954699977
19120,427,196,7,6,0.000343137,846444,0.954707873
22532,121,394,7,6,0.000343137,846451,0.954715768
18601,493,107,7,6,0.000343137,846458,0.954723663
23496,471,409,7,6,0.000343137,846465,0.954731559
19834,13,560,7,6,0.000343137,846472,0.954739454
17468,145,155,7,6,0.000343137,846479,0.954747349
17462,27,720,7,6,0.000343137,846486,0.954755245
19839,22,535,7,6,0.000343137,846493,0.95476314
21366,560,314,7,6,0.000343137,846500,0.954771035
17439,156,535,7,6,0.000343137,846507,0.954778931
19863,571,6,7,6,0.000343137,846514,0.954786826
17493,558,673,7,6,0.000343137,846521,0.954794721
17583,13,367,7,6,0.000343137,846528,0.954802617
17625,404,242,7,6,0.000343137,846535,0.954810512
23401,167,632,7,6,0.000343137,846542,0.954818407
17612,171,126,7,6,0.000343137,846549,0.954826303
17611,507,511,7,6,0.000343137,846556,0.954834198
23478,348,571,7,6,0.000343137,846563,0.954842093
19806,673,140,7,6,0.000343137,846570,0.954849989
17564,398,714,7,6,0.000343137,846577,0.954857884
19807,131,364,7,6,0.000343137,846584,0.954865779
17545,529,117,7,6,0.000343137,846591,0.954873675
17536,27,342,7,6,0.000343137,846598,0.95488157
17517,475,364,7,6,0.000343137,846605,0.954889465
17515,158,398,7,6,0.000343137,846612,0.954897361
19867,130,569,7,6,0.000343137,846619,0.954905256
18061,552,25,7,6,0.000343137,846626,0.954913151
21293,609,319,7,6,0.000343137,846633,0.954921047
17293,26,689,7,6,0.000343137,846640,0.954928942
20297,114,714,7,6,0.000343137,846647,0.954936837
20564,290,302,7,6,0.000343137,846654,0.954944733
21292,171,414,7,6,0.000343137,846661,0.954952628
20296,84,140,7,6,0.000343137,846668,0.954960523
20275,353,652,7,6,0.000343137,846675,0.954968419
17204,393,544,7,6,0.000343137,846682,0.954976314
17305,517,614,7,6,0.000343137,846689,0.954984209
17308,171,141,7,6,0.000343137,846696,0.954992105
20307,347,529,7,6,0.000343137,846703,0.955
17406,230,12,7,6,0.000343137,846710,0.955007895
17386,90,9,7,6,0.000343137,846717,0.955015791
17384,522,174,7,6,0.000343137,846724,0.955023686
20898,528,274,7,6,0.000343137,846731,0.955031581
17364,332,265,7,6,0.000343137,846738,0.955039477
17325,618,2,7,6,0.000343137,846745,0.955047372
17322,364,170,7,6,0.000343137,846752,0.955055267
17316,140,243,7,6,0.000343137,846759,0.955063163
17954,5,427,7,6,0.000343137,846766,0.955071058
21615,414,140,7,6,0.000343137,846773,0.955078953
17922,502,15,7,6,0.000343137,846780,0.955086849
17915,11,22,7,6,0.000343137,846787,0.955094744
23159,328,493,7,6,0.000343137,846794,0.955102639
23165,155,107,7,6,0.000343137,846801,0.955110535
17969,114,170,7,6,0.000343137,846808,0.95511843
17887,511,167,7,6,0.000343137,846815,0.955126325
19618,502,640,7,6,0.000343137,846822,0.955134221
17877,525,236,7,6,0.000343137,846829,0.955142116
17873,517,708,7,6,0.000343137,846836,0.955150011
20837,202,307,7,6,0.000343137,846843,0.955157907
21671,348,409,7,6,0.000343137,846850,0.955165802
18049,145,393,7,6,0.000343137,846857,0.955173697
18042,164,204,7,6,0.000343137,846864,0.955181593
19554,290,558,7,6,0.000343137,846871,0.955189488
18032,30,250,7,6,0.000343137,846878,0.955197383
18030,380,195,7,6,0.000343137,846885,0.955205279
20550,54,3,7,6,0.000343137,846892,0.955213174
17976,708,130,7,6,0.000343137,846899,0.955221069
20385,414,552,7,6,0.000343137,846906,0.955228965
19577,719,84,7,6,0.000343137,846913,0.95523686
18000,586,682,7,6,0.000343137,846920,0.955244755
17996,50,463,7,6,0.000343137,846927,0.955252651
17854,528,68,7,6,0.000343137,846934,0.955260546
21461,313,576,7,6,0.000343137,846941,0.955268441
17757,274,682,7,6,0.000343137,846948,0.955276337
19753,353,571,7,6,0.000343137,846955,0.955284232
17645,517,141,7,6,0.000343137,846962,0.955292127
17782,77,668,7,6,0.000343137,846969,0.955300023
17843,498,618,7,6,0.000343137,846976,0.955307918
17825,427,508,7,6,0.000343137,846983,0.955315813
21553,236,160,7,6,0.000343137,846990,0.955323709
17816,332,596,7,6,0.000343137,846997,0.955331604
20368,404,689,7,6,0.000343137,847004,0.955339499
17808,15,448,7,6,0.000343137,847011,0.955347395
17798,103,31,7,6,0.000343137,847018,0.95535529
15898,328,638,7,6,0.000343137,847025,0.955363185
13889,204,394,7,6,0.000343137,847032,0.955371081
7559,638,334,7,6,0.000343137,847039,0.955378976
14985,19,331,7,6,0.000343137,847046,0.955386871
14991,427,84,7,6,0.000343137,847053,0.955394767
13852,605,398,7,6,0.000343137,847060,0.955402662
12310,313,503,7,6,0.000343137,847067,0.955410557
13813,158,121,7,6,0.000343137,847074,0.955418453
15045,164,31,7,6,0.000343137,847081,0.955426348
16360,682,522,7,6,0.000343137,847088,0.955434243
16313,674,126,7,6,0.000343137,847095,0.955442139
15811,558,514,7,6,0.000343137,847102,0.955450034
12280,708,638,7,6,0.000343137,847109,0.955457929
15831,708,334,7,6,0.000343137,847116,0.955465824
11383,307,475,7,6,0.000343137,847123,0.95547372
14930,618,543,7,6,0.000343137,847130,0.955481615
13936,544,394,7,6,0.000343137,847137,0.95548951
16279,331,171,7,6,0.000343137,847144,0.955497406
14948,501,56,7,6,0.000343137,847151,0.955505301
14970,130,503,7,6,0.000343137,847158,0.955513196
16305,13,379,7,6,0.000343137,847165,0.955521092
10264,701,314,7,6,0.000343137,847172,0.955528987
11055,655,609,7,6,0.000343137,847179,0.955536882
13536,9,12,7,6,0.000343137,847186,0.955544778
13535,394,544,7,6,0.000343137,847193,0.955552673
15125,364,10,7,6,0.000343137,847200,0.955560568
13517,493,11,7,6,0.000343137,847207,0.955568464
16445,332,331,7,6,0.000343137,847214,0.955576359
16451,250,689,7,6,0.000343137,847221,0.955584254
16457,682,25,7,6,0.000343137,847228,0.95559215
16383,43,307,7,6,0.000343137,847235,0.955600045
9953,721,264,7,6,0.000343137,847242,0.95560794
15725,140,354,7,6,0.000343137,847249,0.955615836
15140,383,588,7,6,0.000343137,847256,0.955623731
13446,84,156,7,6,0.000343137,847263,0.955631626
13444,295,529,7,6,0.000343137,847270,0.955639522
13427,479,246,7,6,0.000343137,847277,0.955647417
11970,219,264,7,6,0.000343137,847284,0.955655312
15778,13,532,7,6,0.000343137,847291,0.955663208
13706,54,80,7,6,0.000343137,847298,0.955671103
13657,347,334,7,6,0.000343137,847305,0.955678998
11006,502,123,7,6,0.000343137,847312,0.955686894
13625,20,243,7,6,0.000343137,847319,0.955694789
15750,532,171,7,6,0.000343137,847326,0.955702684
15096,646,397,7,6,0.000343137,847333,0.95571058
12001,562,674,7,6,0.000343137,847340,0.955718475
20618,673,167,7,6,0.000343137,847347,0.95572637
14067,9,409,7,6,0.000343137,847354,0.955734266
14845,364,353,7,6,0.000343137,847361,0.955742161
14432,624,33,7,6,0.000343137,847368,0.955750056
15955,683,473,7,6,0.000343137,847375,0.955757952
15947,507,114,7,6,0.000343137,847382,0.955765847
14631,473,155,7,6,0.000343137,847389,0.955773742
14364,586,121,7,6,0.000343137,847396,0.955781638
14651,614,708,7,6,0.000343137,847403,0.955789533
14353,54,302,7,6,0.000343137,847410,0.955797428
14350,4,31,7,6,0.000343137,847417,0.955805324
16104,11,517,7,6,0.000343137,847424,0.955813219
14344,529,562,7,6,0.000343137,847431,0.955821114
14340,202,68,7,6,0.000343137,847438,0.95582901
14326,367,683,7,6,0.000343137,847445,0.955836905
14305,280,64,7,6,0.000343137,847452,0.9558448
14291,443,12,7,6,0.000343137,847459,0.955852696
14576,443,552,7,6,0.000343137,847466,0.955860591
14437,302,54,7,6,0.000343137,847473,0.955868486
14442,721,502,7,6,0.000343137,847480,0.955876382
14563,54,311,7,6,0.000343137,847487,0.955884277
12103,138,105,7,6,0.000343137,847494,0.955892172
10738,507,354,7,6,0.000343137,847501,0.955900068
12124,15,156,7,6,0.000343137,847508,0.955907963
14484,236,587,7,6,0.000343137,847515,0.955915858
15992,682,204,7,6,0.000343137,847522,0.955923754
10752,638,141,7,6,0.000343137,847529,0.955931649
12142,133,529,7,6,0.000343137,847536,0.955939544
14466,638,562,7,6,0.000343137,847543,0.95594744
10753,618,48,7,6,0.000343137,847550,0.955955335
16049,501,475,7,6,0.000343137,847557,0.95596323
16051,334,328,7,6,0.000343137,847564,0.955971126
16054,30,56,7,6,0.000343137,847571,0.955979021
15979,196,560,7,6,0.000343137,847578,0.955986916
14681,84,383,7,6,0.000343137,847585,0.955994812
14699,311,673,7,6,0.000343137,847592,0.956002707
14177,497,6,7,6,0.000343137,847599,0.956010602
12239,605,219,7,6,0.000343137,847606,0.956018498
10893,95,30,7,6,0.000343137,847613,0.956026393
15884,493,609,7,6,0.000343137,847620,0.956034288
14805,33,618,7,6,0.000343137,847627,0.956042184
14137,31,535,7,6,0.000343137,847634,0.956050079
16217,562,714,7,6,0.000343137,847641,0.956057974
14118,195,314,7,6,0.000343137,847648,0.95606587
14823,265,250,7,6,0.000343137,847655,0.956073765
14100,605,242,7,6,0.000343137,847662,0.95608166
15863,207,68,7,6,0.000343137,847669,0.956089556
14833,219,85,7,6,0.000343137,847676,0.956097451
14080,219,414,7,6,0.000343137,847683,0.956105346
14073,392,9,7,6,0.000343137,847690,0.956113242
15896,295,414,7,6,0.000343137,847697,0.956121137
14282,409,84,7,6,0.000343137,847704,0.956129032
24617,50,2,7,6,0.000343137,847711,0.956136928
14265,596,156,7,6,0.000343137,847718,0.956144823
11616,367,64,7,6,0.000343137,847725,0.956152718
14254,195,16,7,6,0.000343137,847732,0.956160614
14241,123,673,7,6,0.000343137,847739,0.956168509
14739,582,332,7,6,0.000343137,847746,0.956176404
14235,9,593,7,6,0.000343137,847753,0.9561843
10141,543,334,7,6,0.000343137,847760,0.956192195
16186,29,471,7,6,0.000343137,847767,0.95620009
16188,393,164,7,6,0.000343137,847774,0.956207986
14196,562,196,7,6,0.000343137,847781,0.956215881
16480,13,195,7,6,0.000343137,847788,0.956223776
13677,655,95,7,6,0.000343137,847795,0.956231672
15178,295,404,7,6,0.000343137,847802,0.956239567
16629,473,593,7,6,0.000343137,847809,0.956247462
12747,689,397,7,6,0.000343137,847816,0.956255358
15626,328,307,7,6,0.000343137,847823,0.956263253
16604,588,290,7,6,0.000343137,847830,0.956271148
15291,614,20,7,6,0.000343137,847837,0.956279044
13112,219,683,7,6,0.000343137,847844,0.956286939
13101,544,479,7,6,0.000343137,847851,0.956294834
15305,250,427,7,6,0.000343137,847858,0.95630273
9555,4,114,7,6,0.000343137,847865,0.956310625
12822,618,29,7,6,0.000343137,847872,0.95631852
16734,605,385,7,6,0.000343137,847879,0.956326416
12701,383,522,7,6,0.000343137,847886,0.956334311
15242,529,14,7,6,0.000343137,847893,0.956342206
13168,280,646,7,6,0.000343137,847900,0.956350102
16590,586,56,7,6,0.000343137,847907,0.956357997
12718,15,195,7,6,0.000343137,847914,0.956365892
15637,529,714,7,6,0.000343137,847921,0.956373788
16720,347,26,7,6,0.000343137,847928,0.956381683
15333,29,48,7,6,0.000343137,847935,0.956389578
13044,544,141,7,6,0.000343137,847942,0.956397473
16672,475,529,7,6,0.000343137,847949,0.956405369
15413,48,514,7,6,0.000343137,847956,0.956413264
11127,501,638,7,6,0.000343137,847963,0.956421159
11116,609,517,7,6,0.000343137,847970,0.956429055
10546,689,50,7,6,0.000343137,847977,0.95643695
15586,586,640,7,6,0.000343137,847984,0.956444845
16684,398,427,7,6,0.000343137,847991,0.956452741
13002,543,107,7,6,0.000343137,847998,0.956460636
11915,543,586,7,6,0.000343137,848005,0.956468531
10404,497,379,7,6,0.000343137,848012,0.956476427
16666,158,107,7,6,0.000343137,848019,0.956484322
15376,290,145,7,6,0.000343137,848026,0.956492217
10515,708,97,7,6,0.000343137,848033,0.956500113
12900,501,562,7,6,0.000343137,848040,0.956508008
11897,9,155,7,6,0.000343137,848047,0.956515903
15441,328,682,7,6,0.000343137,848054,0.956523799
13060,522,618,7,6,0.000343137,848061,0.956531694
16645,492,314,7,6,0.000343137,848068,0.956539589
12487,609,158,7,6,0.000343137,848075,0.956547485
12942,498,140,7,6,0.000343137,848082,0.95655538
16660,683,219,7,6,0.000343137,848089,0.956563275
15390,84,503,7,6,0.000343137,848096,0.956571171
10416,383,32,7,6,0.000343137,848103,0.956579066
16535,178,6,7,6,0.000343137,848110,0.956586961
13242,497,471,7,6,0.000343137,848117,0.956594857
15509,50,638,7,6,0.000343137,848124,0.956602752
15473,558,682,7,6,0.000343137,848131,0.956610647
15217,682,398,7,6,0.000343137,848138,0.956618543
16510,717,6,7,6,0.000343137,848145,0.956626438
13364,618,475,7,6,0.000343137,848152,0.956634333
15690,11,164,7,6,0.000343137,848159,0.956642229
15507,640,5,7,6,0.000343137,848166,0.956650124
15534,605,609,7,6,0.000343137,848173,0.956658019
15514,163,145,7,6,0.000343137,848180,0.956665915
15529,501,126,7,6,0.000343137,848187,0.95667381
13224,673,682,7,6,0.000343137,848194,0.956681705
16557,25,130,7,6,0.000343137,848201,0.956689601
15703,26,140,7,6,0.000343137,848208,0.956697496
15233,196,497,7,6,0.000343137,848215,0.956705391
15182,219,130,7,6,0.000343137,848222,0.956713287
13236,632,393,7,6,0.000343137,848229,0.956721182
18548,427,280,6,6,0.000294118,848235,0.956727949
15395,367,12,6,6,0.000294118,848241,0.956734717
15440,307,130,6,6,0.000294118,848247,0.956741484
15522,22,243,6,6,0.000294118,848253,0.956748252
23130,16,571,6,6,0.000294118,848259,0.956755019
18550,242,14,6,6,0.000294118,848265,0.956761787
18708,543,502,6,6,0.000294118,848271,0.956768554
14770,130,593,6,6,0.000294118,848277,0.956775321
17944,511,367,6,6,0.000294118,848283,0.956782089
15416,196,170,6,6,0.000294118,848289,0.956788856
20878,124,471,6,6,0.000294118,848295,0.956795624
15511,30,544,6,6,0.000294118,848301,0.956802391
18020,494,11,6,6,0.000294118,848307,0.956809159
23127,124,126,6,6,0.000294118,848313,0.956815926
14520,717,314,6,6,0.000294118,848319,0.956822693
18537,552,64,6,6,0.000294118,848325,0.956829461
14757,20,313,6,6,0.000294118,848331,0.956836228
18539,302,13,6,6,0.000294118,848337,0.956842996
22434,140,544,6,6,0.000294118,848343,0.956849763
18529,383,6,6,6,0.000294118,848349,0.956856531
18542,56,514,6,6,0.000294118,848355,0.956863298
15516,261,379,6,6,0.000294118,848361,0.956870065
14522,196,141,6,6,0.000294118,848367,0.956876833
22615,332,274,6,6,0.000294118,848373,0.9568836
14664,502,463,6,6,0.000294118,848379,0.956890368
14577,311,593,6,6,0.000294118,848385,0.956897135
20191,507,471,6,6,0.000294118,848391,0.956903903
21024,348,673,6,6,0.000294118,848397,0.95691067
20866,124,708,6,6,0.000294118,848403,0.956917437
23090,379,624,6,6,0.000294118,848409,0.956924205
18662,193,302,6,6,0.000294118,848415,0.956930972
18627,522,593,6,6,0.000294118,848421,0.95693774
21028,121,219,6,6,0.000294118,848427,0.956944507
20863,171,544,6,6,0.000294118,848433,0.956951275
22554,446,131,6,6,0.000294118,848439,0.956958042
22482,571,131,6,6,0.000294118,848445,0.956964809
14582,164,84,6,6,0.000294118,848451,0.956971577
20862,195,302,6,6,0.000294118,848457,0.956978344
18630,12,613,6,6,0.000294118,848463,0.956985112
12086,624,314,6,6,0.000294118,848469,0.956991879
14611,383,107,6,6,0.000294118,848475,0.956998647
18677,103,394,6,6,0.000294118,848481,0.957005414
15450,364,558,6,6,0.000294118,848487,0.957012181
18560,689,398,6,6,0.000294118,848493,0.957018949
14715,265,522,6,6,0.000294118,848499,0.957025716
14714,689,30,6,6,0.000294118,848505,0.957032484
14700,163,313,6,6,0.000294118,848511,0.957039251
15446,379,448,6,6,0.000294118,848517,0.957046018
18580,674,140,6,6,0.000294118,848523,0.957052786
18581,404,121,6,6,0.000294118,848529,0.957059553
20174,15,207,6,6,0.000294118,848535,0.957066321
17993,614,618,6,6,0.000294118,848541,0.957073088
18697,663,193,6,6,0.000294118,848547,0.957079856
14554,582,103,6,6,0.000294118,848553,0.957086623
14559,397,683,6,6,0.000294118,848559,0.95709339
18684,31,265,6,6,0.000294118,848565,0.957100158
21026,160,145,6,6,0.000294118,848571,0.957106925
18034,32,720,6,6,0.000294118,848577,0.957113693
18312,19,16,6,6,0.000294118,848583,0.95712046
20254,274,714,6,6,0.000294118,848589,0.957127228
15075,2,723,6,6,0.000294118,848595,0.957133995
18299,334,614,6,6,0.000294118,848601,0.957140762
18297,497,502,6,6,0.000294118,848607,0.95714753
18295,15,264,6,6,0.000294118,848613,0.957154297
18315,114,274,6,6,0.000294118,848619,0.957161065
15078,114,614,6,6,0.000294118,848625,0.957167832
15087,393,528,6,6,0.000294118,848631,0.9571746
20954,427,497,6,6,0.000294118,848637,0.957181367
18283,310,613,6,6,0.000294118,848643,0.957188134
15023,334,398,6,6,0.000294118,848649,0.957194902
20237,12,640,6,6,0.000294118,848655,0.957201669
20240,242,638,6,6,0.000294118,848661,0.957208437
22756,409,443,6,6,0.000294118,848667,0.957215204
18350,117,614,6,6,0.000294118,848673,0.957221972
20970,427,517,6,6,0.000294118,848679,0.957228739
18136,193,471,6,6,0.000294118,848685,0.957235506
10348,655,22,6,6,0.000294118,848691,0.957242274
18342,673,714,6,6,0.000294118,848697,0.957249041
18334,529,439,6,6,0.000294118,848703,0.957255809
22779,242,517,6,6,0.000294118,848709,0.957262576
18323,414,34,6,6,0.000294118,848715,0.957269344
18321,2,250,6,6,0.000294118,848721,0.957276111
15222,383,48,6,6,0.000294118,848727,0.957282878
18197,97,195,6,6,0.000294118,848733,0.957289646
25504,167,640,6,6,0.000294118,848739,0.957296413
20283,290,14,6,6,0.000294118,848745,0.957303181
15192,689,236,6,6,0.000294118,848751,0.957309948
18230,14,114,6,6,0.000294118,848757,0.957316716
18229,502,114,6,6,0.000294118,848763,0.957323483
15191,22,511,6,6,0.000294118,848769,0.95733025
15187,15,121,6,6,0.000294118,848775,0.957337018
18210,32,23,6,6,0.000294118,848781,0.957343785
20937,498,269,6,6,0.000294118,848787,0.957350553
22896,517,126,6,6,0.000294118,848793,0.95735732
22932,31,385,6,6,0.000294118,848799,0.957364088
18249,3,174,6,6,0.000294118,848805,0.957370855
18171,310,673,6,6,0.000294118,848811,0.957377622
25544,560,497,6,6,0.000294118,848817,0.95738439
15203,103,334,6,6,0.000294118,848823,0.957391157
20268,295,624,6,6,0.000294118,848829,0.957397925
15115,34,265,6,6,0.000294118,848835,0.957404692
18253,439,614,6,6,0.000294118,848841,0.95741146
15202,164,307,6,6,0.000294118,848847,0.957418227
15024,294,27,6,6,0.000294118,848853,0.957424994
18363,1,130,6,6,0.000294118,848859,0.957431762
18518,334,404,6,6,0.000294118,848865,0.957438529
22673,719,1,6,6,0.000294118,848871,0.957445297
18483,264,274,6,6,0.000294118,848877,0.957452064
14846,250,479,6,6,0.000294118,848883,0.957458831
20314,335,492,6,6,0.000294118,848889,0.957465599
18219,13,674,6,6,0.000294118,848895,0.957472366
18475,10,261,6,6,0.000294118,848901,0.957479134
22669,348,569,6,6,0.000294118,848907,0.957485901
14856,528,313,6,6,0.000294118,848913,0.957492669
14875,30,114,6,6,0.000294118,848919,0.957499436
18075,163,131,6,6,0.000294118,848925,0.957506203
14899,56,614,6,6,0.000294118,848931,0.957512971
22686,114,155,6,6,0.000294118,848937,0.957519738
18079,689,107,6,6,0.000294118,848943,0.957526506
18058,393,29,6,6,0.000294118,848949,0.957533273
22656,43,274,6,6,0.000294118,848955,0.957540041
11948,586,427,6,6,0.000294118,848961,0.957546808
14792,397,64,6,6,0.000294118,848967,0.957553575
18506,114,246,6,6,0.000294118,848973,0.957560343
15389,562,398,6,6,0.000294118,848979,0.95756711
14809,463,20,6,6,0.000294118,848985,0.957573878
22641,708,103,6,6,0.000294118,848991,0.957580645
14820,393,562,6,6,0.000294118,848997,0.957587413
10391,30,77,6,6,0.000294118,849003,0.95759418
18495,529,171,6,6,0.000294118,849009,0.957600947
23054,155,145,6,6,0.000294118,849015,0.957607715
18494,31,13,6,6,0.000294118,849021,0.957614482
22693,155,475,6,6,0.000294118,849027,0.95762125
18389,48,171,6,6,0.000294118,849033,0.957628017
22718,613,529,6,6,0.000294118,849039,0.957634785
20903,354,193,6,6,0.000294118,849045,0.957641552
18119,398,164,6,6,0.000294118,849051,0.957648319
15279,535,64,6,6,0.000294118,849057,0.957655087
18437,80,13,6,6,0.000294118,849063,0.957661854
18384,1,328,6,6,0.000294118,849069,0.957668622
18369,170,224,6,6,0.000294118,849075,0.957675389
18367,511,302,6,6,0.000294118,849081,0.957682157
15274,497,50,6,6,0.000294118,849087,0.957688924
14980,646,379,6,6,0.000294118,849093,0.957695691
15292,673,2,6,6,0.000294118,849099,0.957702459
14968,302,605,6,6,0.000294118,849105,0.957709226
12052,528,586,6,6,0.000294118,849111,0.957715994
18082,392,328,6,6,0.000294118,849117,0.957722761
14936,9,13,6,6,0.000294118,849123,0.957729529
18426,673,5,6,6,0.000294118,849129,0.957736296
14940,90,224,6,6,0.000294118,849135,0.957743063
22704,328,503,6,6,0.000294118,849141,0.957749831
20225,114,475,6,6,0.000294118,849147,0.957756598
18418,4,714,6,6,0.000294118,849153,0.957763366
18106,385,6,6,6,0.000294118,849159,0.957770133
18726,12,714,6,6,0.000294118,849165,0.957776901
18731,155,95,6,6,0.000294118,849171,0.957783668
21255,250,632,6,6,0.000294118,849177,0.957790435
13322,1,174,6,6,0.000294118,849183,0.957797203
9928,31,77,6,6,0.000294118,849189,0.95780397
21684,15,528,6,6,0.000294118,849195,0.957810738
13337,471,544,6,6,0.000294118,849201,0.957817505
19993,105,124,6,6,0.000294118,849207,0.957824273
21714,30,569,6,6,0.000294118,849213,0.95783104
19515,140,614,6,6,0.000294118,849219,0.957837807
19514,683,131,6,6,0.000294118,849225,0.957844575
21732,171,140,6,6,0.000294118,849231,0.957851342
21733,701,723,6,6,0.000294118,849237,0.95785811
21735,124,379,6,6,0.000294118,849243,0.957864877
19499,632,274,6,6,0.000294118,849249,0.957871644
21660,398,682,6,6,0.000294118,849255,0.957878412
19969,562,404,6,6,0.000294118,849261,0.957885179
19625,588,163,6,6,0.000294118,849267,0.957891947
19619,250,543,6,6,0.000294118,849273,0.957898714
9907,265,123,6,6,0.000294118,849279,0.957905482
13164,717,27,6,6,0.000294118,849285,0.957912249
13185,12,475,6,6,0.000294118,849291,0.957919016
21617,121,50,6,6,0.000294118,849297,0.957925784
19597,160,31,6,6,0.000294118,849303,0.957932551
9921,543,20,6,6,0.000294118,849309,0.957939319
19582,250,507,6,6,0.000294118,849315,0.957946086
13254,383,302,6,6,0.000294118,849321,0.957952854
19578,145,448,6,6,0.000294118,849327,0.957959621
21642,171,427,6,6,0.000294118,849333,0.957966388
19574,514,427,6,6,0.000294118,849339,0.957973156
21647,2,103,6,6,0.000294118,849345,0.957979923
9951,708,230,6,6,0.000294118,849351,0.957986691
13395,439,219,6,6,0.000294118,849357,0.957993458
19381,613,586,6,6,0.000294118,849363,0.958000226
21828,155,167,6,6,0.000294118,849369,0.958006993
19410,354,493,6,6,0.000294118,849375,0.95801376
13572,596,682,6,6,0.000294118,849381,0.958020528
12372,507,10,6,6,0.000294118,849387,0.958027295
21850,404,196,6,6,0.000294118,849393,0.958034063
9990,123,156,6,6,0.000294118,849399,0.95804083
21877,501,1,6,6,0.000294118,849405,0.958047598
20036,332,23,6,6,0.000294118,849411,0.958054365
21182,145,56,6,6,0.000294118,849417,0.958061132
13679,586,4,6,6,0.000294118,849423,0.9580679
19340,121,264,6,6,0.000294118,849429,0.958074667
12375,514,117,6,6,0.000294118,849435,0.958081435
19482,43,398,6,6,0.000294118,849441,0.958088202
13424,31,1,6,6,0.000294118,849447,0.95809497
19466,463,587,6,6,0.000294118,849453,0.958101737
9952,334,84,6,6,0.000294118,849459,0.958108504
13451,10,646,6,6,0.000294118,849465,0.958115272
21782,493,498,6,6,0.000294118,849471,0.958122039
19445,20,535,6,6,0.000294118,849477,0.958128807
20010,171,385,6,6,0.000294118,849483,0.958135574
13533,33,195,6,6,0.000294118,849489,0.958142342
21793,517,274,6,6,0.000294118,849495,0.958149109
19430,133,502,6,6,0.000294118,849501,0.958155876
13545,20,446,6,6,0.000294118,849507,0.958162644
21803,307,682,6,6,0.000294118,849513,0.958169411
21598,204,439,6,6,0.000294118,849519,0.958176179
18735,332,10,6,6,0.000294118,849525,0.958182946
21363,261,141,6,6,0.000294118,849531,0.958189714
12706,609,638,6,6,0.000294118,849537,0.958196481
21368,347,54,6,6,0.000294118,849543,0.958203248
21369,528,14,6,6,0.000294118,849549,0.958210016
21376,121,528,6,6,0.000294118,849555,0.958216783
21377,13,294,6,6,0.000294118,849561,0.958223551
19823,640,140,6,6,0.000294118,849567,0.958230318
19819,274,332,6,6,0.000294118,849573,0.958237085
19817,175,16,6,6,0.000294118,849579,0.958243853
19816,427,141,6,6,0.000294118,849585,0.95825062
19788,511,393,6,6,0.000294118,849591,0.958257388
21410,48,156,6,6,0.000294118,849597,0.958264155
19849,482,311,6,6,0.000294118,849603,0.958270923
19854,684,529,6,6,0.000294118,849609,0.95827769
19881,682,560,6,6,0.000294118,849615,0.958284457
12600,609,663,6,6,0.000294118,849621,0.958291225
19891,80,195,6,6,0.000294118,849627,0.958297992
21319,103,126,6,6,0.000294118,849633,0.95830476
21323,714,397,6,6,0.000294118,849639,0.958311527
19888,593,689,6,6,0.000294118,849645,0.958318295
12658,552,397,6,6,0.000294118,849651,0.958325062
21325,331,569,6,6,0.000294118,849657,0.958331829
19884,145,414,6,6,0.000294118,849663,0.958338597
21334,246,95,6,6,0.000294118,849669,0.958345364
12671,4,663,6,6,0.000294118,849675,0.958352132
12683,392,582,6,6,0.000294118,849681,0.958358899
21339,130,178,6,6,0.000294118,849687,0.958365667
19770,158,528,6,6,0.000294118,849693,0.958372434
19663,427,404,6,6,0.000294118,849699,0.958379201
21265,54,522,6,6,0.000294118,849705,0.958385969
21547,290,508,6,6,0.000294118,849711,0.958392736
19674,3,294,6,6,0.000294118,849717,0.958399504
19671,155,30,6,6,0.000294118,849723,0.958406271
13096,2,443,6,6,0.000294118,849729,0.958413039
21526,124,655,6,6,0.000294118,849735,0.958419806
21568,121,131,6,6,0.000294118,849741,0.958426573
9244,605,393,6,6,0.000294118,849747,0.958433341
21572,532,493,6,6,0.000294118,849753,0.958440108
21573,269,310,6,6,0.000294118,849759,0.958446876
21584,50,5,6,6,0.000294118,849765,0.958453643
12461,156,95,6,6,0.000294118,849771,0.958460411
19951,328,20,6,6,0.000294118,849777,0.958467178
19705,6,290,6,6,0.000294118,849783,0.958473945
21488,364,26,6,6,0.000294118,849789,0.958480713
21277,684,582,6,6,0.000294118,849795,0.95848748
19933,25,560,6,6,0.000294118,849801,0.958494248
21271,632,290,6,6,0.000294118,849807,0.958501015
19708,497,517,6,6,0.000294118,849813,0.958507783
19724,701,1,6,6,0.000294118,849819,0.95851455
19942,427,529,6,6,0.000294118,849825,0.958521317
19720,295,482,6,6,0.000294118,849831,0.958528085
19714,588,624,6,6,0.000294118,849837,0.958534852
19712,721,588,6,6,0.000294118,849843,0.95854162
19710,552,571,6,6,0.000294118,849849,0.958548387
19338,562,23,6,6,0.000294118,849855,0.958555155
14270,193,33,6,6,0.000294118,849861,0.958561922
14276,4,502,6,6,0.000294118,849867,0.958568689
18930,393,543,6,6,0.000294118,849873,0.958575457
18929,314,319,6,6,0.000294118,849879,0.958582224
18924,379,167,6,6,0.000294118,849885,0.958588992
22229,596,492,6,6,0.000294118,849891,0.958595759
21104,290,663,6,6,0.000294118,849897,0.958602527
14324,16,23,6,6,0.000294118,849903,0.958609294
18908,80,508,6,6,0.000294118,849909,0.958616061
21102,84,155,6,6,0.000294118,849915,0.958622829
18887,383,674,6,6,0.000294118,849921,0.958629596
21100,3,13,6,6,0.000294118,849927,0.958636364
14349,274,552,6,6,0.000294118,849933,0.958643131
17936,196,140,6,6,0.000294118,849939,0.958649898
19029,393,708,6,6,0.000294118,849945,0.958656666
19028,114,632,6,6,0.000294118,849951,0.958663433
20102,164,560,6,6,0.000294118,849957,0.958670201
22148,29,446,6,6,0.000294118,849963,0.958676968
14181,473,140,6,6,0.000294118,849969,0.958683736
19005,446,224,6,6,0.000294118,849975,0.958690503
18962,503,532,6,6,0.000294118,849981,0.95869727
18988,114,265,6,6,0.000294118,849987,0.958704038
22178,717,347,6,6,0.000294118,849993,0.958710805
18964,23,280,6,6,0.000294118,849999,0.958717573
12190,31,532,6,6,0.000294118,850005,0.95872434
18877,701,348,6,6,0.000294118,850011,0.958731108
18873,458,311,6,6,0.000294118,850017,0.958737875
14444,274,398,6,6,0.000294118,850023,0.958744642
22339,26,618,6,6,0.000294118,850029,0.95875141
18791,404,475,6,6,0.000294118,850035,0.958758177
22341,13,404,6,6,0.000294118,850041,0.958764945
22348,684,126,6,6,0.000294118,850047,0.958771712
18784,398,517,6,6,0.000294118,850053,0.95877848
22355,131,13,6,6,0.000294118,850059,0.958785247
14465,2,427,6,6,0.000294118,850065,0.958792014
22322,475,193,6,6,0.000294118,850071,0.958798782
22375,195,313,6,6,0.000294118,850077,0.958805549
18764,328,274,6,6,0.000294118,850083,0.958812317
20152,117,528,6,6,0.000294118,850089,0.958819084
18758,501,332,6,6,0.000294118,850095,0.958825852
14485,32,652,6,6,0.000294118,850101,0.958832619
22271,174,202,6,6,0.000294118,850107,0.958839386
18870,11,383,6,6,0.000294118,850113,0.958846154
20130,502,517,6,6,0.000294118,850119,0.958852921
14370,528,97,6,6,0.000294118,850125,0.958859689
14407,11,246,6,6,0.000294118,850131,0.958866456
18820,497,34,6,6,0.000294118,850137,0.958873224
25954,347,652,6,6,0.000294118,850143,0.958879991
22304,20,596,6,6,0.000294118,850149,0.958886758
22305,354,207,6,6,0.000294118,850155,0.958893526
12158,156,20,6,6,0.000294118,850161,0.958900293
14144,56,158,6,6,0.000294118,850167,0.958907061
13819,393,274,6,6,0.000294118,850173,0.958913828
19253,655,714,6,6,0.000294118,850179,0.958920596
13844,674,482,6,6,0.000294118,850185,0.958927363
21158,334,640,6,6,0.000294118,850191,0.95893413
19245,107,90,6,6,0.000294118,850197,0.958940898
13866,404,638,6,6,0.000294118,850203,0.958947665
13874,9,493,6,6,0.000294118,850209,0.958954433
13892,673,328,6,6,0.000294118,850215,0.9589612
21981,613,204,6,6,0.000294118,850221,0.958967968
19215,475,552,6,6,0.000294118,850227,0.958974735
19206,393,12,6,6,0.000294118,850233,0.958981502
19204,544,5,6,6,0.000294118,850239,0.95898827
19203,404,56,6,6,0.000294118,850245,0.958995037
22034,117,56,6,6,0.000294118,850251,0.959001805
22039,80,155,6,6,0.000294118,850257,0.959008572
19265,334,683,6,6,0.000294118,850263,0.959015339
19181,458,230,6,6,0.000294118,850269,0.959022107
13704,174,80,6,6,0.000294118,850275,0.959028874
21180,310,13,6,6,0.000294118,850281,0.959035642
21913,145,714,6,6,0.000294118,850287,0.959042409
21174,535,294,6,6,0.000294118,850293,0.959049177
20048,219,507,6,6,0.000294118,850299,0.959055944
21939,383,439,6,6,0.000294118,850305,0.959062711
13809,497,130,6,6,0.000294118,850311,0.959069479
20053,475,164,6,6,0.000294118,850317,0.959076246
20056,114,204,6,6,0.000294118,850323,0.959083014
13768,156,313,6,6,0.000294118,850329,0.959089781
21976,19,311,6,6,0.000294118,850335,0.959096549
21977,717,224,6,6,0.000294118,850341,0.959103316
13791,158,50,6,6,0.000294118,850347,0.959110083
13795,593,354,6,6,0.000294118,850353,0.959116851
19271,202,708,6,6,0.000294118,850359,0.959123618
22045,673,332,6,6,0.000294118,850365,0.959130386
19106,103,6,6,6,0.000294118,850371,0.959137153
14054,265,48,6,6,0.000294118,850377,0.959143921
19101,50,532,6,6,0.000294118,850383,0.959150688
19098,80,618,6,6,0.000294118,850389,0.959157455
21131,463,652,6,6,0.000294118,850395,0.959164223
19092,475,170,6,6,0.000294118,850401,0.95917099
19089,269,219,6,6,0.000294118,850407,0.959177758
22110,126,663,6,6,0.000294118,850413,0.959184525
19072,64,68,6,6,0.000294118,850419,0.959191293
22089,347,265,6,6,0.000294118,850425,0.95919806
26082,133,207,6,6,0.000294118,850431,0.959204827
20095,663,23,6,6,0.000294118,850437,0.959211595
19066,20,250,6,6,0.000294118,850443,0.959218362
14115,29,123,6,6,0.000294118,850449,0.95922513
19058,261,313,6,6,0.000294118,850455,0.959231897
19057,114,130,6,6,0.000294118,850461,0.959238665
19054,265,56,6,6,0.000294118,850467,0.959245432
19053,160,529,6,6,0.000294118,850473,0.959252199
19048,97,171,6,6,0.000294118,850479,0.959258967
14032,655,50,6,6,0.000294118,850485,0.959265734
22047,68,124,6,6,0.000294118,850491,0.959272502
19156,302,261,6,6,0.000294118,850497,0.959279269
19177,22,6,6,6,0.000294118,850503,0.959286037
19175,427,30,6,6,0.000294118,850509,0.959292804
20075,174,562,6,6,0.000294118,850515,0.959299571
22051,22,313,6,6,0.000294118,850521,0.959306339
13944,250,130,6,6,0.000294118,850527,0.959313106
13946,207,313,6,6,0.000294118,850533,0.959319874
19157,155,522,6,6,0.000294118,850539,0.959326641
19155,26,2,6,6,0.000294118,850545,0.959333409
19143,494,302,6,6,0.000294118,850551,0.959340176
13992,13,1,6,6,0.000294118,850557,0.959346943
14021,511,638,6,6,0.000294118,850563,0.959353711
19133,638,4,6,6,0.000294118,850569,0.959360478
19130,164,663,6,6,0.000294118,850575,0.959367246
15524,156,48,6,6,0.000294118,850581,0.959374013
17935,1,560,6,6,0.000294118,850587,0.959380781
15754,207,354,6,6,0.000294118,850593,0.959387548
17422,334,532,6,6,0.000294118,850599,0.959394315
17418,674,383,6,6,0.000294118,850605,0.959401083
11574,26,646,6,6,0.000294118,850611,0.95940785
23593,714,107,6,6,0.000294118,850617,0.959414618
17413,265,605,6,6,0.000294118,850623,0.959421385
16099,353,246,6,6,0.000294118,850629,0.959428152
17393,250,383,6,6,0.000294118,850635,0.95943492
17378,380,133,6,6,0.000294118,850641,0.959441687
10858,33,85,6,6,0.000294118,850647,0.959448455
20743,243,196,6,6,0.000294118,850653,0.959455222
17355,174,156,6,6,0.000294118,850659,0.95946199
20492,717,31,6,6,0.000294118,850665,0.959468757
17443,618,331,6,6,0.000294118,850671,0.959475524
24712,170,236,6,6,0.000294118,850677,0.959482292
16052,29,95,6,6,0.000294118,850683,0.959489059
16064,5,77,6,6,0.000294118,850689,0.959495827
17440,56,507,6,6,0.000294118,850695,0.959502594
16077,479,22,6,6,0.000294118,850701,0.959509362
16081,164,34,6,6,0.000294118,850707,0.959516129
20464,721,95,6,6,0.000294118,850713,0.959522896
16170,507,236,6,6,0.000294118,850719,0.959529664
16249,398,261,6,6,0.000294118,850725,0.959536431
10896,19,6,6,6,0.000294118,850731,0.959543199
17279,164,302,6,6,0.000294118,850737,0.959549966
17269,394,14,6,6,0.000294118,850743,0.959556734
20715,13,544,6,6,0.000294118,850749,0.959563501
16257,12,593,6,6,0.000294118,850755,0.959570268
16263,31,609,6,6,0.000294118,850761,0.959577036
16268,204,535,6,6,0.000294118,850767,0.959583803
20516,517,682,6,6,0.000294118,850773,0.959590571
20705,160,354,6,6,0.000294118,850779,0.959597338
17240,6,587,6,6,0.000294118,850785,0.959604106
17298,522,195,6,6,0.000294118,850791,0.959610873
23667,668,130,6,6,0.000294118,850797,0.95961764
16184,682,14,6,6,0.000294118,850803,0.959624408
17332,609,463,6,6,0.000294118,850809,0.959631175
17324,6,85,6,6,0.000294118,850815,0.959637943
17317,511,427,6,6,0.000294118,850821,0.95964471
16201,302,174,6,6,0.000294118,850827,0.959651478
17314,334,475,6,6,0.000294118,850833,0.959658245
17311,593,522,6,6,0.000294118,850839,0.959665012
17309,141,105,6,6,0.000294118,850845,0.95967178
16204,380,23,6,6,0.000294118,850851,0.959678547
16212,2,117,6,6,0.000294118,850857,0.959685315
24548,29,674,6,6,0.000294118,850863,0.959692082
16025,207,33,6,6,0.000294118,850869,0.95969885
20803,560,224,6,6,0.000294118,850875,0.959705617
15838,638,614,6,6,0.000294118,850881,0.959712384
17671,479,618,6,6,0.000294118,850887,0.959719152
17607,164,385,6,6,0.000294118,850893,0.959725919
15872,443,64,6,6,0.000294118,850899,0.959732687
15875,314,492,6,6,0.000294118,850905,0.959739454
15809,543,427,6,6,0.000294118,850911,0.959746222
10667,34,593,6,6,0.000294118,850917,0.959752989
15877,3,682,6,6,0.000294118,850923,0.959759756
17717,14,264,6,6,0.000294118,850929,0.959766524
17716,632,439,6,6,0.000294118,850935,0.959773291
17714,103,15,6,6,0.000294118,850941,0.959780059
17713,544,30,6,6,0.000294118,850947,0.959786826
17712,20,507,6,6,0.000294118,850953,0.959793594
17710,243,528,6,6,0.000294118,850959,0.959800361
15767,195,582,6,6,0.000294118,850965,0.959807128
17698,552,614,6,6,0.000294118,850971,0.959813896
20812,463,714,6,6,0.000294118,850977,0.959820663
17688,668,498,6,6,0.000294118,850983,0.959827431
17685,332,394,6,6,0.000294118,850989,0.959834198
17684,97,121,6,6,0.000294118,850995,0.959840965
17602,250,34,6,6,0.000294118,851001,0.959847733
15879,614,560,6,6,0.000294118,851007,0.9598545
23519,242,560,6,6,0.000294118,851013,0.959861268
17507,596,20,6,6,0.000294118,851019,0.959868035
17531,48,552,6,6,0.000294118,851025,0.959874803
15956,497,313,6,6,0.000294118,851031,0.95988157
15957,482,105,6,6,0.000294118,851037,0.959888337
17508,562,155,6,6,0.000294118,851043,0.959895105
15974,219,328,6,6,0.000294118,851049,0.959901872
20452,90,558,6,6,0.000294118,851055,0.95990864
17502,295,290,6,6,0.000294118,851061,0.959915407
15994,171,123,6,6,0.000294118,851067,0.959922175
20766,167,663,6,6,0.000294118,851073,0.959928942
17481,439,596,6,6,0.000294118,851079,0.959935709
20439,32,269,6,6,0.000294118,851085,0.959942477
20783,528,307,6,6,0.000294118,851091,0.959949244
17594,342,314,6,6,0.000294118,851097,0.959956012
15885,605,501,6,6,0.000294118,851103,0.959962779
24926,126,105,6,6,0.000294118,851109,0.959969547
15906,307,265,6,6,0.000294118,851115,0.959976314
17563,2,181,6,6,0.000294118,851121,0.959983081
17561,528,295,6,6,0.000294118,851127,0.959989849
17560,242,48,6,6,0.000294118,851133,0.959996616
15930,593,95,6,6,0.000294118,851139,0.960003384
24890,171,328,6,6,0.000294118,851145,0.960010151
16912,475,207,6,6,0.000294118,851151,0.960016919
20583,439,497,6,6,0.000294118,851157,0.960023686
24287,85,443,6,6,0.000294118,851163,0.960030453
16927,124,582,6,6,0.000294118,851169,0.960037221
16623,473,624,6,6,0.000294118,851175,0.960043988
16918,463,23,6,6,0.000294118,851181,0.960050756
16941,16,652,6,6,0.000294118,851187,0.960057523
16649,133,141,6,6,0.000294118,851193,0.960064291
16663,379,126,6,6,0.000294118,851199,0.960071058
24240,544,618,6,6,0.000294118,851205,0.960077825
20597,717,348,6,6,0.000294118,851211,0.960084593
16879,48,195,6,6,0.000294118,851217,0.96009136
24313,48,494,6,6,0.000294118,851223,0.960098128
16942,193,335,6,6,0.000294118,851229,0.960104895
16987,517,723,6,6,0.000294118,851235,0.960111663
16982,50,145,6,6,0.000294118,851241,0.96011843
16551,11,511,6,6,0.000294118,851247,0.960125197
16565,307,64,6,6,0.000294118,851253,0.960131965
24327,85,264,6,6,0.000294118,851259,0.960138732
16596,409,230,6,6,0.000294118,851265,0.9601455
16594,328,64,6,6,0.000294118,851271,0.960152267
16785,313,163,6,6,0.000294118,851277,0.960159035
20620,593,479,6,6,0.000294118,851283,0.960165802
16808,11,723,6,6,0.000294118,851289,0.960172569
20619,458,14,6,6,0.000294118,851295,0.960179337
20615,5,609,6,6,0.000294118,851301,0.960186104
24149,196,717,6,6,0.000294118,851307,0.960192872
16765,624,582,6,6,0.000294118,851313,0.960199639
16774,11,605,6,6,0.000294118,851319,0.960206406
16769,414,145,6,6,0.000294118,851325,0.960213174
24045,498,409,6,6,0.000294118,851331,0.960219941
16854,311,163,6,6,0.000294118,851337,0.960226709
16850,342,380,6,6,0.000294118,851343,0.960233476
16843,334,529,6,6,0.000294118,851349,0.960240244
16723,588,155,6,6,0.000294118,851355,0.960247011
11139,397,689,6,6,0.000294118,851361,0.960253778
16823,640,164,6,6,0.000294118,851367,0.960260546
20609,131,163,6,6,0.000294118,851373,0.960267313
24110,121,479,6,6,0.000294118,851379,0.960274081
16527,708,164,6,6,0.000294118,851385,0.960280848
17232,250,54,6,6,0.000294118,851391,0.960287616
17157,261,32,6,6,0.000294118,851397,0.960294383
17174,56,383,6,6,0.000294118,851403,0.96030115
24460,80,701,6,6,0.000294118,851409,0.960307918
16357,473,193,6,6,0.000294118,851415,0.960314685
16337,171,614,6,6,0.000294118,851421,0.960321453
20541,618,107,6,6,0.000294118,851427,0.96032822
16361,640,661,6,6,0.000294118,851433,0.960334988
17136,16,383,6,6,0.000294118,851439,0.960341755
17133,10,409,6,6,0.000294118,851445,0.960348522
17132,331,448,6,6,0.000294118,851451,0.96035529
16405,20,130,6,6,0.000294118,851457,0.960362057
16302,174,295,6,6,0.000294118,851463,0.960368825
16283,204,552,6,6,0.000294118,851469,0.960375592
16287,29,379,6,6,0.000294118,851475,0.96038236
24505,126,522,6,6,0.000294118,851481,0.960389127
24488,668,528,6,6,0.000294118,851487,0.960395894
17206,274,163,6,6,0.000294118,851493,0.960402662
17205,347,121,6,6,0.000294118,851499,0.960409429
17202,50,265,6,6,0.000294118,851505,0.960416197
16316,409,398,6,6,0.000294118,851511,0.960422964
16332,367,562,6,6,0.000294118,851517,0.960429732
16403,105,175,6,6,0.000294118,851523,0.960436499
17119,463,683,6,6,0.000294118,851529,0.960443266
20573,140,528,6,6,0.000294118,851535,0.960450034
17041,558,364,6,6,0.000294118,851541,0.960456801
23946,708,720,6,6,0.000294118,851547,0.960463569
17025,646,11,6,6,0.000294118,851553,0.960470336
16470,448,313,6,6,0.000294118,851559,0.960477104
16502,609,6,6,6,0.000294118,851565,0.960483871
17006,56,20,6,6,0.000294118,851571,0.960490638
17003,12,15,6,6,0.000294118,851577,0.960497406
17052,123,195,6,6,0.000294118,851583,0.960504173
16469,140,398,6,6,0.000294118,851589,0.960510941
17109,313,193,6,6,0.000294118,851595,0.960517708
17092,335,290,6,6,0.000294118,851601,0.960524476
17103,353,64,6,6,0.000294118,851607,0.960531243
17087,655,6,6,6,0.000294118,851613,0.96053801
16428,107,493,6,6,0.000294118,851619,0.960544778
17083,661,123,6,6,0.000294118,851625,0.960551545
16441,439,348,6,6,0.000294118,851631,0.960558313
16443,507,535,6,6,0.000294118,851637,0.96056508
20815,443,195,6,6,0.000294118,851643,0.960571848
15588,22,354,6,6,0.000294118,851649,0.960578615
15629,140,404,6,6,0.000294118,851655,0.960585382
17811,582,23,6,6,0.000294118,851661,0.96059215
15630,525,314,6,6,0.000294118,851667,0.960598917
23309,121,552,6,6,0.000294118,851673,0.960605685
17733,274,30,6,6,0.000294118,851679,0.960612452
17740,331,23,6,6,0.000294118,851685,0.960619219
17812,131,174,6,6,0.000294118,851691,0.960625987
15747,507,638,6,6,0.000294118,851697,0.960632754
15732,525,9,6,6,0.000294118,851703,0.960639522
10553,393,265,6,6,0.000294118,851709,0.960646289
15546,475,29,6,6,0.000294118,851715,0.960653057
20850,517,482,6,6,0.000294118,851721,0.960659824
15720,97,632,6,6,0.000294118,851727,0.960666591
20387,26,160,6,6,0.000294118,851733,0.960673359
17856,385,502,6,6,0.000294118,851739,0.960680126
23296,701,126,6,6,0.000294118,851745,0.960686894
17807,535,661,6,6,0.000294118,851751,0.960693661
23307,219,652,6,6,0.000294118,851757,0.960700429
17880,605,274,6,6,0.000294118,851763,0.960707196
20844,367,23,6,6,0.000294118,851769,0.960713963
15573,404,6,6,6,0.000294118,851775,0.960720731
23278,632,294,6,6,0.000294118,851781,0.960727498
17883,265,663,6,6,0.000294118,851787,0.960734266
17871,354,140,6,6,0.000294118,851793,0.960741033
15542,50,250,6,6,0.000294118,851799,0.960747801
17762,207,522,6,6,0.000294118,851805,0.960754568
20817,307,528,6,6,0.000294118,851811,0.960761335
20833,498,1,6,6,0.000294118,851817,0.960768103
17755,682,50,6,6,0.000294118,851823,0.96077487
15593,246,394,6,6,0.000294118,851829,0.960781638
15527,242,398,6,6,0.000294118,851835,0.960788405
15537,178,708,6,6,0.000294118,851841,0.960795173
15552,56,708,6,6,0.000294118,851847,0.96080194
17750,280,174,6,6,0.000294118,851853,0.960808707
17926,501,632,6,6,0.000294118,851859,0.960815475
17799,10,503,6,6,0.000294118,851865,0.960822242
17862,25,535,6,6,0.000294118,851871,0.96082901
20372,50,723,6,6,0.000294118,851877,0.960835777
17891,593,414,6,6,0.000294118,851883,0.960842545
10591,443,117,6,6,0.000294118,851889,0.960849312
15530,443,30,6,6,0.000294118,851895,0.960856079
11794,501,683,6,6,0.000294118,851901,0.960862847
23234,121,427,6,6,0.000294118,851907,0.960869614
23314,193,274,6,6,0.000294118,851913,0.960876382
20367,158,385,6,6,0.000294118,851919,0.960883149
15525,529,463,6,6,0.000294118,851925,0.960889917
17793,479,290,11,5,0.000539216,851936,0.960902323
16072,294,348,11,5,0.000539216,851947,0.96091473
17477,674,56,10,5,0.000490196,851957,0.960926009
15394,514,48,10,5,0.000490196,851967,0.960937289
18592,171,586,10,5,0.000490196,851977,0.960948568
19647,236,618,10,5,0.000490196,851987,0.960959847
12426,27,525,10,5,0.000490196,851997,0.960971126
13264,174,123,10,5,0.000490196,852007,0.960982405
10714,497,302,10,5,0.000490196,852017,0.960993684
11796,618,174,10,5,0.000490196,852027,0.961004963
13651,493,230,9,5,0.000441176,852036,0.961015114
11652,34,586,9,5,0.000441176,852045,0.961025265
20379,265,328,9,5,0.000441176,852054,0.961035416
16988,347,562,9,5,0.000441176,852063,0.961045567
15397,721,522,9,5,0.000441176,852072,0.961055718
18018,1,674,9,5,0.000441176,852081,0.96106587
20212,178,9,9,5,0.000441176,852090,0.961076021
21389,121,443,9,5,0.000441176,852099,0.961086172
15506,544,511,9,5,0.000441176,852108,0.961096323
12579,609,479,9,5,0.000441176,852117,0.961106474
14668,95,560,9,5,0.000441176,852126,0.961116625
19002,596,12,9,5,0.000441176,852135,0.961126776
18782,703,6,9,5,0.000441176,852144,0.961136928
19285,618,170,9,5,0.000441176,852153,0.961147079
17008,164,295,9,5,0.000441176,852162,0.96115723
13926,307,5,9,5,0.000441176,852171,0.961167381
17663,26,392,8,5,0.000392157,852179,0.961176404
10509,609,522,8,5,0.000392157,852187,0.961185427
17704,673,560,8,5,0.000392157,852195,0.961194451
15715,133,48,8,5,0.000392157,852203,0.961203474
19900,85,528,8,5,0.000392157,852211,0.961212497
12601,16,618,8,5,0.000392157,852219,0.96122152
16398,141,16,8,5,0.000392157,852227,0.961230544
17376,155,582,8,5,0.000392157,852235,0.961239567
11996,618,230,8,5,0.000392157,852243,0.96124859
12852,439,558,8,5,0.000392157,852251,0.961257613
19802,84,181,8,5,0.000392157,852259,0.961266637
17497,398,640,8,5,0.000392157,852267,0.96127566
20722,439,501,8,5,0.000392157,852275,0.961284683
12194,30,394,8,5,0.000392157,852283,0.961293706
18544,117,689,8,5,0.000392157,852291,0.96130273
18521,295,569,8,5,0.000392157,852299,0.961311753
10710,638,30,8,5,0.000392157,852307,0.961320776
18355,31,243,8,5,0.000392157,852315,0.961329799
19287,427,170,8,5,0.000392157,852323,0.961338822
19280,236,673,8,5,0.000392157,852331,0.961347846
19273,48,193,8,5,0.000392157,852339,0.961356869
14188,552,689,8,5,0.000392157,852347,0.961365892
16806,588,409,8,5,0.000392157,852355,0.961374915
22435,571,31,8,5,0.000392157,852363,0.961383939
18852,48,560,8,5,0.000392157,852371,0.961392962
18704,385,95,8,5,0.000392157,852379,0.961401985
18576,517,364,8,5,0.000392157,852387,0.961411008
14584,280,140,8,5,0.000392157,852395,0.961420032
22497,569,638,8,5,0.000392157,852403,0.961429055
14077,517,97,8,5,0.000392157,852411,0.961438078
19584,328,145,8,5,0.000392157,852419,0.961447101
15477,632,195,8,5,0.000392157,852427,0.961456125
16531,224,246,8,5,0.000392157,852435,0.961465148
15417,638,126,8,5,0.000392157,852443,0.961474171
17893,493,522,8,5,0.000392157,852451,0.961483194
13335,11,640,8,5,0.000392157,852459,0.961492217
13510,668,479,8,5,0.000392157,852467,0.961501241
18192,354,673,8,5,0.000392157,852475,0.961510264
18227,507,130,8,5,0.000392157,852483,0.961519287
16561,689,141,8,5,0.000392157,852491,0.96152831
20220,632,404,7,5,0.000343137,852498,0.961536206
16805,269,331,7,5,0.000343137,852505,0.961544101
24073,250,482,7,5,0.000343137,852512,0.961551996
16931,552,264,7,5,0.000343137,852519,0.961559892
20151,463,502,7,5,0.000343137,852526,0.961567787
17029,145,618,7,5,0.000343137,852533,0.961575682
19956,663,13,7,5,0.000343137,852540,0.961583578
21040,164,439,7,5,0.000343137,852547,0.961591473
17115,593,471,7,5,0.000343137,852554,0.961599368
16983,130,12,7,5,0.000343137,852561,0.961607264
16971,593,97,7,5,0.000343137,852568,0.961615159
21202,141,529,7,5,0.000343137,852575,0.961623054
20138,29,2,7,5,0.000343137,852582,0.96163095
16959,609,632,7,5,0.000343137,852589,0.961638845
20114,140,31,7,5,0.000343137,852596,0.96164674
16943,492,586,7,5,0.000343137,852603,0.961654636
21164,204,571,7,5,0.000343137,852610,0.961662531
16811,383,204,7,5,0.000343137,852617,0.961670426
20238,701,475,7,5,0.000343137,852624,0.961678322
20980,364,463,7,5,0.000343137,852631,0.961686217
16970,202,14,7,5,0.000343137,852638,0.961694112
22246,614,54,7,5,0.000343137,852645,0.961702008
19330,497,23,7,5,0.000343137,852652,0.961709903
21905,364,640,7,5,0.000343137,852659,0.961717798
21915,126,689,7,5,0.000343137,852666,0.961725694
21831,121,463,7,5,0.000343137,852673,0.961733589
18462,353,618,7,5,0.000343137,852680,0.961741484
18450,586,714,7,5,0.000343137,852687,0.96174938
18432,404,528,7,5,0.000343137,852694,0.961757275
18429,103,219,7,5,0.000343137,852701,0.96176517
19462,22,156,7,5,0.000343137,852708,0.961773066
18127,544,14,7,5,0.000343137,852715,0.961780961
19508,632,683,7,5,0.000343137,852722,0.961788856
18092,721,250,7,5,0.000343137,852729,0.961796752
19452,13,156,7,5,0.000343137,852736,0.961804647
18150,171,609,7,5,0.000343137,852743,0.961812542
22892,328,156,7,5,0.000343137,852750,0.961820438
20759,31,427,7,5,0.000343137,852757,0.961828333
19001,117,50,7,5,0.000343137,852764,0.961836228
19022,596,29,7,5,0.000343137,852771,0.961844124
19047,394,126,7,5,0.000343137,852778,0.961852019
19063,618,443,7,5,0.000343137,852785,0.961859914
18913,22,723,7,5,0.000343137,852792,0.96186781
18872,497,640,7,5,0.000343137,852799,0.961875705
18861,133,552,7,5,0.000343137,852806,0.9618836
18859,717,32,7,5,0.000343137,852813,0.961891496
18809,347,497,7,5,0.000343137,852820,0.961899391
22183,605,593,7,5,0.000343137,852827,0.961907286
18702,562,364,7,5,0.000343137,852834,0.961915182
18549,171,552,7,5,0.000343137,852841,0.961923077
19161,334,130,7,5,0.000343137,852848,0.961930972
19186,674,503,7,5,0.000343137,852855,0.961938868
22022,121,310,7,5,0.000343137,852862,0.961946763
18482,517,640,7,5,0.000343137,852869,0.961954658
22460,22,50,7,5,0.000343137,852876,0.961962554
19122,347,56,7,5,0.000343137,852883,0.961970449
22565,171,178,7,5,0.000343137,852890,0.961978344
18589,618,397,7,5,0.000343137,852897,0.96198624
18073,156,155,7,5,0.000343137,852904,0.961994135
20340,310,492,7,5,0.000343137,852911,0.96200203
23521,230,43,7,5,0.000343137,852918,0.962009926
17466,482,335,7,5,0.000343137,852925,0.962017821
19821,427,689,7,5,0.000343137,852932,0.962025716
17622,114,497,7,5,0.000343137,852939,0.962033612
19799,43,170,7,5,0.000343137,852946,0.962041507
23439,294,2,7,5,0.000343137,852953,0.962049402
17286,84,20,7,5,0.000343137,852960,0.962057298
17259,511,77,7,5,0.000343137,852967,0.962065193
17250,243,723,7,5,0.000343137,852974,0.962073088
17306,535,646,7,5,0.000343137,852981,0.962080984
21282,121,439,7,5,0.000343137,852988,0.962088879
17230,398,14,7,5,0.000343137,852995,0.962096774
17183,265,674,7,5,0.000343137,853002,0.96210467
17181,404,501,7,5,0.000343137,853009,0.962112565
21329,380,668,7,5,0.000343137,853016,0.96212046
17359,701,588,7,5,0.000343137,853023,0.962128356
17329,97,562,7,5,0.000343137,853030,0.962136251
17933,261,535,7,5,0.000343137,853037,0.962144146
17916,219,714,7,5,0.000343137,853044,0.962152042
23204,463,409,7,5,0.000343137,853051,0.962159937
21589,131,571,7,5,0.000343137,853058,0.962167832
18060,543,25,7,5,0.000343137,853065,0.962175727
18024,145,569,7,5,0.000343137,853072,0.962183623
17989,427,614,7,5,0.000343137,853079,0.962191518
17987,404,463,7,5,0.000343137,853086,0.962199413
17848,264,250,7,5,0.000343137,853093,0.962207309
20361,68,720,7,5,0.000343137,853100,0.962215204
17687,31,164,7,5,0.000343137,853107,0.962223099
19675,439,364,7,5,0.000343137,853114,0.962230995
21537,264,6,7,5,0.000343137,853121,0.96223889
17814,721,33,7,5,0.000343137,853128,0.962246785
21529,502,552,7,5,0.000343137,853135,0.962254681
17805,701,16,7,5,0.000343137,853142,0.962262576
20847,2,609,7,5,0.000343137,853149,0.962270471
11369,243,6,7,5,0.000343137,853156,0.962278367
13783,529,663,7,5,0.000343137,853163,0.962286262
16354,97,2,7,5,0.000343137,853170,0.962294157
10937,97,145,7,5,0.000343137,853177,0.962302053
15852,544,243,7,5,0.000343137,853184,0.962309948
12285,699,314,7,5,0.000343137,853191,0.962317843
15813,54,379,7,5,0.000343137,853198,0.962325739
12290,721,25,7,5,0.000343137,853205,0.962333634
16482,446,32,7,5,0.000343137,853212,0.962341529
15135,280,587,7,5,0.000343137,853219,0.962349425
13540,97,34,7,5,0.000343137,853226,0.96235732
15727,708,689,7,5,0.000343137,853233,0.962365215
15724,167,158,7,5,0.000343137,853240,0.962373111
16471,393,22,7,5,0.000343137,853247,0.962381006
13546,145,64,7,5,0.000343137,853254,0.962388901
13630,446,196,7,5,0.000343137,853261,0.962396797
13629,353,20,7,5,0.000343137,853268,0.962404692
12011,2,158,7,5,0.000343137,853275,0.962412587
14599,20,202,7,5,0.000343137,853282,0.962420483
12084,250,6,7,5,0.000343137,853289,0.962428378
16127,114,14,7,5,0.000343137,853296,0.962436273
16019,196,107,7,5,0.000343137,853303,0.962444169
16028,699,48,7,5,0.000343137,853310,0.962452064
14482,383,638,7,5,0.000343137,853317,0.962459959
14468,674,661,7,5,0.000343137,853324,0.962467855
11449,501,196,7,5,0.000343137,853331,0.96247575
24546,614,178,7,5,0.000343137,853338,0.962483645
12073,302,156,7,5,0.000343137,853345,0.962491541
14821,493,310,7,5,0.000343137,853352,0.962499436
16200,22,596,7,5,0.000343137,853359,0.962507331
14278,471,385,7,5,0.000343137,853366,0.962515227
24610,34,178,7,5,0.000343137,853373,0.962523122
10106,25,334,7,5,0.000343137,853380,0.962531017
14221,25,145,7,5,0.000343137,853387,0.962538913
14199,721,242,7,5,0.000343137,853394,0.962546808
16730,20,236,7,5,0.000343137,853401,0.962554703
15619,164,562,7,5,0.000343137,853408,0.962562599
16608,663,571,7,5,0.000343137,853415,0.962570494
12779,95,64,7,5,0.000343137,853422,0.962578389
12794,514,313,7,5,0.000343137,853429,0.962586285
15649,295,242,7,5,0.000343137,853436,0.96259418
16735,632,614,7,5,0.000343137,853443,0.962602075
15410,160,9,7,5,0.000343137,853450,0.962609971
16644,64,105,7,5,0.000343137,853457,0.962617866
9329,90,80,7,5,0.000343137,853464,0.962625761
16505,141,394,7,5,0.000343137,853471,0.962633657
16745,497,723,7,5,0.000343137,853478,0.962641552
15474,493,379,7,5,0.000343137,853485,0.962649447
16522,497,562,7,5,0.000343137,853492,0.962657343
15206,14,674,7,5,0.000343137,853499,0.962665238
16493,77,448,7,5,0.000343137,853506,0.962673133
14735,193,582,6,5,0.000294118,853512,0.962679901
14527,682,48,6,5,0.000294118,853518,0.962686668
20331,605,30,6,5,0.000294118,853524,0.962693436
17966,689,170,6,5,0.000294118,853530,0.962700203
14727,261,529,6,5,0.000294118,853536,0.96270697
15487,409,4,6,5,0.000294118,853542,0.962713738
20164,264,68,6,5,0.000294118,853548,0.962720505
20877,596,294,6,5,0.000294118,853554,0.962727273
17971,655,427,6,5,0.000294118,853560,0.96273404
15464,398,246,6,5,0.000294118,853566,0.962740808
17991,131,175,6,5,0.000294118,853572,0.962747575
21022,663,290,6,5,0.000294118,853578,0.962754342
14579,404,385,6,5,0.000294118,853584,0.96276111
22468,103,14,6,5,0.000294118,853590,0.962767877
23099,124,475,6,5,0.000294118,853596,0.962774645
18660,11,507,6,5,0.000294118,853602,0.962781412
18656,16,195,6,5,0.000294118,853608,0.96278818
14585,479,508,6,5,0.000294118,853614,0.962794947
18640,195,14,6,5,0.000294118,853620,0.962801714
20338,167,335,6,5,0.000294118,853626,0.962808482
18650,246,236,6,5,0.000294118,853632,0.962815249
14566,12,313,6,5,0.000294118,853638,0.962822017
17972,265,6,6,5,0.000294118,853644,0.962828784
14543,562,121,6,5,0.000294118,853650,0.962835552
21051,155,529,6,5,0.000294118,853656,0.962842319
18646,367,508,6,5,0.000294118,853662,0.962849086
23105,121,311,6,5,0.000294118,853668,0.962855854
17997,394,708,6,5,0.000294118,853674,0.962862621
20867,347,618,6,5,0.000294118,853680,0.962869389
18585,719,310,6,5,0.000294118,853686,0.962876156
14674,264,414,6,5,0.000294118,853692,0.962882924
22574,348,124,6,5,0.000294118,853698,0.962889691
14670,20,479,6,5,0.000294118,853704,0.962896458
18596,347,609,6,5,0.000294118,853710,0.962903226
14669,77,137,6,5,0.000294118,853716,0.962909993
15456,265,130,6,5,0.000294118,853722,0.962916761
18156,511,121,6,5,0.000294118,853728,0.962923528
15231,9,174,6,5,0.000294118,853734,0.962930296
22813,124,9,6,5,0.000294118,853740,0.962937063
15082,502,50,6,5,0.000294118,853746,0.96294383
18159,552,514,6,5,0.000294118,853752,0.962950598
18161,544,475,6,5,0.000294118,853758,0.962957365
15226,195,196,6,5,0.000294118,853764,0.962964133
22801,605,463,6,5,0.000294118,853770,0.9629709
15047,117,33,6,5,0.000294118,853776,0.962977667
18135,33,448,6,5,0.000294118,853782,0.962984435
18318,164,6,6,5,0.000294118,853788,0.962991202
18142,517,596,6,5,0.000294118,853794,0.96299797
22831,156,5,6,5,0.000294118,853800,0.963004737
18279,448,30,6,5,0.000294118,853806,0.963011505
15148,25,156,6,5,0.000294118,853812,0.963018272
18241,571,558,6,5,0.000294118,853818,0.963025039
11969,674,20,6,5,0.000294118,853824,0.963031807
22883,2,294,6,5,0.000294118,853830,0.963038574
18200,140,427,6,5,0.000294118,853836,0.963045342
15185,265,535,6,5,0.000294118,853842,0.963052109
20939,178,558,6,5,0.000294118,853848,0.963058877
18244,295,364,6,5,0.000294118,853854,0.963065644
18246,171,2,6,5,0.000294118,853860,0.963072411
18170,114,646,6,5,0.000294118,853866,0.963079179
20265,202,632,6,5,0.000294118,853872,0.963085946
18183,123,167,6,5,0.000294118,853878,0.963092714
18185,498,4,6,5,0.000294118,853884,0.963099481
18252,242,471,6,5,0.000294118,853890,0.963106249
20271,13,164,6,5,0.000294118,853896,0.963113016
20285,20,501,6,5,0.000294118,853902,0.963119783
20311,250,204,6,5,0.000294118,853908,0.963126551
14844,471,242,6,5,0.000294118,853914,0.963133318
18456,609,22,6,5,0.000294118,853920,0.963140086
18452,528,95,6,5,0.000294118,853926,0.963146853
20308,342,473,6,5,0.000294118,853932,0.963153621
14902,398,605,6,5,0.000294118,853938,0.963160388
14812,522,29,6,5,0.000294118,853944,0.963167155
18038,196,250,6,5,0.000294118,853950,0.963173923
15387,682,535,6,5,0.000294118,853956,0.96318069
22645,482,95,6,5,0.000294118,853962,0.963187458
20993,354,552,6,5,0.000294118,853968,0.963194225
25670,164,593,6,5,0.000294118,853974,0.963200993
20230,178,224,6,5,0.000294118,853980,0.96320776
14996,514,364,6,5,0.000294118,853986,0.963214527
15008,471,246,6,5,0.000294118,853992,0.963221295
18365,668,14,6,5,0.000294118,853998,0.963228062
18364,202,6,6,5,0.000294118,854004,0.96323483
15341,475,56,6,5,0.000294118,854010,0.963241597
18435,19,475,6,5,0.000294118,854016,0.963248365
22699,404,714,6,5,0.000294118,854022,0.963255132
18083,84,90,6,5,0.000294118,854028,0.963261899
18428,26,587,6,5,0.000294118,854034,0.963268667
15313,133,609,6,5,0.000294118,854040,0.963275434
18415,544,385,6,5,0.000294118,854046,0.963282202
13318,439,638,6,5,0.000294118,854052,0.963288969
21677,544,2,6,5,0.000294118,854058,0.963295737
19547,50,562,6,5,0.000294118,854064,0.963302504
19537,596,507,6,5,0.000294118,854070,0.963309271
21717,23,596,6,5,0.000294118,854076,0.963316039
19521,130,23,6,5,0.000294118,854082,0.963322806
19516,13,26,6,5,0.000294118,854088,0.963329574
19510,517,507,6,5,0.000294118,854094,0.963336341
21220,347,501,6,5,0.000294118,854100,0.963343109
19558,207,34,6,5,0.000294118,854106,0.963349876
13181,394,4,6,5,0.000294118,854112,0.963356643
21616,140,34,6,5,0.000294118,854118,0.963363411
13196,242,393,6,5,0.000294118,854124,0.963370178
13198,261,588,6,5,0.000294118,854130,0.963376946
19975,140,145,6,5,0.000294118,854136,0.963383713
13230,475,236,6,5,0.000294118,854142,0.96339048
19570,717,16,6,5,0.000294118,854148,0.963397248
21211,130,673,6,5,0.000294118,854154,0.963404015
19413,219,140,6,5,0.000294118,854160,0.963410783
13598,529,3,6,5,0.000294118,854166,0.96341755
21849,5,167,6,5,0.000294118,854172,0.963424318
19394,684,131,6,5,0.000294118,854178,0.963431085
19377,20,544,6,5,0.000294118,854184,0.963437852
21189,714,394,6,5,0.000294118,854190,0.96344462
13634,50,121,6,5,0.000294118,854196,0.963451387
21882,367,13,6,5,0.000294118,854202,0.963458155
21883,721,117,6,5,0.000294118,854208,0.963464922
13652,97,640,6,5,0.000294118,854214,0.96347169
13674,30,535,6,5,0.000294118,854220,0.963478457
21810,342,582,6,5,0.000294118,854226,0.963485224
13465,507,141,6,5,0.000294118,854232,0.963491992
21749,502,528,6,5,0.000294118,854238,0.963498759
13423,302,265,6,5,0.000294118,854244,0.963505527
21208,475,618,6,5,0.000294118,854250,0.963512294
20005,114,543,6,5,0.000294118,854256,0.963519062
13436,708,171,6,5,0.000294118,854262,0.963525829
13466,640,544,6,5,0.000294118,854268,0.963532596
21804,684,207,6,5,0.000294118,854274,0.963539364
13480,29,313,6,5,0.000294118,854280,0.963546131
19435,394,593,6,5,0.000294118,854286,0.963552899
21802,167,145,6,5,0.000294118,854292,0.963559666
19636,19,123,6,5,0.000294118,854298,0.963566434
13147,54,105,6,5,0.000294118,854304,0.963573201
21371,26,613,6,5,0.000294118,854310,0.963579968
12739,471,587,6,5,0.000294118,854316,0.963586736
21373,114,30,6,5,0.000294118,854322,0.963593503
21390,290,31,6,5,0.000294118,854328,0.963600271
12868,618,123,6,5,0.000294118,854334,0.963607038
12914,26,593,6,5,0.000294118,854340,0.963613806
19920,140,3,6,5,0.000294118,854346,0.963620573
21404,314,576,6,5,0.000294118,854352,0.96362734
21409,219,4,6,5,0.000294118,854358,0.963634108
21416,155,508,6,5,0.000294118,854364,0.963640875
19771,274,155,6,5,0.000294118,854370,0.963647643
19899,141,380,6,5,0.000294118,854376,0.96365441
9690,4,393,6,5,0.000294118,854382,0.963661178
21311,261,475,6,5,0.000294118,854388,0.963667945
19855,668,6,6,5,0.000294118,854394,0.963674712
19878,145,5,6,5,0.000294118,854400,0.96368148
19877,64,558,6,5,0.000294118,854406,0.963688247
21344,721,97,6,5,0.000294118,854412,0.963695015
19866,31,398,6,5,0.000294118,854418,0.963701782
12685,618,353,6,5,0.000294118,854424,0.96370855
19859,588,175,6,5,0.000294118,854430,0.963715317
21355,701,463,6,5,0.000294118,854436,0.963722084
12959,501,95,6,5,0.000294118,854442,0.963728852
19688,632,624,6,5,0.000294118,854448,0.963735619
19668,668,3,6,5,0.000294118,854454,0.963742387
21558,562,414,6,5,0.000294118,854460,0.963749154
21559,626,145,6,5,0.000294118,854466,0.963755921
21258,661,558,6,5,0.000294118,854472,0.963762689
19648,158,364,6,5,0.000294118,854478,0.963769456
9871,605,26,6,5,0.000294118,854484,0.963776224
19643,544,121,6,5,0.000294118,854490,0.963782991
12543,43,638,6,5,0.000294118,854496,0.963789759
19760,20,448,6,5,0.000294118,854502,0.963796526
12984,609,261,6,5,0.000294118,854508,0.963803293
21462,167,379,6,5,0.000294118,854514,0.963810061
19934,31,661,6,5,0.000294118,854520,0.963816828
19739,414,560,6,5,0.000294118,854526,0.963823596
21495,167,274,6,5,0.000294118,854532,0.963830363
19941,207,689,6,5,0.000294118,854538,0.963837131
19723,164,95,6,5,0.000294118,854544,0.963843898
19946,535,140,6,5,0.000294118,854550,0.963850665
21903,661,77,6,5,0.000294118,854556,0.963857433
13697,473,156,6,5,0.000294118,854562,0.9638642
19334,242,196,6,5,0.000294118,854568,0.963870968
22219,613,97,6,5,0.000294118,854574,0.963877735
18935,15,502,6,5,0.000294118,854580,0.963884503
22225,5,404,6,5,0.000294118,854586,0.96389127
14284,501,64,6,5,0.000294118,854592,0.963898037
14285,498,155,6,5,0.000294118,854598,0.963904805
18923,68,202,6,5,0.000294118,854604,0.963911572
18914,261,385,6,5,0.000294118,854610,0.96391834
18901,332,558,6,5,0.000294118,854616,0.963925107
18895,328,2,6,5,0.000294118,854622,0.963931875
20118,479,714,6,5,0.000294118,854628,0.963938642
22199,354,103,6,5,0.000294118,854634,0.963945409
14195,31,508,6,5,0.000294118,854640,0.963952177
19032,684,473,6,5,0.000294118,854646,0.963958944
14159,673,439,6,5,0.000294118,854652,0.963965712
14172,230,155,6,5,0.000294118,854658,0.963972479
21110,13,170,6,5,0.000294118,854664,0.963979247
12208,394,295,6,5,0.000294118,854670,0.963986014
18967,385,307,6,5,0.000294118,854676,0.963992781
14255,250,714,6,5,0.000294118,854682,0.963999549
18965,54,353,6,5,0.000294118,854688,0.964006316
18774,655,507,6,5,0.000294118,854694,0.964013084
14436,219,560,6,5,0.000294118,854700,0.964019851
22336,605,23,6,5,0.000294118,854706,0.964026619
18787,367,503,6,5,0.000294118,854712,0.964033386
22365,158,175,6,5,0.000294118,854718,0.964040153
14473,19,196,6,5,0.000294118,854724,0.964046921
18752,27,202,6,5,0.000294118,854730,0.964053688
14502,133,497,6,5,0.000294118,854736,0.964060456
22407,392,385,6,5,0.000294118,854742,0.964067223
12117,379,613,6,5,0.000294118,854748,0.964073991
14511,95,164,6,5,0.000294118,854754,0.964080758
14435,380,294,6,5,0.000294118,854760,0.964087525
22320,290,230,6,5,0.000294118,854766,0.964094293
12189,107,64,6,5,0.000294118,854772,0.96410106
18860,614,508,6,5,0.000294118,854778,0.964107828
21095,114,502,6,5,0.000294118,854784,0.964114595
18849,310,174,6,5,0.000294118,854790,0.964121363
18834,310,193,6,5,0.000294118,854796,0.96412813
22303,2,552,6,5,0.000294118,854802,0.964134897
14423,543,397,6,5,0.000294118,854808,0.964141665
18830,404,502,6,5,0.000294118,854814,0.964148432
14434,471,586,6,5,0.000294118,854820,0.9641552
20101,19,674,6,5,0.000294118,854826,0.964161967
21982,517,25,6,5,0.000294118,854832,0.964168734
13856,242,95,6,5,0.000294118,854838,0.964175502
19236,22,167,6,5,0.000294118,854844,0.964182269
19234,117,145,6,5,0.000294118,854850,0.964189037
22010,15,571,6,5,0.000294118,854856,0.964195804
13898,367,261,6,5,0.000294118,854862,0.964202572
19188,14,624,6,5,0.000294118,854868,0.964209339
19261,392,10,6,5,0.000294118,854874,0.964216106
13721,492,582,6,5,0.000294118,854880,0.964222874
19320,708,397,6,5,0.000294118,854886,0.964229641
21170,661,522,6,5,0.000294118,854892,0.964236409
19308,50,164,6,5,0.000294118,854898,0.964243176
19274,522,319,6,5,0.000294118,854904,0.964249944
22046,562,383,6,5,0.000294118,854910,0.964256711
14138,586,6,6,5,0.000294118,854916,0.964263478
22095,511,517,6,5,0.000294118,854922,0.964270246
19086,708,367,6,5,0.000294118,854928,0.964277013
19079,354,544,6,5,0.000294118,854934,0.964283781
21120,609,593,6,5,0.000294118,854940,0.964290548
14051,624,123,6,5,0.000294118,854946,0.964297316
19174,280,160,6,5,0.000294118,854952,0.964304083
22050,50,497,6,5,0.000294118,854958,0.96431085
13940,501,97,6,5,0.000294118,854964,0.964317618
13956,683,394,6,5,0.000294118,854970,0.964324385
12283,31,236,6,5,0.000294118,854976,0.964331153
22061,141,588,6,5,0.000294118,854982,0.96433792
13964,269,158,6,5,0.000294118,854988,0.964344688
20078,33,246,6,5,0.000294118,854994,0.964351455
22070,43,54,6,5,0.000294118,855000,0.964358222
20617,708,26,6,5,0.000294118,855006,0.96436499
17409,25,114,6,5,0.000294118,855012,0.964371757
16094,394,723,6,5,0.000294118,855018,0.964378525
10850,33,528,6,5,0.000294118,855024,0.964385292
20484,328,29,6,5,0.000294118,855030,0.96439206
20739,655,383,6,5,0.000294118,855036,0.964398827
16153,632,508,6,5,0.000294118,855042,0.964405594
16089,507,543,6,5,0.000294118,855048,0.964412362
16086,250,593,6,5,0.000294118,855054,0.964419129
23528,261,501,6,5,0.000294118,855060,0.964425897
17464,708,596,6,5,0.000294118,855066,0.964432664
17460,295,25,6,5,0.000294118,855072,0.964439432
17457,334,141,6,5,0.000294118,855078,0.964446199
16056,11,261,6,5,0.000294118,855084,0.964452966
16074,242,164,6,5,0.000294118,855090,0.964459734
16078,243,479,6,5,0.000294118,855096,0.964466501
17436,497,543,6,5,0.000294118,855102,0.964473269
16082,394,246,6,5,0.000294118,855108,0.964480036
17344,138,26,6,5,0.000294118,855114,0.964486804
17342,471,655,6,5,0.000294118,855120,0.964493571
17277,334,54,6,5,0.000294118,855126,0.964500338
17272,145,682,6,5,0.000294118,855132,0.964507106
17297,475,54,6,5,0.000294118,855138,0.964513873
16262,130,4,6,5,0.000294118,855144,0.964520641
17244,682,497,6,5,0.000294118,855150,0.964527408
17318,196,103,6,5,0.000294118,855156,0.964534176
16187,689,307,6,5,0.000294118,855162,0.964540943
17323,164,502,6,5,0.000294118,855168,0.96454771
23671,588,332,6,5,0.000294118,855174,0.964554478
24580,348,133,6,5,0.000294118,855180,0.964561245
17299,353,493,6,5,0.000294118,855186,0.964568013
16205,22,265,6,5,0.000294118,855192,0.96457478
16030,398,54,6,5,0.000294118,855198,0.964581547
23522,202,558,6,5,0.000294118,855204,0.964588315
17635,30,207,6,5,0.000294118,855210,0.964595082
17666,174,126,6,5,0.000294118,855216,0.96460185
15827,133,236,6,5,0.000294118,855222,0.964608617
17647,334,463,6,5,0.000294118,855228,0.964615385
20801,439,264,6,5,0.000294118,855234,0.964622152
17637,5,543,6,5,0.000294118,855240,0.964628919
15846,156,174,6,5,0.000294118,855246,0.964635687
23396,20,576,6,5,0.000294118,855252,0.964642454
15853,207,32,6,5,0.000294118,855258,0.964649222
20795,103,663,6,5,0.000294118,855264,0.964655989
15867,624,640,6,5,0.000294118,855270,0.964662757
15779,544,236,6,5,0.000294118,855276,0.964669524
17676,393,682,6,5,0.000294118,855282,0.964676291
11682,522,20,6,5,0.000294118,855288,0.964683059
17683,174,171,6,5,0.000294118,855294,0.964689826
15795,265,313,6,5,0.000294118,855300,0.964696594
20775,19,313,6,5,0.000294118,855306,0.964703361
17534,90,219,6,5,0.000294118,855312,0.964710129
20447,202,473,6,5,0.000294118,855318,0.964716896
17543,4,640,6,5,0.000294118,855324,0.964723663
20453,103,708,6,5,0.000294118,855330,0.964730431
20765,77,319,6,5,0.000294118,855336,0.964737198
17483,295,714,6,5,0.000294118,855342,0.964743966
20778,302,624,6,5,0.000294118,855348,0.964750733
11633,397,12,6,5,0.000294118,855354,0.964757501
17586,19,20,6,5,0.000294118,855360,0.964764268
17585,204,507,6,5,0.000294118,855366,0.964771035
15904,655,414,6,5,0.000294118,855372,0.964777803
23452,427,155,6,5,0.000294118,855378,0.96478457
17574,503,310,6,5,0.000294118,855384,0.964791338
15913,655,682,6,5,0.000294118,855390,0.964798105
17235,33,714,6,5,0.000294118,855396,0.964804873
16908,535,683,6,5,0.000294118,855402,0.96481164
16671,10,613,6,5,0.000294118,855408,0.964818407
16687,501,20,6,5,0.000294118,855414,0.964825175
16870,196,171,6,5,0.000294118,855420,0.964831942
16578,517,586,6,5,0.000294118,855426,0.96483871
16537,114,683,6,5,0.000294118,855432,0.964845477
16538,13,334,6,5,0.000294118,855438,0.964852245
16546,638,242,6,5,0.000294118,855444,0.964859012
16964,367,163,6,5,0.000294118,855450,0.964865779
16593,311,494,6,5,0.000294118,855456,0.964872547
16953,43,439,6,5,0.000294118,855462,0.964879314
16952,138,131,6,5,0.000294118,855468,0.964886082
16697,720,313,6,5,0.000294118,855474,0.964892849
16703,632,236,6,5,0.000294118,855480,0.964899617
24359,443,701,6,5,0.000294118,855486,0.964906384
16803,719,204,6,5,0.000294118,855492,0.964913151
16746,586,364,6,5,0.000294118,855498,0.964919919
11161,640,2,6,5,0.000294118,855504,0.964926686
16788,507,196,6,5,0.000294118,855510,0.964933454
16766,310,482,6,5,0.000294118,855516,0.964940221
20616,347,22,6,5,0.000294118,855522,0.964946988
16744,535,29,6,5,0.000294118,855528,0.964953756
16810,175,27,6,5,0.000294118,855534,0.964960523
24076,117,562,6,5,0.000294118,855540,0.964967291
16863,475,13,6,5,0.000294118,855546,0.964974058
16860,20,497,6,5,0.000294118,855552,0.964980826
16708,632,264,6,5,0.000294118,855558,0.964987593
20610,458,663,6,5,0.000294118,855564,0.96499436
16725,394,30,6,5,0.000294118,855570,0.965001128
16727,404,348,6,5,0.000294118,855576,0.965007895
16532,265,242,6,5,0.000294118,855582,0.965014663
17173,427,414,6,5,0.000294118,855588,0.96502143
20687,23,11,6,5,0.000294118,855594,0.965028198
17163,295,103,6,5,0.000294118,855600,0.965034965
11337,103,335,6,5,0.000294118,855606,0.965041732
16355,514,68,6,5,0.000294118,855612,0.9650485
17151,535,20,6,5,0.000294118,855618,0.965055267
17145,624,302,6,5,0.000294118,855624,0.965062035
20689,684,15,6,5,0.000294118,855630,0.965068802
17179,522,383,6,5,0.000294118,855636,0.96507557
20522,31,156,6,5,0.000294118,855642,0.965082337
17226,699,224,6,5,0.000294118,855648,0.965089104
24499,668,207,6,5,0.000294118,855654,0.965095872
17207,394,34,6,5,0.000294118,855660,0.965102639
16333,311,103,6,5,0.000294118,855666,0.965109407
23789,242,34,6,5,0.000294118,855672,0.965116174
16492,5,84,6,5,0.000294118,855678,0.965122942
17051,682,501,6,5,0.000294118,855684,0.965129709
16472,295,618,6,5,0.000294118,855690,0.965136476
17044,22,264,6,5,0.000294118,855696,0.965143244
17033,458,68,6,5,0.000294118,855702,0.965150011
16490,482,123,6,5,0.000294118,855708,0.965156779
16508,138,498,6,5,0.000294118,855714,0.965163546
16515,56,2,6,5,0.000294118,855720,0.965170314
23977,348,85,6,5,0.000294118,855726,0.965177081
23982,544,294,6,5,0.000294118,855732,0.965183848
17001,632,243,6,5,0.000294118,855738,0.965190616
20552,290,335,6,5,0.000294118,855744,0.965197383
20553,544,708,6,5,0.000294118,855750,0.965204151
23860,354,43,6,5,0.000294118,855756,0.965210918
17093,193,354,6,5,0.000294118,855762,0.965217686
23897,30,383,6,5,0.000294118,855768,0.965224453
11098,4,586,6,5,0.000294118,855774,0.96523122
16463,502,3,6,5,0.000294118,855780,0.965237988
24647,684,170,6,5,0.000294118,855786,0.965244755
20824,250,511,6,5,0.000294118,855792,0.965251523
15622,265,511,6,5,0.000294118,855798,0.96525829
15545,383,307,6,5,0.000294118,855804,0.965265058
17920,414,30,6,5,0.000294118,855810,0.965271825
15654,380,207,6,5,0.000294118,855816,0.965278592
17865,497,114,6,5,0.000294118,855822,0.96528536
17730,261,498,6,5,0.000294118,855828,0.965292127
17902,34,514,6,5,0.000294118,855834,0.965298895
20369,2,529,6,5,0.000294118,855840,0.965305662
17738,354,5,6,5,0.000294118,855846,0.96531243
17803,314,458,6,5,0.000294118,855852,0.965319197
15695,11,56,6,5,0.000294118,855858,0.965325964
15691,494,311,6,5,0.000294118,855864,0.965332732
20356,242,6,6,5,0.000294118,855870,0.965339499
20383,5,614,6,5,0.000294118,855876,0.965346267
23223,684,348,6,5,0.000294118,855882,0.965353034
17767,13,354,6,5,0.000294118,855888,0.965359801
17819,458,335,6,5,0.000294118,855894,0.965366569
23147,124,171,6,5,0.000294118,855900,0.965373336
20816,68,261,6,5,0.000294118,855906,0.965380104
23196,683,348,6,5,0.000294118,855912,0.965386871
23310,719,145,6,5,0.000294118,855918,0.965393639
20855,64,196,6,5,0.000294118,855924,0.965400406
15730,383,164,6,5,0.000294118,855930,0.965407173
13757,310,246,5,5,0.000245098,855935,0.965412813
21949,160,141,5,5,0.000245098,855940,0.965418453
26344,342,463,5,5,0.000245098,855945,0.965424092
17128,383,471,5,5,0.000245098,855950,0.965429732
16400,97,497,5,5,0.000245098,855955,0.965435371
16409,613,473,5,5,0.000245098,855960,0.965441011
21951,385,501,5,5,0.000245098,855965,0.96544665
16407,593,562,5,5,0.000245098,855970,0.96545229
19357,23,16,5,5,0.000245098,855975,0.965457929
21965,114,164,5,5,0.000245098,855980,0.965463569
17120,463,195,5,5,0.000245098,855985,0.965469208
25392,3,43,5,5,0.000245098,855990,0.965474848
11768,280,246,5,5,0.000245098,855995,0.965480487
21960,103,632,5,5,0.000245098,856000,0.965486127
17851,54,9,5,5,0.000245098,856005,0.965491766
15348,167,302,5,5,0.000245098,856010,0.965497406
20041,682,562,5,5,0.000245098,856015,0.965503045
24441,13,605,5,5,0.000245098,856020,0.965508685
20051,463,13,5,5,0.000245098,856025,0.965514324
16384,133,3,5,5,0.000245098,856030,0.965519964
26373,34,503,5,5,0.000245098,856035,0.965525603
17152,11,714,5,5,0.000245098,856040,0.965531243
20675,380,332,5,5,0.000245098,856045,0.965536882
20677,14,393,5,5,0.000245098,856050,0.965542522
24458,224,342,5,5,0.000245098,856055,0.965548162
21922,1,265,5,5,0.000245098,856060,0.965553801
16362,439,114,5,5,0.000245098,856065,0.965559441
20678,117,414,5,5,0.000245098,856070,0.96556508
21181,295,163,5,5,0.000245098,856075,0.96557072
20312,502,156,5,5,0.000245098,856080,0.965576359
20545,9,269,5,5,0.000245098,856085,0.965581999
20896,20,242,5,5,0.000245098,856090,0.965587638
12337,439,95,5,5,0.000245098,856095,0.965593278
21942,224,124,5,5,0.000245098,856100,0.965598917
21929,497,708,5,5,0.000245098,856105,0.965604557
23230,517,294,5,5,0.000245098,856110,0.965610196
19332,624,723,5,5,0.000245098,856115,0.965615836
20680,668,20,5,5,0.000245098,856120,0.965621475
17153,274,14,5,5,0.000245098,856125,0.965627115
16389,638,164,5,5,0.000245098,856130,0.965632754
21864,652,380,5,5,0.000245098,856135,0.965638394
20672,714,498,5,5,0.000245098,856140,0.965644033
16429,163,230,5,5,0.000245098,856145,0.965649673
15379,682,274,5,5,0.000245098,856150,0.965655312
20666,393,683,5,5,0.000245098,856155,0.965660952
13539,720,314,5,5,0.000245098,856160,0.965666591
21800,11,613,5,5,0.000245098,856165,0.965672231
16433,379,1,5,5,0.000245098,856170,0.965677871
20842,552,117,5,5,0.000245098,856175,0.96568351
15380,2,498,5,5,0.000245098,856180,0.96568915
23874,202,224,5,5,0.000245098,856185,0.965694789
13550,398,501,5,5,0.000245098,856190,0.965700429
16411,2,141,5,5,0.000245098,856195,0.965706068
21779,54,50,5,5,0.000245098,856200,0.965711708
20881,193,720,5,5,0.000245098,856205,0.965717347
20007,97,167,5,5,0.000245098,856210,0.965722987
20562,511,385,5,5,0.000245098,856215,0.965728626
23920,334,605,5,5,0.000245098,856220,0.965734266
13483,207,9,5,5,0.000245098,856225,0.965739905
24391,158,668,5,5,0.000245098,856230,0.965745545
20011,493,3,5,5,0.000245098,856235,0.965751184
15589,638,5,5,5,0.000245098,856240,0.965756824
12395,638,529,5,5,0.000245098,856245,0.965762463
23905,64,250,5,5,0.000245098,856250,0.965768103
9965,264,314,5,5,0.000245098,856255,0.965773742
18057,475,414,5,5,0.000245098,856260,0.965779382
13569,699,80,5,5,0.000245098,856265,0.965785021
18066,646,224,5,5,0.000245098,856270,0.965790661
23844,64,2,5,5,0.000245098,856275,0.9657963
25420,124,313,5,5,0.000245098,856280,0.96580194
19378,274,171,5,5,0.000245098,856285,0.96580758
23840,124,463,5,5,0.000245098,856290,0.965813219
23839,446,13,5,5,0.000245098,856295,0.965818859
16422,367,493,5,5,0.000245098,856300,0.965824498
21873,701,224,5,5,0.000245098,856305,0.965830138
24435,124,427,5,5,0.000245098,856310,0.965835777
19369,479,43,5,5,0.000245098,856315,0.965841417
19368,84,171,5,5,0.000245098,856320,0.965847056
12346,640,29,5,5,0.000245098,856325,0.965852696
21192,684,562,5,5,0.000245098,856330,0.965858335
19390,618,5,5,5,0.000245098,856335,0.965863975
21829,475,482,5,5,0.000245098,856340,0.965869614
21830,19,522,5,5,0.000245098,856345,0.965875254
17098,3,587,5,5,0.000245098,856350,0.965880893
13588,609,307,5,5,0.000245098,856355,0.965886533
16420,525,11,5,5,0.000245098,856360,0.965892172
23861,156,4,5,5,0.000245098,856365,0.965897812
15590,264,393,5,5,0.000245098,856370,0.965903451
15363,243,562,5,5,0.000245098,856375,0.965909091
21845,552,502,5,5,0.000245098,856380,0.96591473
21193,482,310,5,5,0.000245098,856385,0.96592037
20886,117,682,5,5,0.000245098,856390,0.965926009
20024,171,264,5,5,0.000245098,856395,0.965931649
17107,335,138,5,5,0.000245098,856400,0.965937289
20058,347,141,5,5,0.000245098,856405,0.965942928
19263,19,204,5,5,0.000245098,856410,0.965948568
23240,624,508,5,5,0.000245098,856415,0.965954207
19154,473,90,5,5,0.000245098,856420,0.965959847
19152,661,310,5,5,0.000245098,856425,0.965965486
16273,196,544,5,5,0.000245098,856430,0.965971126
13974,160,80,5,5,0.000245098,856435,0.965976765
22068,29,517,5,5,0.000245098,856440,0.965982405
17247,1,385,5,5,0.000245098,856445,0.965988044
19142,6,265,5,5,0.000245098,856450,0.965993684
21144,668,443,5,5,0.000245098,856455,0.965999323
25458,207,328,5,5,0.000245098,856460,0.966004963
19135,164,107,5,5,0.000245098,856465,0.966010602
17253,708,178,5,5,0.000245098,856470,0.966016242
22073,19,640,5,5,0.000245098,856475,0.966021881
23726,167,638,5,5,0.000245098,856480,0.966027521
22074,414,170,5,5,0.000245098,856485,0.96603316
20899,130,175,5,5,0.000245098,856490,0.9660388
20084,219,1,5,5,0.000245098,856495,0.966044439
19179,50,130,5,5,0.000245098,856500,0.966050079
17223,3,508,5,5,0.000245098,856505,0.966055718
17224,4,385,5,5,0.000245098,856510,0.966061358
13917,543,264,5,5,0.000245098,856515,0.966066998
23003,458,145,5,5,0.000245098,856520,0.966072637
17836,529,160,5,5,0.000245098,856525,0.966078277
20697,668,121,5,5,0.000245098,856530,0.966083916
19169,242,609,5,5,0.000245098,856535,0.966089556
16275,493,473,5,5,0.000245098,856540,0.966095195
13937,207,475,5,5,0.000245098,856545,0.966100835
18112,178,310,5,5,0.000245098,856550,0.966106474
22053,195,224,5,5,0.000245098,856555,0.966112114
22055,15,652,5,5,0.000245098,856560,0.966117753
20382,414,682,5,5,0.000245098,856565,0.966123393
18124,97,655,5,5,0.000245098,856570,0.966129032
22103,236,294,5,5,0.000245098,856575,0.966134672
19083,494,397,5,5,0.000245098,856580,0.966140311
19082,264,261,5,5,0.000245098,856585,0.966145951
19080,439,15,5,5,0.000245098,856590,0.96615159
15272,170,582,5,5,0.000245098,856595,0.96615723
16251,280,12,5,5,0.000245098,856600,0.966162869
19099,97,501,5,5,0.000245098,856605,0.966168509
14031,30,586,5,5,0.000245098,856610,0.966174148
23724,1,25,5,5,0.000245098,856615,0.966179788
19114,618,50,5,5,0.000245098,856620,0.966185427
14039,295,264,5,5,0.000245098,856625,0.966191067
14042,123,294,5,5,0.000245098,856630,0.966196707
19108,195,353,5,5,0.000245098,856635,0.966202346
22092,364,439,5,5,0.000245098,856640,0.966207986
19104,380,492,5,5,0.000245098,856645,0.966213625
23710,25,640,5,5,0.000245098,856650,0.966219265
17265,236,1,5,5,0.000245098,856655,0.966224904
11377,265,404,5,5,0.000245098,856660,0.966230544
13915,673,587,5,5,0.000245098,856665,0.966236183
19286,719,632,5,5,0.000245098,856670,0.966241823
17180,302,167,5,5,0.000245098,856675,0.966247462
21987,80,175,5,5,0.000245098,856680,0.966253102
13820,331,652,5,5,0.000245098,856685,0.966258741
13821,446,105,5,5,0.000245098,856690,0.966264381
13832,475,605,5,5,0.000245098,856695,0.96627002
21994,202,16,5,5,0.000245098,856700,0.96627566
23016,618,114,5,5,0.000245098,856705,0.966281299
21996,721,313,5,5,0.000245098,856710,0.966286939
17185,230,493,5,5,0.000245098,856715,0.966292578
16329,501,163,5,5,0.000245098,856720,0.966298218
19242,525,68,5,5,0.000245098,856725,0.966303857
20529,552,661,5,5,0.000245098,856730,0.966309497
19240,97,56,5,5,0.000245098,856735,0.966315136
19239,514,714,5,5,0.000245098,856740,0.966320776
19238,22,68,5,5,0.000245098,856745,0.966326416
20528,562,482,5,5,0.000245098,856750,0.966332055
15336,3,126,5,5,0.000245098,856755,0.966337695
13868,20,156,5,5,0.000245098,856760,0.966343334
17162,25,140,5,5,0.000245098,856765,0.966348974
20535,246,385,5,5,0.000245098,856770,0.966354613
16339,242,385,5,5,0.000245098,856775,0.966360253
18085,12,97,5,5,0.000245098,856780,0.966365892
18086,609,163,5,5,0.000245098,856785,0.966371532
19269,383,414,5,5,0.000245098,856790,0.966377171
25422,160,511,5,5,0.000245098,856795,0.966382811
23023,624,367,5,5,0.000245098,856800,0.96638845
18046,398,409,5,5,0.000245098,856805,0.96639409
23794,133,632,5,5,0.000245098,856810,0.966399729
23004,174,193,5,5,0.000245098,856815,0.966405369
23010,14,290,5,5,0.000245098,856820,0.966411008
16303,398,689,5,5,0.000245098,856825,0.966416648
19200,502,414,5,5,0.000245098,856830,0.966422287
22037,380,43,5,5,0.000245098,856835,0.966427927
23247,131,684,5,5,0.000245098,856840,0.966433566
19194,689,404,5,5,0.000245098,856845,0.966439206
13910,655,307,5,5,0.000245098,856850,0.966444845
15304,196,655,5,5,0.000245098,856855,0.966450485
22040,207,708,5,5,0.000245098,856860,0.966456125
13912,655,543,5,5,0.000245098,856865,0.966461764
21152,364,529,5,5,0.000245098,856870,0.966467404
26223,626,27,5,5,0.000245098,856875,0.966473043
23015,9,43,5,5,0.000245098,856880,0.966478683
13875,3,507,5,5,0.000245098,856885,0.966484322
17198,475,544,5,5,0.000245098,856890,0.966489962
23014,525,502,5,5,0.000245098,856895,0.966495601
23786,719,219,5,5,0.000245098,856900,0.966501241
19223,398,22,5,5,0.000245098,856905,0.96650688
19221,609,683,5,5,0.000245098,856910,0.96651252
23011,605,269,5,5,0.000245098,856915,0.966518159
19219,439,529,5,5,0.000245098,856920,0.966523799
21154,348,332,5,5,0.000245098,856925,0.966529438
22016,126,473,5,5,0.000245098,856930,0.966535078
19214,31,529,5,5,0.000245098,856935,0.966540717
22018,246,97,5,5,0.000245098,856940,0.966546357
20660,164,723,5,5,0.000245098,856945,0.966551996
21772,379,23,5,5,0.000245098,856950,0.966557636
19762,507,265,5,5,0.000245098,856955,0.966563275
21451,1,448,5,5,0.000245098,856960,0.966568915
19758,242,347,5,5,0.000245098,856965,0.966574554
21456,632,25,5,5,0.000245098,856970,0.966580194
19751,475,560,5,5,0.000245098,856975,0.966585834
19750,274,427,5,5,0.000245098,856980,0.966591473
9839,4,54,5,5,0.000245098,856985,0.966597113
19932,618,1,5,5,0.000245098,856990,0.966602752
13024,673,117,5,5,0.000245098,856995,0.966608392
17906,529,31,5,5,0.000245098,857000,0.966614031
20599,714,367,5,5,0.000245098,857005,0.966619671
16873,552,171,5,5,0.000245098,857010,0.96662531
21472,529,383,5,5,0.000245098,857015,0.96663095
24041,605,332,5,5,0.000245098,857020,0.966636589
21280,613,11,5,5,0.000245098,857025,0.966642229
15385,624,95,5,5,0.000245098,857030,0.966647868
12537,335,193,5,5,0.000245098,857035,0.966653508
19921,230,332,5,5,0.000245098,857040,0.966659147
19785,138,11,5,5,0.000245098,857045,0.966664787
17913,33,624,5,5,0.000245098,857050,0.966670426
21284,204,175,5,5,0.000245098,857055,0.966676066
19781,243,56,5,5,0.000245098,857060,0.966681705
20629,48,103,5,5,0.000245098,857065,0.966687345
21418,2,156,5,5,0.000245098,857070,0.966692984
19776,156,195,5,5,0.000245098,857075,0.966698624
19774,353,661,5,5,0.000245098,857080,0.966704263
21427,27,719,5,5,0.000245098,857085,0.966709903
21429,13,443,5,5,0.000245098,857090,0.966715543
16706,2,243,5,5,0.000245098,857095,0.966721182
17911,502,313,5,5,0.000245098,857100,0.966726822
19923,498,5,5,5,0.000245098,857105,0.966732461
24048,618,586,5,5,0.000245098,857110,0.966738101
24204,528,507,5,5,0.000245098,857115,0.96674374
19737,195,167,5,5,0.000245098,857120,0.96674938
21514,528,482,5,5,0.000245098,857125,0.966755019
23185,131,290,5,5,0.000245098,857130,0.966760659
19704,334,274,5,5,0.000245098,857135,0.966766298
21517,507,609,5,5,0.000245098,857140,0.966771938
21521,497,171,5,5,0.000245098,857145,0.966777577
19948,48,140,5,5,0.000245098,857150,0.966783217
19696,13,50,5,5,0.000245098,857155,0.966788856
26815,624,552,5,5,0.000245098,857160,0.966794496
21263,16,174,5,5,0.000245098,857165,0.966800135
9299,4,32,5,5,0.000245098,857170,0.966805775
16639,514,22,5,5,0.000245098,857175,0.966811414
16637,552,398,5,5,0.000245098,857180,0.966817054
15548,174,475,5,5,0.000245098,857185,0.966822693
16657,328,640,5,5,0.000245098,857190,0.966828333
21507,701,443,5,5,0.000245098,857195,0.966833972
16889,158,174,5,5,0.000245098,857200,0.966839612
23170,178,640,5,5,0.000245098,857205,0.966845252
24030,674,624,5,5,0.000245098,857210,0.966850891
20865,156,2,5,5,0.000245098,857215,0.966856531
16664,26,155,5,5,0.000245098,857220,0.96686217
16680,609,4,5,5,0.000245098,857225,0.96686781
16674,655,117,5,5,0.000245098,857230,0.966873449
21269,294,582,5,5,0.000245098,857235,0.966879089
25267,114,2,5,5,0.000245098,857240,0.966884728
11200,4,522,5,5,0.000245098,857245,0.966890368
21403,236,90,5,5,0.000245098,857250,0.966896007
24202,121,117,5,5,0.000245098,857255,0.966901647
21365,507,398,5,5,0.000245098,857260,0.966907286
23122,1,19,5,5,0.000245098,857265,0.966912926
15536,613,479,5,5,0.000245098,857270,0.966918565
19911,427,535,5,5,0.000245098,857275,0.966924205
16804,105,525,5,5,0.000245098,857280,0.966929844
21356,655,439,5,5,0.000245098,857285,0.966935484
21357,54,498,5,5,0.000245098,857290,0.966941123
16743,133,398,5,5,0.000245098,857295,0.966946763
19852,207,596,5,5,0.000245098,857300,0.966952402
12702,30,562,5,5,0.000245098,857305,0.966958042
24177,155,3,5,5,0.000245098,857310,0.966963681
21361,33,701,5,5,0.000245098,857315,0.966969321
16793,5,307,5,5,0.000245098,857320,0.966974961
20351,29,353,5,5,0.000245098,857325,0.9669806
9675,9,195,5,5,0.000245098,857330,0.96698624
16777,307,529,5,5,0.000245098,857335,0.966991879
19905,207,97,5,5,0.000245098,857340,0.966997519
15521,265,479,5,5,0.000245098,857345,0.967003158
24129,174,569,5,5,0.000245098,857350,0.967008798
23145,23,582,5,5,0.000245098,857355,0.967014437
12668,274,145,5,5,0.000245098,857360,0.967020077
17948,156,264,5,5,0.000245098,857365,0.967025716
17959,613,535,5,5,0.000245098,857370,0.967031356
16813,593,15,5,5,0.000245098,857375,0.967036995
19919,204,682,5,5,0.000245098,857380,0.967042635
24186,684,77,5,5,0.000245098,857385,0.967048274
17918,14,121,5,5,0.000245098,857390,0.967053914
20343,354,618,5,5,0.000245098,857395,0.967059553
12805,708,632,5,5,0.000245098,857400,0.967065193
16837,379,140,5,5,0.000245098,857405,0.967070832
20354,684,353,5,5,0.000245098,857410,0.967076472
24191,311,668,5,5,0.000245098,857415,0.967082111
12899,207,80,5,5,0.000245098,857420,0.967087751
16713,719,302,5,5,0.000245098,857425,0.96709339
20626,196,54,5,5,0.000245098,857430,0.96709903
19798,497,646,5,5,0.000245098,857435,0.96710467
24096,265,613,5,5,0.000245098,857440,0.967110309
12720,9,618,5,5,0.000245098,857445,0.967115949
16819,302,246,5,5,0.000245098,857450,0.967121588
19836,33,175,5,5,0.000245098,857455,0.967127228
20608,503,23,5,5,0.000245098,857460,0.967132867
24100,596,624,5,5,0.000245098,857465,0.967138507
27087,294,178,5,5,0.000245098,857470,0.967144146
16825,593,439,5,5,0.000245098,857475,0.967149786
16731,1,26,5,5,0.000245098,857480,0.967155425
12757,458,558,5,5,0.000245098,857485,0.967161065
19825,243,364,5,5,0.000245098,857490,0.967166704
21378,77,525,5,5,0.000245098,857495,0.967172344
16830,97,443,5,5,0.000245098,857500,0.967177983
12783,511,529,5,5,0.000245098,857505,0.967183623
21540,138,473,5,5,0.000245098,857510,0.967189262
21543,614,2,5,5,0.000245098,857515,0.967194902
21726,439,723,5,5,0.000245098,857520,0.967200541
16520,632,511,5,5,0.000245098,857525,0.967206181
21695,68,719,5,5,0.000245098,857530,0.96721182
15396,497,117,5,5,0.000245098,857535,0.96721746
19991,367,507,5,5,0.000245098,857540,0.967223099
19530,133,471,5,5,0.000245098,857545,0.967228739
23216,347,552,5,5,0.000245098,857550,0.967234379
17015,596,652,5,5,0.000245098,857555,0.967240018
20568,145,503,5,5,0.000245098,857560,0.967245658
13362,443,683,5,5,0.000245098,857565,0.967251297
21725,265,439,5,5,0.000245098,857570,0.967256937
16497,138,9,5,5,0.000245098,857575,0.967262576
19517,471,126,5,5,0.000245098,857580,0.967268216
23961,668,427,5,5,0.000245098,857585,0.967273855
21694,11,587,5,5,0.000245098,857590,0.967279495
20571,663,181,5,5,0.000245098,857595,0.967285134
21226,170,314,5,5,0.000245098,857600,0.967290774
26654,130,721,5,5,0.000245098,857605,0.967296413
13287,605,97,5,5,0.000245098,857610,0.967302053
21657,3,409,5,5,0.000245098,857615,0.967307692
21665,414,543,5,5,0.000245098,857620,0.967313332
19560,156,29,5,5,0.000245098,857625,0.967318971
19556,131,482,5,5,0.000245098,857630,0.967324611
19982,14,587,5,5,0.000245098,857635,0.96733025
21229,497,30,5,5,0.000245098,857640,0.96733589
20654,663,503,5,5,0.000245098,857645,0.967341529
15404,311,195,5,5,0.000245098,857650,0.967347169
16494,13,174,5,5,0.000245098,857655,0.967352808
19512,532,29,5,5,0.000245098,857660,0.967358448
15411,107,507,5,5,0.000245098,857665,0.967364088
21746,31,502,5,5,0.000245098,857670,0.967369727
24377,543,668,5,5,0.000245098,857675,0.967375367
19480,385,398,5,5,0.000245098,857680,0.967381006
19478,525,609,5,5,0.000245098,857685,0.967386646
16479,207,302,5,5,0.000245098,857690,0.967392285
13411,640,195,5,5,0.000245098,857695,0.967397925
16475,632,427,5,5,0.000245098,857700,0.967403564
16473,632,609,5,5,0.000245098,857705,0.967409204
19471,145,661,5,5,0.000245098,857710,0.967414843
23222,347,614,5,5,0.000245098,857715,0.967420483
21763,347,193,5,5,0.000245098,857720,0.967426122
20004,14,511,5,5,0.000245098,857725,0.967431762
21771,427,64,5,5,0.000245098,857730,0.967437401
19487,502,34,5,5,0.000245098,857735,0.967443041
13379,242,274,5,5,0.000245098,857740,0.96744868
17864,20,394,5,5,0.000245098,857745,0.96745432
18037,29,663,5,5,0.000245098,857750,0.967459959
19500,103,77,5,5,0.000245098,857755,0.967465599
19490,117,348,5,5,0.000245098,857760,0.967471238
26522,145,646,5,5,0.000245098,857765,0.967476878
23935,364,646,5,5,0.000245098,857770,0.967482517
19493,195,640,5,5,0.000245098,857775,0.967488157
13408,404,439,5,5,0.000245098,857780,0.967493797
20588,178,34,5,5,0.000245098,857785,0.967499436
17999,708,3,5,5,0.000245098,857790,0.967505076
20581,367,29,5,5,0.000245098,857795,0.967510715
23999,141,50,5,5,0.000245098,857800,0.967516355
19960,14,265,5,5,0.000245098,857805,0.967521994
16597,274,517,5,5,0.000245098,857810,0.967527634
23081,155,11,5,5,0.000245098,857815,0.967533273
17889,552,167,5,5,0.000245098,857820,0.967538913
19637,446,97,5,5,0.000245098,857825,0.967544552
16607,50,414,5,5,0.000245098,857830,0.967550192
24277,371,310,5,5,0.000245098,857835,0.967555831
21548,15,701,5,5,0.000245098,857840,0.967561471
19678,310,618,5,5,0.000245098,857845,0.96756711
26799,126,347,5,5,0.000245098,857850,0.96757275
26785,626,31,5,5,0.000245098,857855,0.967578389
16920,174,479,5,5,0.000245098,857860,0.967584029
19673,156,514,5,5,0.000245098,857865,0.967589668
16631,328,158,5,5,0.000245098,857870,0.967595308
21564,661,10,5,5,0.000245098,857875,0.967600947
24281,528,2,5,5,0.000245098,857880,0.967606587
20643,12,543,5,5,0.000245098,857885,0.967612226
19666,29,463,5,5,0.000245098,857890,0.967617866
20645,638,22,5,5,0.000245098,857895,0.967623506
19661,618,156,5,5,0.000245098,857900,0.967629145
20647,479,605,5,5,0.000245098,857905,0.967634785
24325,543,54,5,5,0.000245098,857910,0.967640424
21643,158,269,5,5,0.000245098,857915,0.967646064
21602,720,29,5,5,0.000245098,857920,0.967651703
19600,295,175,5,5,0.000245098,857925,0.967657343
19599,354,507,5,5,0.000245098,857930,0.967662982
21246,160,367,5,5,0.000245098,857935,0.967668622
16978,558,140,5,5,0.000245098,857940,0.967674261
17882,250,14,5,5,0.000245098,857945,0.967679901
19591,501,528,5,5,0.000245098,857950,0.96768554
24333,605,167,5,5,0.000245098,857955,0.96769118
17879,20,614,5,5,0.000245098,857960,0.967696819
16534,646,77,5,5,0.000245098,857965,0.967702459
19601,43,543,5,5,0.000245098,857970,0.967708098
19602,493,114,5,5,0.000245098,857975,0.967713738
19970,380,178,5,5,0.000245098,857980,0.967719377
11901,4,689,5,5,0.000245098,857985,0.967725017
21252,1,117,5,5,0.000245098,857990,0.967730656
13157,242,141,5,5,0.000245098,857995,0.967736296
16588,27,492,5,5,0.000245098,858000,0.967741935
13158,494,105,5,5,0.000245098,858005,0.967747575
23078,124,3,5,5,0.000245098,858010,0.967753215
20649,167,95,5,5,0.000245098,858015,0.967758854
15431,246,379,5,5,0.000245098,858020,0.967764494
23993,354,171,5,5,0.000245098,858025,0.967770133
15436,302,140,5,5,0.000245098,858030,0.967775773
21251,511,475,5,5,0.000245098,858035,0.967781412
16577,393,475,5,5,0.000245098,858040,0.967787052
19606,196,22,5,5,0.000245098,858045,0.967792691
16232,443,261,5,5,0.000245098,858050,0.967798331
17554,397,383,5,5,0.000245098,858055,0.96780397
22578,64,331,5,5,0.000245098,858060,0.96780961
22583,626,16,5,5,0.000245098,858065,0.967815249
20197,195,30,5,5,0.000245098,858070,0.967820889
15922,31,586,5,5,0.000245098,858075,0.967826528
15723,701,582,5,5,0.000245098,858080,0.967832168
20200,609,427,5,5,0.000245098,858085,0.967837807
23448,328,508,5,5,0.000245098,858090,0.967843447
22594,448,640,5,5,0.000245098,858095,0.967849086
14703,193,475,5,5,0.000245098,858100,0.967854726
22575,14,427,5,5,0.000245098,858105,0.967860365
10717,54,123,5,5,0.000245098,858110,0.967866005
17542,497,307,5,5,0.000245098,858115,0.967871644
17544,43,655,5,5,0.000245098,858120,0.967877284
25784,121,587,5,5,0.000245098,858125,0.967882924
14661,385,614,5,5,0.000245098,858130,0.967888563
22536,328,90,5,5,0.000245098,858135,0.967894203
22539,158,673,5,5,0.000245098,858140,0.967899842
24878,26,721,5,5,0.000245098,858145,0.967905482
14662,632,498,5,5,0.000245098,858150,0.967911121
18602,250,163,5,5,0.000245098,858155,0.967916761
23454,19,295,5,5,0.000245098,858160,0.9679224
15159,605,196,5,5,0.000245098,858165,0.96792804
17759,84,12,5,5,0.000245098,858170,0.967933679
15935,114,471,5,5,0.000245098,858175,0.967939319
17758,689,552,5,5,0.000245098,858180,0.967944958
22570,193,50,5,5,0.000245098,858185,0.967950598
22571,22,332,5,5,0.000245098,858190,0.967956237
20194,588,90,5,5,0.000245098,858195,0.967961877
17566,498,2,5,5,0.000245098,858200,0.967967516
22626,471,605,5,5,0.000245098,858205,0.967973156
20206,30,22,5,5,0.000245098,858210,0.967978795
7344,4,655,5,5,0.000245098,858215,0.967984435
18525,56,482,5,5,0.000245098,858220,0.967990074
20209,528,723,5,5,0.000245098,858225,0.967995714
20784,471,661,5,5,0.000245098,858230,0.968001353
20210,123,593,5,5,0.000245098,858235,0.968006993
14775,502,588,5,5,0.000245098,858240,0.968012633
22880,131,652,5,5,0.000245098,858245,0.968018272
18517,163,335,5,5,0.000245098,858250,0.968023912
25732,193,19,5,5,0.000245098,858255,0.968029551
15131,22,543,5,5,0.000245098,858260,0.968035191
15726,446,123,5,5,0.000245098,858265,0.96804083
14794,174,105,5,5,0.000245098,858270,0.96804647
14795,2,674,5,5,0.000245098,858275,0.968052109
23443,558,90,5,5,0.000245098,858280,0.968057749
18558,23,529,5,5,0.000245098,858285,0.968063388
22612,522,446,5,5,0.000245098,858290,0.968069028
24915,448,463,5,5,0.000245098,858295,0.968074667
20781,4,383,5,5,0.000245098,858300,0.968080307
17570,84,2,5,5,0.000245098,858305,0.968085946
14728,11,97,5,5,0.000245098,858310,0.968091586
17753,398,560,5,5,0.000245098,858315,0.968097225
15137,511,48,5,5,0.000245098,858320,0.968102865
17575,394,364,5,5,0.000245098,858325,0.968108504
18234,138,529,5,5,0.000245098,858330,0.968114144
22621,471,552,5,5,0.000245098,858335,0.968119783
23431,663,163,5,5,0.000245098,858340,0.968125423
15905,34,294,5,5,0.000245098,858345,0.968131062
14740,302,482,5,5,0.000245098,858350,0.968136702
18538,618,307,5,5,0.000245098,858355,0.968142342
24860,155,364,5,5,0.000245098,858360,0.968147981
17540,354,503,5,5,0.000245098,858365,0.968153621
22418,80,494,5,5,0.000245098,858370,0.96815926
18699,2,280,5,5,0.000245098,858375,0.9681649
20933,624,50,5,5,0.000245098,858380,0.968170539
15716,103,230,5,5,0.000245098,858385,0.968176179
22444,26,29,5,5,0.000245098,858390,0.968181818
15973,224,593,5,5,0.000245098,858395,0.968187458
18691,5,195,5,5,0.000245098,858400,0.968193097
18688,682,22,5,5,0.000245098,858405,0.968198737
18687,264,398,5,5,0.000245098,858410,0.968204376
22446,684,204,5,5,0.000245098,858415,0.968210016
20172,497,20,5,5,0.000245098,858420,0.968215655
19065,458,33,5,5,0.000245098,858425,0.968221295
23481,682,427,5,5,0.000245098,858430,0.968226934
20176,380,342,5,5,0.000245098,858435,0.968232574
18674,511,84,5,5,0.000245098,858440,0.968238213
18700,12,439,5,5,0.000245098,858445,0.968243853
15711,138,84,5,5,0.000245098,858450,0.968249492
15985,302,714,5,5,0.000245098,858455,0.968255132
18725,507,20,5,5,0.000245098,858460,0.968260771
20280,155,274,5,5,0.000245098,858465,0.968266411
17489,32,701,5,5,0.000245098,858470,0.968272051
20163,446,335,5,5,0.000245098,858475,0.96827769
18718,11,167,5,5,0.000245098,858480,0.96828333
22432,404,640,5,5,0.000245098,858485,0.968288969
17495,624,353,5,5,0.000245098,858490,0.968294609
24794,68,133,5,5,0.000245098,858495,0.968300248
14531,133,393,5,5,0.000245098,858500,0.968305888
18710,103,224,5,5,0.000245098,858505,0.968311527
17513,394,682,5,5,0.000245098,858510,0.968317167
24817,156,689,5,5,0.000245098,858515,0.968322806
18643,22,140,5,5,0.000245098,858520,0.968328446
22498,261,164,5,5,0.000245098,858525,0.968334085
25815,571,632,5,5,0.000245098,858530,0.968339725
23305,103,640,5,5,0.000245098,858535,0.968345364
14633,207,123,5,5,0.000245098,858540,0.968351004
20186,117,6,5,5,0.000245098,858545,0.968356643
25790,43,85,5,5,0.000245098,858550,0.968362283
21035,593,34,5,5,0.000245098,858555,0.968367922
11599,9,646,5,5,0.000245098,858560,0.968373562
17529,219,682,5,5,0.000245098,858565,0.968379201
22462,638,652,5,5,0.000245098,858570,0.968384841
22467,328,552,5,5,0.000245098,858575,0.96839048
15962,714,380,5,5,0.000245098,858580,0.96839612
21043,582,492,5,5,0.000245098,858585,0.96840176
21042,393,246,5,5,0.000245098,858590,0.968407399
23475,544,195,5,5,0.000245098,858595,0.968413039
23474,684,471,5,5,0.000245098,858600,0.968418678
18657,334,56,5,5,0.000245098,858605,0.968424318
17523,640,155,5,5,0.000245098,858610,0.968429957
25841,718,269,5,5,0.000245098,858615,0.968435597
17525,404,15,5,5,0.000245098,858620,0.968441236
17526,446,471,5,5,0.000245098,858625,0.968446876
18648,332,522,5,5,0.000245098,858630,0.968452515
20771,498,294,5,5,0.000245098,858635,0.968458155
20772,246,313,5,5,0.000245098,858640,0.968463794
22635,473,269,5,5,0.000245098,858645,0.968469434
21003,114,34,5,5,0.000245098,858650,0.968475073
15019,3,25,5,5,0.000245098,858655,0.968480713
15796,22,463,5,5,0.000245098,858660,0.968486352
22746,571,638,5,5,0.000245098,858665,0.968491992
17680,105,137,5,5,0.000245098,858670,0.968497631
17682,164,497,5,5,0.000245098,858675,0.968503271
15026,193,379,5,5,0.000245098,858680,0.96850891
15036,264,265,5,5,0.000245098,858685,0.96851455
23371,493,26,5,5,0.000245098,858690,0.968520189
10664,23,158,5,5,0.000245098,858695,0.968525829
22760,618,385,5,5,0.000245098,858700,0.968531469
20808,471,682,5,5,0.000245098,858705,0.968537108
22738,204,364,5,5,0.000245098,858710,0.968542748
18346,243,560,5,5,0.000245098,858715,0.968548387
18372,13,529,5,5,0.000245098,858720,0.968554027
22847,19,588,5,5,0.000245098,858725,0.968559666
22719,392,498,5,5,0.000245098,858730,0.968565306
24977,54,97,5,5,0.000245098,858735,0.968570945
15801,682,295,5,5,0.000245098,858740,0.968576585
20233,84,618,5,5,0.000245098,858745,0.968582224
20234,174,22,5,5,0.000245098,858750,0.968587864
17675,668,334,5,5,0.000245098,858755,0.968593503
18380,32,124,5,5,0.000245098,858760,0.968599143
15012,95,294,5,5,0.000245098,858765,0.968604782
18376,646,655,5,5,0.000245098,858770,0.968610422
25635,652,196,5,5,0.000245098,858775,0.968616061
17692,155,689,5,5,0.000245098,858780,0.968621701
17595,250,364,5,5,0.000245098,858785,0.96862734
22840,261,348,5,5,0.000245098,858790,0.96863298
20813,34,714,5,5,0.000245098,858795,0.968638619
18313,446,379,5,5,0.000245098,858800,0.968644259
25016,126,661,5,5,0.000245098,858805,0.968649898
25564,708,107,5,5,0.000245098,858810,0.968655538
18309,196,19,5,5,0.000245098,858815,0.968661178
17724,463,29,5,5,0.000245098,858820,0.968666817
12021,493,9,5,5,0.000245098,858825,0.968672457
15072,307,117,5,5,0.000245098,858830,0.968678096
25555,117,552,5,5,0.000245098,858835,0.968683736
20955,507,517,5,5,0.000245098,858840,0.968689375
18285,196,501,5,5,0.000245098,858845,0.968695015
15089,243,121,5,5,0.000245098,858850,0.968700654
17719,114,414,5,5,0.000245098,858855,0.968706294
15771,11,54,5,5,0.000245098,858860,0.968711933
17693,618,26,5,5,0.000245098,858865,0.968717573
18341,246,77,5,5,0.000245098,858870,0.968723212
23358,482,463,5,5,0.000245098,858875,0.968728852
20402,638,364,5,5,0.000245098,858880,0.968734491
20245,394,632,5,5,0.000245098,858885,0.968740131
20246,250,503,5,5,0.000245098,858890,0.96874577
12604,638,439,5,5,0.000245098,858895,0.96875141
22776,14,414,5,5,0.000245098,858900,0.968757049
18278,16,261,5,5,0.000245098,858905,0.968762689
15049,582,174,5,5,0.000245098,858910,0.968768328
17699,493,586,5,5,0.000245098,858915,0.968773968
20248,114,156,5,5,0.000245098,858920,0.968779607
15055,334,158,5,5,0.000245098,858925,0.968785247
22787,458,348,5,5,0.000245098,858930,0.968790887
25001,498,133,5,5,0.000245098,858935,0.968796526
25007,50,652,5,5,0.000245098,858940,0.968802166
20406,164,313,5,5,0.000245098,858945,0.968807805
18401,719,380,5,5,0.000245098,858950,0.968813445
18479,290,105,5,5,0.000245098,858955,0.968819084
18254,334,4,5,5,0.000245098,858960,0.968824724
18473,367,294,5,5,0.000245098,858965,0.968830363
17739,4,497,5,5,0.000245098,858970,0.968836003
22677,328,207,5,5,0.000245098,858975,0.968841642
18468,202,314,5,5,0.000245098,858980,0.968847282
22678,290,32,5,5,0.000245098,858985,0.968852921
18465,334,30,5,5,0.000245098,858990,0.968858561
18458,25,12,5,5,0.000245098,858995,0.9688642
18457,171,354,5,5,0.000245098,859000,0.96886984
18257,97,652,5,5,0.000245098,859005,0.968875479
22679,196,652,5,5,0.000245098,859010,0.968881119
20996,64,9,5,5,0.000245098,859015,0.968886758
22663,181,14,5,5,0.000245098,859020,0.968892398
20999,202,380,5,5,0.000245098,859025,0.968898037
17661,140,353,5,5,0.000245098,859030,0.968903677
18505,274,640,5,5,0.000245098,859035,0.968909316
20431,224,175,5,5,0.000245098,859040,0.968914956
11636,689,64,5,5,0.000245098,859045,0.968920596
17747,674,528,5,5,0.000245098,859050,0.968926235
15127,131,507,5,5,0.000245098,859055,0.968931875
23410,13,552,5,5,0.000245098,859060,0.968937514
23402,32,261,5,5,0.000245098,859065,0.968943154
17614,511,15,5,5,0.000245098,859070,0.968948793
17618,544,683,5,5,0.000245098,859075,0.968954433
14898,32,181,5,5,0.000245098,859080,0.968960072
14900,163,9,5,5,0.000245098,859085,0.968965712
23384,56,29,5,5,0.000245098,859090,0.968971351
20947,560,27,5,5,0.000245098,859095,0.968976991
18416,593,682,5,5,0.000245098,859100,0.96898263
18414,219,175,5,5,0.000245098,859105,0.96898827
18412,193,571,5,5,0.000245098,859110,0.968993909
20982,609,640,5,5,0.000245098,859115,0.968999549
18407,562,56,5,5,0.000245098,859120,0.969005188
25654,560,22,5,5,0.000245098,859125,0.969010828
18404,494,394,5,5,0.000245098,859130,0.969016467
15825,25,588,5,5,0.000245098,859135,0.969022107
15734,609,181,5,5,0.000245098,859140,0.969027746
23385,514,640,5,5,0.000245098,859145,0.969033386
18448,274,632,5,5,0.000245098,859150,0.969039025
17636,14,508,5,5,0.000245098,859155,0.969044665
18259,269,280,5,5,0.000245098,859160,0.969050305
22696,167,588,5,5,0.000245098,859165,0.969055944
20419,719,30,5,5,0.000245098,859170,0.969061584
18262,131,294,5,5,0.000245098,859175,0.969067223
15833,294,14,5,5,0.000245098,859180,0.969072863
14921,582,261,5,5,0.000245098,859185,0.969078502
18434,720,105,5,5,0.000245098,859190,0.969084142
20989,439,427,5,5,0.000245098,859195,0.969089781
15829,392,471,5,5,0.000245098,859200,0.969095421
14933,605,10,5,5,0.000245098,859205,0.96910106
17646,107,508,5,5,0.000245098,859210,0.9691067
24777,164,54,5,5,0.000245098,859215,0.969112339
24807,684,632,5,5,0.000245098,859220,0.969117979
18729,130,332,5,5,0.000245098,859225,0.969123618
16142,25,714,5,5,0.000245098,859230,0.969129258
21105,193,663,5,5,0.000245098,859235,0.969134897
20123,97,508,5,5,0.000245098,859240,0.969140537
23648,433,30,5,5,0.000245098,859245,0.969146176
23647,596,448,5,5,0.000245098,859250,0.969151816
18926,103,204,5,5,0.000245098,859255,0.969157455
16126,640,25,5,5,0.000245098,859260,0.969163095
15224,525,367,5,5,0.000245098,859265,0.969168734
15223,497,535,5,5,0.000245098,859270,0.969174374
17800,439,404,5,5,0.000245098,859275,0.969180014
20292,605,34,5,5,0.000245098,859280,0.969185653
18917,714,379,5,5,0.000245098,859285,0.969191293
14322,552,20,5,5,0.000245098,859290,0.969196932
20480,646,246,5,5,0.000245098,859295,0.969202572
24639,171,23,5,5,0.000245098,859300,0.969208211
24626,640,646,5,5,0.000245098,859305,0.969213851
23660,701,219,5,5,0.000245098,859310,0.96921949
12199,4,558,5,5,0.000245098,859315,0.96922513
18956,673,29,5,5,0.000245098,859320,0.969230769
12192,514,588,5,5,0.000245098,859325,0.969236409
24608,720,5,5,5,0.000245098,859330,0.969242048
20490,446,95,5,5,0.000245098,859335,0.969247688
18160,138,354,5,5,0.000245098,859340,0.969253327
22208,663,652,5,5,0.000245098,859345,0.969258967
16148,397,632,5,5,0.000245098,859350,0.969264606
20829,265,34,5,5,0.000245098,859355,0.969270246
22210,535,164,5,5,0.000245098,859360,0.969275885
22213,140,14,5,5,0.000245098,859365,0.969281525
20119,22,552,5,5,0.000245098,859370,0.969287164
20120,123,493,5,5,0.000245098,859375,0.969292804
22242,347,155,5,5,0.000245098,859380,0.969298443
18911,196,156,5,5,0.000245098,859385,0.969304083
18884,1,56,5,5,0.000245098,859390,0.969309723
23621,443,178,5,5,0.000245098,859395,0.969315362
20476,683,274,5,5,0.000245098,859400,0.969321002
18878,6,673,5,5,0.000245098,859405,0.969326641
20475,663,661,5,5,0.000245098,859410,0.969332281
14357,471,528,5,5,0.000245098,859415,0.96933792
18875,20,181,5,5,0.000245098,859420,0.96934356
18874,196,398,5,5,0.000245098,859425,0.969349199
20747,668,475,5,5,0.000245098,859430,0.969354839
23608,22,517,5,5,0.000245098,859435,0.969360478
22273,22,404,5,5,0.000245098,859440,0.969366118
23606,683,463,5,5,0.000245098,859445,0.969371757
18866,295,448,5,5,0.000245098,859450,0.969377397
14369,2,56,5,5,0.000245098,859455,0.969383036
18864,261,3,5,5,0.000245098,859460,0.969388676
16105,31,121,5,5,0.000245098,859465,0.969394315
22250,34,54,5,5,0.000245098,859470,0.969399955
17382,16,569,5,5,0.000245098,859475,0.969405594
14328,25,638,5,5,0.000245098,859480,0.969411234
18906,439,54,5,5,0.000245098,859485,0.969416873
22245,171,167,5,5,0.000245098,859490,0.969422513
21103,250,517,5,5,0.000245098,859495,0.969428152
18899,588,569,5,5,0.000245098,859500,0.969433792
18888,379,503,5,5,0.000245098,859505,0.969439432
18898,97,439,5,5,0.000245098,859510,0.969445071
22253,354,409,5,5,0.000245098,859515,0.969450711
16108,673,196,5,5,0.000245098,859520,0.96945635
22256,290,131,5,5,0.000245098,859525,0.96946199
16164,243,638,5,5,0.000245098,859530,0.969467629
20731,471,482,5,5,0.000245098,859535,0.969473269
26070,121,26,5,5,0.000245098,859540,0.969478908
25460,514,593,5,5,0.000245098,859545,0.969484548
19038,54,558,5,5,0.000245098,859550,0.969490187
19036,588,193,5,5,0.000245098,859555,0.969495827
23254,347,514,5,5,0.000245098,859560,0.969501466
19033,167,156,5,5,0.000245098,859565,0.969507106
16209,50,117,5,5,0.000245098,859570,0.969512745
20728,274,328,5,5,0.000245098,859575,0.969518385
24567,684,50,5,5,0.000245098,859580,0.969524024
12243,207,20,5,5,0.000245098,859585,0.969529664
15254,26,508,5,5,0.000245098,859590,0.969535303
11965,26,683,5,5,0.000245098,859595,0.969540943
23675,587,27,5,5,0.000245098,859600,0.969546582
22134,684,544,5,5,0.000245098,859605,0.969552222
11953,529,145,5,5,0.000245098,859610,0.969557861
14129,379,714,5,5,0.000245098,859615,0.969563501
10084,640,77,5,5,0.000245098,859620,0.969569141
22125,11,269,5,5,0.000245098,859625,0.96957478
19059,11,409,5,5,0.000245098,859630,0.96958042
20725,613,302,5,5,0.000245098,859635,0.969586059
19056,544,126,5,5,0.000245098,859640,0.969591699
16221,20,193,5,5,0.000245098,859645,0.969597338
22131,178,380,5,5,0.000245098,859650,0.969602978
10102,501,471,5,5,0.000245098,859655,0.969608617
19049,193,331,5,5,0.000245098,859660,0.969614257
21121,163,501,5,5,0.000245098,859665,0.969619896
22133,294,219,5,5,0.000245098,859670,0.969625536
24579,493,31,5,5,0.000245098,859675,0.969631175
18158,302,103,5,5,0.000245098,859680,0.969636815
22150,123,290,5,5,0.000245098,859685,0.969642454
22166,77,178,5,5,0.000245098,859690,0.969648094
14224,475,121,5,5,0.000245098,859695,0.969653733
15664,532,2,5,5,0.000245098,859700,0.969659373
15667,609,126,5,5,0.000245098,859705,0.969665012
22171,632,155,5,5,0.000245098,859710,0.969670652
24589,131,593,5,5,0.000245098,859715,0.969676291
16176,133,663,5,5,0.000245098,859720,0.969681931
18976,265,463,5,5,0.000245098,859725,0.96968757
14243,507,77,5,5,0.000245098,859730,0.96969321
18973,719,11,5,5,0.000245098,859735,0.96969885
22172,507,674,5,5,0.000245098,859740,0.969704489
16169,20,25,5,5,0.000245098,859745,0.969710129
20735,328,587,5,5,0.000245098,859750,0.969715768
15663,532,261,5,5,0.000245098,859755,0.969721408
22163,331,332,5,5,0.000245098,859760,0.969727047
11460,269,84,5,5,0.000245098,859765,0.969732687
22152,328,673,5,5,0.000245098,859770,0.969738326
19012,624,311,5,5,0.000245098,859775,0.969743966
14178,25,204,5,5,0.000245098,859780,0.969749605
19007,535,12,5,5,0.000245098,859785,0.969755245
16196,9,163,5,5,0.000245098,859790,0.969760884
26023,26,90,5,5,0.000245098,859795,0.969766524
22972,43,181,5,5,0.000245098,859800,0.969772163
19000,14,562,5,5,0.000245098,859805,0.969777803
22153,13,130,5,5,0.000245098,859810,0.969783442
22154,427,171,5,5,0.000245098,859815,0.969789082
22971,43,661,5,5,0.000245098,859820,0.969794721
16095,394,562,5,5,0.000245098,859825,0.969800361
20478,347,502,5,5,0.000245098,859830,0.969806
25952,121,517,5,5,0.000245098,859835,0.96981164
18793,14,170,5,5,0.000245098,859840,0.969817279
18790,195,295,5,5,0.000245098,859845,0.969822919
17785,393,482,5,5,0.000245098,859850,0.969828559
24710,204,246,5,5,0.000245098,859855,0.969834198
18801,439,26,5,5,0.000245098,859860,0.969839838
18783,593,295,5,5,0.000245098,859865,0.969845477
21081,609,30,5,5,0.000245098,859870,0.969851117
15696,295,4,5,5,0.000245098,859875,0.969856756
22357,394,2,5,5,0.000245098,859880,0.969862396
22333,207,126,5,5,0.000245098,859885,0.969868035
22316,479,193,5,5,0.000245098,859890,0.969873675
23575,22,328,5,5,0.000245098,859895,0.969879314
22317,502,714,5,5,0.000245098,859900,0.969884954
21089,683,334,5,5,0.000245098,859905,0.969890593
17434,269,522,5,5,0.000245098,859910,0.969896233
20826,242,348,5,5,0.000245098,859915,0.969901872
22325,15,503,5,5,0.000245098,859920,0.969907512
21085,717,708,5,5,0.000245098,859925,0.969913151
18808,699,77,5,5,0.000245098,859930,0.969918791
22330,493,439,5,5,0.000245098,859935,0.96992443
18805,682,164,5,5,0.000245098,859940,0.96993007
12144,33,569,5,5,0.000245098,859945,0.969935709
22950,334,517,5,5,0.000245098,859950,0.969941349
20157,230,174,5,5,0.000245098,859955,0.969946988
20158,171,508,5,5,0.000245098,859960,0.969952628
23525,393,207,5,5,0.000245098,859965,0.969958268
22911,90,130,5,5,0.000245098,859970,0.969963907
18742,6,514,5,5,0.000245098,859975,0.969969547
16013,30,446,5,5,0.000245098,859980,0.969975186
16008,274,97,5,5,0.000245098,859985,0.969980826
22414,528,141,5,5,0.000245098,859990,0.969986465
17471,638,605,5,5,0.000245098,859995,0.969992105
11706,689,158,5,5,0.000245098,860000,0.969997744
20762,503,397,5,5,0.000245098,860005,0.970003384
20149,717,196,5,5,0.000245098,860010,0.970009023
10201,196,394,5,5,0.000245098,860015,0.970014663
14467,638,328,5,5,0.000245098,860020,0.970020302
24736,124,638,5,5,0.000245098,860025,0.970025942
18762,385,689,5,5,0.000245098,860030,0.970031581
14488,596,683,5,5,0.000245098,860035,0.970037221
24751,703,367,5,5,0.000245098,860040,0.97004286
15199,33,174,5,5,0.000245098,860045,0.9700485
17776,514,50,5,5,0.000245098,860050,0.970054139
18755,682,117,5,5,0.000245098,860055,0.970059779
18336,121,84,5,5,0.000245098,860060,0.970065418
22957,124,1,5,5,0.000245098,860065,0.970071058
22286,121,498,5,5,0.000245098,860070,0.970076697
23261,354,178,5,5,0.000245098,860075,0.970082337
18174,502,683,5,5,0.000245098,860080,0.970087977
17426,335,494,5,5,0.000245098,860085,0.970093616
24683,571,34,5,5,0.000245098,860090,0.970099256
15205,497,588,5,5,0.000245098,860095,0.970104895
20136,164,708,5,5,0.000245098,860100,0.970110535
25958,5,674,5,5,0.000245098,860105,0.970116174
14384,158,155,5,5,0.000245098,860110,0.970121814
18835,414,517,5,5,0.000245098,860115,0.970127453
14382,605,663,5,5,0.000245098,860120,0.970133093
17419,497,674,5,5,0.000245098,860125,0.970138732
20135,446,334,5,5,0.000245098,860130,0.970144372
22959,719,638,5,5,0.000245098,860135,0.970150011
20137,517,264,5,5,0.000245098,860140,0.970155651
15680,708,195,5,5,0.000245098,860145,0.97016129
15547,543,193,18,4,0.000882353,860163,0.970181593
8313,383,230,12,4,0.000588235,860175,0.970195127
20284,684,307,11,4,0.000539216,860186,0.970207534
17262,414,723,9,4,0.000441176,860195,0.970217686
18604,14,274,9,4,0.000441176,860204,0.970227837
21305,552,392,8,4,0.000392157,860212,0.97023686
12679,2,236,8,4,0.000392157,860220,0.970245883
18545,439,204,8,4,0.000392157,860228,0.970254906
18513,261,4,8,4,0.000392157,860236,0.97026393
18756,383,385,8,4,0.000392157,860244,0.970272953
16691,274,364,8,4,0.000392157,860252,0.970281976
15475,23,655,8,4,0.000392157,860260,0.970290999
13221,689,498,8,4,0.000392157,860268,0.970300023
19596,380,103,8,4,0.000392157,860276,0.970309046
17010,114,64,8,4,0.000392157,860284,0.970318069
20258,22,544,7,4,0.000343137,860291,0.970325964
17073,618,126,7,4,0.000343137,860298,0.97033386
20155,207,674,7,4,0.000343137,860305,0.970341755
16928,243,167,7,4,0.000343137,860312,0.97034965
19460,383,14,7,4,0.000343137,860319,0.970357546
18238,683,535,7,4,0.000343137,860326,0.970365441
18568,543,29,7,4,0.000343137,860333,0.970373336
17488,503,529,7,4,0.000343137,860340,0.970381232
19861,427,265,7,4,0.000343137,860347,0.970389127
19804,160,170,7,4,0.000343137,860354,0.970397022
21417,683,663,7,4,0.000343137,860361,0.970404918
21399,141,95,7,4,0.000343137,860368,0.970412813
20365,383,392,7,4,0.000343137,860375,0.970420708
21556,230,137,7,4,0.000343137,860382,0.970428604
16327,439,14,7,4,0.000343137,860389,0.970436499
12025,618,638,7,4,0.000343137,860396,0.970444394
16427,404,295,7,4,0.000343137,860403,0.97045229
15920,265,307,7,4,0.000343137,860410,0.970460185
14509,397,246,7,4,0.000343137,860417,0.97046808
16191,543,170,7,4,0.000343137,860424,0.970475976
15412,264,11,7,4,0.000343137,860431,0.970483871
16560,5,596,7,4,0.000343137,860438,0.970491766
15666,156,587,7,4,0.000343137,860445,0.970499662
14736,493,224,6,4,0.000294118,860451,0.970506429
17951,497,587,6,4,0.000294118,860457,0.970513196
18715,140,471,6,4,0.000294118,860463,0.970519964
11863,97,20,6,4,0.000294118,860469,0.970526731
23074,54,535,6,4,0.000294118,860475,0.970533499
23065,302,178,6,4,0.000294118,860481,0.970540266
17965,493,311,6,4,0.000294118,860487,0.970547034
14592,123,507,6,4,0.000294118,860493,0.970553801
18649,493,414,6,4,0.000294118,860499,0.970560568
18555,385,242,6,4,0.000294118,860505,0.970567336
18004,84,1,6,4,0.000294118,860511,0.970574103
16772,50,328,6,4,0.000294118,860517,0.970580871
18598,123,409,6,4,0.000294118,860523,0.970587638
18154,661,473,6,4,0.000294118,860529,0.970594406
18339,43,605,6,4,0.000294118,860535,0.970601173
18143,64,14,6,4,0.000294118,860541,0.97060794
18151,593,586,6,4,0.000294118,860547,0.970614708
15094,532,64,6,4,0.000294118,860553,0.970621475
18180,22,204,6,4,0.000294118,860559,0.970628243
20270,446,64,6,4,0.000294118,860565,0.97063501
18186,107,1,6,4,0.000294118,860571,0.970641778
18504,708,250,6,4,0.000294118,860577,0.970648545
18040,683,77,6,4,0.000294118,860583,0.970655312
15383,14,11,6,4,0.000294118,860589,0.97066208
15381,414,158,6,4,0.000294118,860595,0.970668847
20213,31,274,6,4,0.000294118,860601,0.970675615
20231,613,313,6,4,0.000294118,860607,0.970682382
15290,140,588,6,4,0.000294118,860613,0.97068915
18374,242,3,6,4,0.000294118,860619,0.970695917
15316,562,264,6,4,0.000294118,860625,0.970702684
15307,525,335,6,4,0.000294118,860631,0.970709452
22209,195,29,6,4,0.000294118,860637,0.970716219
19989,632,250,6,4,0.000294118,860643,0.970722987
21699,167,64,6,4,0.000294118,860649,0.970729754
21707,683,347,6,4,0.000294118,860655,0.970736522
19518,236,171,6,4,0.000294118,860661,0.970743289
19559,207,50,6,4,0.000294118,860667,0.970750056
19630,219,605,6,4,0.000294118,860673,0.970756824
19616,90,471,6,4,0.000294118,860679,0.970763591
19978,655,171,6,4,0.000294118,860685,0.970770359
13594,529,674,6,4,0.000294118,860691,0.970777126
21818,193,674,6,4,0.000294118,860697,0.970783894
19484,609,682,6,4,0.000294118,860703,0.970790661
20001,708,193,6,4,0.000294118,860709,0.970797428
12729,9,673,6,4,0.000294118,860715,0.970804196
12894,2,121,6,4,0.000294118,860721,0.970810963
19850,171,243,6,4,0.000294118,860727,0.970817731
12689,613,16,6,4,0.000294118,860733,0.970824498
21539,155,331,6,4,0.000294118,860739,0.970831266
21544,236,193,6,4,0.000294118,860745,0.970838033
19664,103,145,6,4,0.000294118,860751,0.9708448
19646,269,354,6,4,0.000294118,860757,0.970851568
12982,97,543,6,4,0.000294118,860763,0.970858335
19729,15,552,6,4,0.000294118,860769,0.970865103
19715,295,507,6,4,0.000294118,860775,0.97087187
18937,155,334,6,4,0.000294118,860781,0.970878637
18922,383,328,6,4,0.000294118,860787,0.970885405
18891,274,56,6,4,0.000294118,860793,0.970892172
22149,280,5,6,4,0.000294118,860799,0.97089894
19017,588,103,6,4,0.000294118,860805,0.970905707
18980,532,618,6,4,0.000294118,860811,0.970912475
14240,14,158,6,4,0.000294118,860817,0.970919242
22174,19,310,6,4,0.000294118,860823,0.970926009
21091,158,618,6,4,0.000294118,860829,0.970932777
22279,114,163,6,4,0.000294118,860835,0.970939544
18855,124,302,6,4,0.000294118,860841,0.970946312
22288,364,50,6,4,0.000294118,860847,0.970953079
18840,720,32,6,4,0.000294118,860853,0.970959847
18839,479,332,6,4,0.000294118,860859,0.970966614
22306,195,380,6,4,0.000294118,860865,0.970973381
19040,497,682,6,4,0.000294118,860871,0.970980149
19227,614,12,6,4,0.000294118,860877,0.970986916
13908,29,295,6,4,0.000294118,860883,0.970993684
19191,522,269,6,4,0.000294118,860889,0.971000451
12336,379,246,6,4,0.000294118,860895,0.971007219
21927,328,448,6,4,0.000294118,860901,0.971013986
19276,394,170,6,4,0.000294118,860907,0.971020753
20092,448,354,6,4,0.000294118,860913,0.971027521
14108,535,587,6,4,0.000294118,860919,0.971034288
19170,427,121,6,4,0.000294118,860925,0.971041056
24675,202,448,6,4,0.000294118,860931,0.971047823
17428,683,145,6,4,0.000294118,860937,0.971054591
16070,10,12,6,4,0.000294118,860943,0.971061358
16237,586,439,6,4,0.000294118,860949,0.971068125
17274,398,392,6,4,0.000294118,860955,0.971074893
23702,14,328,6,4,0.000294118,860961,0.97108166
17331,479,502,6,4,0.000294118,860967,0.971088428
17659,33,140,6,4,0.000294118,860973,0.971095195
23324,626,34,6,4,0.000294118,860979,0.971101963
24996,178,294,6,4,0.000294118,860985,0.97110873
15880,193,569,6,4,0.000294118,860991,0.971115497
23425,167,195,6,4,0.000294118,860997,0.971122265
23755,155,121,6,4,0.000294118,861003,0.971129032
17234,280,54,6,4,0.000294118,861009,0.9711358
16615,609,714,6,4,0.000294118,861015,0.971142567
16617,95,328,6,4,0.000294118,861021,0.971149335
20641,14,385,6,4,0.000294118,861027,0.971156102
24022,380,371,6,4,0.000294118,861033,0.971162869
16582,528,414,6,4,0.000294118,861039,0.971169637
16961,414,427,6,4,0.000294118,861045,0.971176404
16958,332,582,6,4,0.000294118,861051,0.971183172
16591,2,307,6,4,0.000294118,861057,0.971189939
16798,332,689,6,4,0.000294118,861063,0.971196707
16797,479,511,6,4,0.000294118,861069,0.971203474
20612,683,335,6,4,0.000294118,861075,0.971210241
16710,367,155,6,4,0.000294118,861081,0.971217009
16728,529,723,6,4,0.000294118,861087,0.971223776
16729,586,196,6,4,0.000294118,861093,0.971230544
17171,588,613,6,4,0.000294118,861099,0.971237311
23770,613,497,6,4,0.000294118,861105,0.971244079
16320,33,171,6,4,0.000294118,861111,0.971250846
17184,364,6,6,4,0.000294118,861117,0.971257613
17108,114,242,6,4,0.000294118,861123,0.971264381
17106,307,587,6,4,0.000294118,861129,0.971271148
11023,582,613,6,4,0.000294118,861135,0.971277916
16467,397,2,6,4,0.000294118,861141,0.971284683
20561,68,409,6,4,0.000294118,861147,0.97129145
15631,640,13,6,4,0.000294118,861153,0.971298218
17872,26,5,6,4,0.000294118,861159,0.971304985
15678,314,433,6,4,0.000294118,861165,0.971311753
23215,126,558,6,4,0.000294118,861171,0.97131852
17786,588,174,6,4,0.000294118,861177,0.971325288
25065,64,30,6,4,0.000294118,861183,0.971332055
12340,394,638,5,4,0.000245098,861188,0.971337695
12343,242,522,5,4,0.000245098,861193,0.971343334
20838,195,443,5,4,0.000245098,861198,0.971348974
20037,1,274,5,4,0.000245098,861203,0.971354613
16404,123,618,5,4,0.000245098,861208,0.971360253
21163,56,171,5,4,0.000245098,861213,0.971365892
19324,605,264,5,4,0.000245098,861218,0.971371532
21912,117,501,5,4,0.000245098,861223,0.971377171
13742,114,158,5,4,0.000245098,861228,0.971382811
18077,552,85,5,4,0.000245098,861233,0.97138845
13734,302,414,5,4,0.000245098,861238,0.97139409
20043,114,22,5,4,0.000245098,861243,0.971399729
15600,246,353,5,4,0.000245098,861248,0.971405369
19333,19,708,5,4,0.000245098,861253,0.971411008
19303,507,155,5,4,0.000245098,861258,0.971416648
16393,689,586,5,4,0.000245098,861263,0.971422287
17721,593,663,5,4,0.000245098,861268,0.971427927
19431,246,26,5,4,0.000245098,861273,0.971433566
23892,380,720,5,4,0.000245098,861278,0.971439206
21807,448,224,5,4,0.000245098,861283,0.971444845
20320,502,723,5,4,0.000245098,861288,0.971450485
20018,80,167,5,4,0.000245098,861293,0.971456125
23884,107,332,5,4,0.000245098,861298,0.971461764
23863,605,689,5,4,0.000245098,861303,0.971467404
24397,397,668,5,4,0.000245098,861308,0.971473043
21775,443,137,5,4,0.000245098,861313,0.971478683
17056,123,332,5,4,0.000245098,861318,0.971484322
16452,126,280,5,4,0.000245098,861323,0.971489962
20663,290,204,5,4,0.000245098,861328,0.971495601
23918,155,56,5,4,0.000245098,861333,0.971501241
16425,720,16,5,4,0.000245098,861338,0.97150688
21871,393,167,5,4,0.000245098,861343,0.97151252
12356,4,295,5,4,0.000245098,861348,0.971518159
13627,640,497,5,4,0.000245098,861353,0.971523799
21869,562,85,5,4,0.000245098,861358,0.971529438
19371,663,593,5,4,0.000245098,861363,0.971535078
19367,123,13,5,4,0.000245098,861368,0.971540717
21875,334,708,5,4,0.000245098,861373,0.971546357
19383,721,347,5,4,0.000245098,861378,0.971551996
19388,311,492,5,4,0.000245098,861383,0.971557636
19400,332,497,5,4,0.000245098,861388,0.971563275
20317,141,10,5,4,0.000245098,861393,0.971568915
19147,655,471,5,4,0.000245098,861398,0.971574554
22065,364,158,5,4,0.000245098,861403,0.971580194
26163,178,11,5,4,0.000245098,861408,0.971585834
21139,250,64,5,4,0.000245098,861413,0.971591473
11385,558,29,5,4,0.000245098,861418,0.971597113
11927,708,123,5,4,0.000245098,861423,0.971602752
19158,141,84,5,4,0.000245098,861428,0.971608392
23759,701,498,5,4,0.000245098,861433,0.971614031
23002,243,661,5,4,0.000245098,861438,0.971619671
15616,4,646,5,4,0.000245098,861443,0.97162531
22054,14,250,5,4,0.000245098,861448,0.97163095
26137,514,126,5,4,0.000245098,861453,0.971636589
22081,409,95,5,4,0.000245098,861458,0.971642229
20834,90,596,5,4,0.000245098,861463,0.971647868
19095,463,264,5,4,0.000245098,861468,0.971653508
19094,719,367,5,4,0.000245098,861473,0.971659147
16248,624,475,5,4,0.000245098,861478,0.971664787
19091,558,103,5,4,0.000245098,861483,0.971670426
24517,124,367,5,4,0.000245098,861488,0.971676066
22109,624,174,5,4,0.000245098,861493,0.971681705
23253,294,354,5,4,0.000245098,861498,0.971687345
24527,250,167,5,4,0.000245098,861503,0.971692984
19073,170,558,5,4,0.000245098,861508,0.971698624
16233,529,15,5,4,0.000245098,861513,0.971704263
20909,511,264,5,4,0.000245098,861518,0.971709903
17280,646,4,5,4,0.000245098,861523,0.971715543
17720,207,295,5,4,0.000245098,861528,0.971721182
26117,514,508,5,4,0.000245098,861533,0.971726822
19121,207,196,5,4,0.000245098,861538,0.971732461
22084,673,652,5,4,0.000245098,861543,0.971738101
22085,682,364,5,4,0.000245098,861548,0.97174374
17258,385,264,5,4,0.000245098,861553,0.97174938
14048,43,640,5,4,0.000245098,861558,0.971755019
20713,532,673,5,4,0.000245098,861563,0.971760659
23723,236,494,5,4,0.000245098,861568,0.971766298
12300,243,3,5,4,0.000245098,861573,0.971771938
12297,274,156,5,4,0.000245098,861578,0.971777577
23796,164,517,5,4,0.000245098,861583,0.971783217
24481,202,508,5,4,0.000245098,861588,0.971788856
19284,655,560,5,4,0.000245098,861593,0.971794496
26260,683,242,5,4,0.000245098,861598,0.971800135
19277,25,507,5,4,0.000245098,861603,0.971805775
21159,383,25,5,4,0.000245098,861608,0.971811414
20061,50,30,5,4,0.000245098,861613,0.971817054
23817,3,673,5,4,0.000245098,861618,0.971822693
24484,163,328,5,4,0.000245098,861623,0.971828333
15314,207,311,5,4,0.000245098,861628,0.971833972
23785,121,295,5,4,0.000245098,861633,0.971839612
24487,632,124,5,4,0.000245098,861638,0.971845252
19199,448,33,5,4,0.000245098,861643,0.971850891
19197,646,609,5,4,0.000245098,861648,0.971856531
17839,393,2,5,4,0.000245098,861653,0.97186217
19190,689,497,5,4,0.000245098,861658,0.97186781
22041,167,475,5,4,0.000245098,861663,0.971873449
19207,2,274,5,4,0.000245098,861668,0.971879089
19230,609,167,5,4,0.000245098,861673,0.971884728
24486,68,23,5,4,0.000245098,861678,0.971890368
22009,2,164,5,4,0.000245098,861683,0.971896007
21156,265,364,5,4,0.000245098,861688,0.971901647
16308,156,34,5,4,0.000245098,861693,0.971907286
20851,34,448,5,4,0.000245098,861698,0.971912926
23167,364,689,5,4,0.000245098,861703,0.971918565
20600,624,171,5,4,0.000245098,861708,0.971924205
24212,404,269,5,4,0.000245098,861713,0.971929844
17980,31,155,5,4,0.000245098,861718,0.971935484
19740,43,195,5,4,0.000245098,861723,0.971941123
16865,163,107,5,4,0.000245098,861728,0.971946763
23164,661,379,5,4,0.000245098,861733,0.971952402
16855,638,1,5,4,0.000245098,861738,0.971958042
21426,64,498,5,4,0.000245098,861743,0.971963681
24214,414,90,5,4,0.000245098,861748,0.971969321
16909,492,588,5,4,0.000245098,861753,0.971974961
20590,246,655,5,4,0.000245098,861758,0.9719806
19692,525,107,5,4,0.000245098,861763,0.97198624
13080,30,543,5,4,0.000245098,861768,0.971991879
16905,334,609,5,4,0.000245098,861773,0.971997519
16877,243,246,5,4,0.000245098,861778,0.972003158
21270,29,167,5,4,0.000245098,861783,0.972008798
21493,532,409,5,4,0.000245098,861788,0.972014437
17903,689,544,5,4,0.000245098,861793,0.972020077
19721,170,131,5,4,0.000245098,861798,0.972025716
19719,54,95,5,4,0.000245098,861803,0.972031356
16895,22,334,5,4,0.000245098,861808,0.972036995
12925,507,379,5,4,0.000245098,861813,0.972042635
24120,178,126,5,4,0.000245098,861818,0.972048274
19864,160,335,5,4,0.000245098,861823,0.972053914
17924,219,5,5,4,0.000245098,861828,0.972059553
25190,632,202,5,4,0.000245098,861833,0.972065193
16807,123,207,5,4,0.000245098,861838,0.972070832
19870,609,543,5,4,0.000245098,861843,0.972076472
24176,243,2,5,4,0.000245098,861848,0.972082111
16781,684,145,5,4,0.000245098,861853,0.972087751
21309,133,463,5,4,0.000245098,861858,0.97209339
20350,48,507,5,4,0.000245098,861863,0.97209903
16753,145,174,5,4,0.000245098,861868,0.97210467
15515,409,379,5,4,0.000245098,861873,0.972110309
19882,204,661,5,4,0.000245098,861878,0.972115949
16786,196,609,5,4,0.000245098,861883,0.972121588
16758,26,261,5,4,0.000245098,861888,0.972127228
24128,439,64,5,4,0.000245098,861893,0.972132867
21387,90,310,5,4,0.000245098,861898,0.972138507
16724,613,230,5,4,0.000245098,861903,0.972144146
12874,123,552,5,4,0.000245098,861908,0.972149786
21392,97,514,5,4,0.000245098,861913,0.972155425
16847,507,393,5,4,0.000245098,861918,0.972161065
19794,145,514,5,4,0.000245098,861923,0.972166704
21290,618,264,5,4,0.000245098,861928,0.972172344
23148,493,242,5,4,0.000245098,861933,0.972177983
21381,193,114,5,4,0.000245098,861938,0.972183623
19914,314,719,5,4,0.000245098,861943,0.972189262
23117,514,439,5,4,0.000245098,861948,0.972194902
16816,347,170,5,4,0.000245098,861953,0.972200541
25195,175,314,5,4,0.000245098,861958,0.972206181
20856,15,398,5,4,0.000245098,861963,0.97221182
19827,313,493,5,4,0.000245098,861968,0.97221746
15550,56,170,5,4,0.000245098,861973,0.972223099
19990,497,364,5,4,0.000245098,861978,0.972228739
19534,335,525,5,4,0.000245098,861983,0.972234379
16503,493,334,5,4,0.000245098,861988,0.972240018
21720,95,652,5,4,0.000245098,861993,0.972245658
23219,663,332,5,4,0.000245098,861998,0.972251297
21673,558,124,5,4,0.000245098,862003,0.972256937
19552,219,2,5,4,0.000245098,862008,0.972262576
23983,105,19,5,4,0.000245098,862013,0.972268216
20326,529,507,5,4,0.000245098,862018,0.972273855
21233,280,493,5,4,0.000245098,862023,0.972279495
17870,265,33,5,4,0.000245098,862028,0.972285134
13410,392,334,5,4,0.000245098,862033,0.972290774
19483,532,294,5,4,0.000245098,862038,0.972296413
20000,587,10,5,4,0.000245098,862043,0.972302053
21748,552,265,5,4,0.000245098,862048,0.972307692
17050,379,507,5,4,0.000245098,862053,0.972313332
21742,587,473,5,4,0.000245098,862058,0.972318971
10925,475,394,5,4,0.000245098,862063,0.972324611
19501,103,10,5,4,0.000245098,862068,0.97233025
23954,117,4,5,4,0.000245098,862073,0.97233589
19994,684,95,5,4,0.000245098,862078,0.972341529
9939,4,219,5,4,0.000245098,862083,0.972347169
17032,596,1,5,4,0.000245098,862088,0.972352808
19502,126,20,5,4,0.000245098,862093,0.972358448
17863,31,511,5,4,0.000245098,862098,0.972364088
20323,264,535,5,4,0.000245098,862103,0.972369727
16485,207,230,5,4,0.000245098,862108,0.972375367
17876,264,141,5,4,0.000245098,862113,0.972381006
19571,193,614,5,4,0.000245098,862118,0.972386646
19651,582,133,5,4,0.000245098,862123,0.972392285
15447,383,121,5,4,0.000245098,862128,0.972397925
18001,385,31,5,4,0.000245098,862133,0.972403564
24000,170,167,5,4,0.000245098,862138,0.972409204
21582,155,34,5,4,0.000245098,862143,0.972414843
12460,618,33,5,4,0.000245098,862148,0.972420483
23080,354,13,5,4,0.000245098,862153,0.972426122
17885,497,714,5,4,0.000245098,862158,0.972431762
21600,178,97,5,4,0.000245098,862163,0.972437401
20584,682,502,5,4,0.000245098,862168,0.972443041
24309,719,640,5,4,0.000245098,862173,0.97244868
25284,167,48,5,4,0.000245098,862178,0.97245432
12448,156,84,5,4,0.000245098,862183,0.972459959
15419,385,33,5,4,0.000245098,862188,0.972465599
20576,174,11,5,4,0.000245098,862193,0.972471238
21632,708,265,5,4,0.000245098,862198,0.972476878
21636,145,328,5,4,0.000245098,862203,0.972482517
21637,684,156,5,4,0.000245098,862208,0.972488157
13246,30,193,5,4,0.000245098,862213,0.972493797
19580,674,682,5,4,0.000245098,862218,0.972499436
21608,204,587,5,4,0.000245098,862223,0.972505076
19620,310,181,5,4,0.000245098,862228,0.972510715
20876,522,193,5,4,0.000245098,862233,0.972516355
20578,497,398,5,4,0.000245098,862238,0.972521994
13188,123,1,5,4,0.000245098,862243,0.972527634
10922,618,80,5,4,0.000245098,862248,0.972533273
14675,29,97,5,4,0.000245098,862253,0.972538913
17555,367,171,5,4,0.000245098,862258,0.972544552
23451,354,155,5,4,0.000245098,862263,0.972550192
20274,280,528,5,4,0.000245098,862268,0.972555831
21015,12,689,5,4,0.000245098,862273,0.972561471
20199,19,663,5,4,0.000245098,862278,0.97256711
14688,295,164,5,4,0.000245098,862283,0.97257275
18573,699,16,5,4,0.000245098,862288,0.972578389
18570,502,31,5,4,0.000245098,862293,0.972584029
21016,12,133,5,4,0.000245098,862298,0.972589668
22598,178,311,5,4,0.000245098,862303,0.972595308
22524,493,56,5,4,0.000245098,862308,0.972600947
25026,167,280,5,4,0.000245098,862313,0.972606587
23444,294,471,5,4,0.000245098,862318,0.972612226
18617,448,348,5,4,0.000245098,862323,0.972617866
17584,34,274,5,4,0.000245098,862328,0.972623506
18527,708,243,5,4,0.000245098,862333,0.972629145
17592,609,15,5,4,0.000245098,862338,0.972634785
18515,507,107,5,4,0.000245098,862343,0.972640424
14784,646,443,5,4,0.000245098,862348,0.972646064
22882,347,103,5,4,0.000245098,862353,0.972651703
22609,703,14,5,4,0.000245098,862358,0.972657343
17582,34,156,5,4,0.000245098,862363,0.972662982
22613,522,13,5,4,0.000245098,862368,0.972668622
18543,497,97,5,4,0.000245098,862373,0.972674261
15902,393,593,5,4,0.000245098,862378,0.972679901
18701,522,673,5,4,0.000245098,862383,0.97268554
18690,15,661,5,4,0.000245098,862388,0.97269118
20171,558,54,5,4,0.000245098,862393,0.972696819
21044,718,6,5,4,0.000245098,862398,0.972702459
18679,140,117,5,4,0.000245098,862403,0.972708098
14572,10,174,5,4,0.000245098,862408,0.972713738
17485,605,558,5,4,0.000245098,862413,0.972719377
17774,605,114,5,4,0.000245098,862418,0.972725017
16002,141,379,5,4,0.000245098,862423,0.972730656
17490,141,367,5,4,0.000245098,862428,0.972736296
15996,503,314,5,4,0.000245098,862433,0.972741935
15989,367,20,5,4,0.000245098,862438,0.972747575
17498,310,261,5,4,0.000245098,862443,0.972753215
25822,517,207,5,4,0.000245098,862448,0.972758854
21032,20,19,5,4,0.000245098,862453,0.972764494
18635,471,264,5,4,0.000245098,862458,0.972770133
25800,398,155,5,4,0.000245098,862463,0.972775773
24857,511,2,5,4,0.000245098,862468,0.972781412
22504,492,613,5,4,0.000245098,862473,0.972787052
18625,22,48,5,4,0.000245098,862478,0.972792691
22514,674,193,5,4,0.000245098,862483,0.972798331
25794,364,493,5,4,0.000245098,862488,0.97280397
18670,503,582,5,4,0.000245098,862493,0.97280961
20177,77,175,5,4,0.000245098,862498,0.972815249
17765,511,95,5,4,0.000245098,862503,0.972820889
25510,126,331,5,4,0.000245098,862508,0.972826528
18651,265,348,5,4,0.000245098,862513,0.972832168
22637,295,207,5,4,0.000245098,862518,0.972837807
18271,243,543,5,4,0.000245098,862523,0.972843447
20401,160,663,5,4,0.000245098,862528,0.972849086
15102,605,141,5,4,0.000245098,862533,0.972854726
20239,121,614,5,4,0.000245098,862538,0.972860365
18396,529,34,5,4,0.000245098,862543,0.972866005
11660,219,12,5,4,0.000245098,862548,0.972871644
20412,655,126,5,4,0.000245098,862553,0.972877284
15107,624,354,5,4,0.000245098,862558,0.972882924
22735,458,31,5,4,0.000245098,862563,0.972888563
18379,2,207,5,4,0.000245098,862568,0.972894203
15009,48,265,5,4,0.000245098,862573,0.972899842
22736,1,4,5,4,0.000245098,862578,0.972905482
17690,473,493,5,4,0.000245098,862583,0.972911121
17725,708,170,5,4,0.000245098,862588,0.972916761
20957,14,596,5,4,0.000245098,862593,0.9729224
18306,105,371,5,4,0.000245098,862598,0.97292804
22810,347,683,5,4,0.000245098,862603,0.972933679
22826,328,294,5,4,0.000245098,862608,0.972939319
18288,20,11,5,4,0.000245098,862613,0.972944958
20960,347,517,5,4,0.000245098,862618,0.972950598
17703,497,121,5,4,0.000245098,862623,0.972956237
23319,160,23,5,4,0.000245098,862628,0.972961877
20964,717,582,5,4,0.000245098,862633,0.972967516
22791,13,609,5,4,0.000245098,862638,0.972973156
17664,674,1,5,4,0.000245098,862643,0.972978795
17623,502,4,5,4,0.000245098,862648,0.972984435
14857,265,302,5,4,0.000245098,862653,0.972990074
14859,458,105,5,4,0.000245098,862658,0.972995714
18464,10,446,5,4,0.000245098,862663,0.973001353
14872,33,507,5,4,0.000245098,862668,0.973006993
18460,14,689,5,4,0.000245098,862673,0.973012633
18502,105,43,5,4,0.000245098,862678,0.973018272
20272,167,50,5,4,0.000245098,862683,0.973023912
22870,243,54,5,4,0.000245098,862688,0.973029551
17603,261,68,5,4,0.000245098,862693,0.973035191
20789,721,473,5,4,0.000245098,862698,0.97304083
17744,528,6,5,4,0.000245098,862703,0.97304647
15868,689,508,5,4,0.000245098,862708,0.973052109
21001,294,473,5,4,0.000245098,862713,0.973057749
18487,632,587,5,4,0.000245098,862718,0.973063388
20793,105,668,5,4,0.000245098,862723,0.973069028
15845,701,10,5,4,0.000245098,862728,0.973074667
20224,25,508,5,4,0.000245098,862733,0.973080307
25661,668,23,5,4,0.000245098,862738,0.973085946
14955,29,224,5,4,0.000245098,862743,0.973091586
23379,54,689,5,4,0.000245098,862748,0.973097225
17657,171,535,5,4,0.000245098,862753,0.973102865
22709,448,131,5,4,0.000245098,862758,0.973108504
25536,719,655,5,4,0.000245098,862763,0.973114144
18260,463,364,5,4,0.000245098,862768,0.973119783
24966,427,714,5,4,0.000245098,862773,0.973125423
10234,310,85,5,4,0.000245098,862778,0.973131062
18443,164,588,5,4,0.000245098,862783,0.973136702
14917,668,158,5,4,0.000245098,862788,0.973142342
15830,243,34,5,4,0.000245098,862793,0.973147981
16135,493,264,5,4,0.000245098,862798,0.973153621
22228,479,383,5,4,0.000245098,862803,0.97315926
17372,193,10,5,4,0.000245098,862808,0.9731649
20742,383,605,5,4,0.000245098,862813,0.973170539
22235,56,652,5,4,0.000245098,862818,0.973176179
20744,174,307,5,4,0.000245098,862823,0.973181818
25048,250,1,5,4,0.000245098,862828,0.973187458
22194,163,114,5,4,0.000245098,862833,0.973193097
18959,501,689,5,4,0.000245098,862838,0.973198737
18951,20,427,5,4,0.000245098,862843,0.973204376
18942,1,586,5,4,0.000245098,862848,0.973210016
15221,502,117,5,4,0.000245098,862853,0.973215655
18909,624,335,5,4,0.000245098,862858,0.973221295
17395,514,31,5,4,0.000245098,862863,0.973226934
22270,552,56,5,4,0.000245098,862868,0.973232574
20921,22,638,5,4,0.000245098,862873,0.973238213
22260,56,544,5,4,0.000245098,862878,0.973243853
23627,264,663,5,4,0.000245098,862883,0.973249492
14331,596,508,5,4,0.000245098,862888,0.973255132
24654,23,204,5,4,0.000245098,862893,0.973260771
24655,528,12,5,4,0.000245098,862898,0.973266411
23629,175,126,5,4,0.000245098,862903,0.973272051
16106,502,535,5,4,0.000245098,862908,0.97327769
22258,34,661,5,4,0.000245098,862913,0.97328333
20736,145,124,5,4,0.000245098,862918,0.973288969
18963,25,95,5,4,0.000245098,862923,0.973294609
26067,379,124,5,4,0.000245098,862928,0.973300248
18138,246,32,5,4,0.000245098,862933,0.973305888
22137,43,614,5,4,0.000245098,862938,0.973311527
21119,22,155,5,4,0.000245098,862943,0.973317167
19021,230,448,5,4,0.000245098,862948,0.973322806
24545,517,265,5,4,0.000245098,862953,0.973328446
21122,4,34,5,4,0.000245098,862958,0.973334085
24539,202,97,5,4,0.000245098,862963,0.973339725
19051,458,64,5,4,0.000245098,862968,0.973345364
23689,85,107,5,4,0.000245098,862973,0.973351004
26039,250,673,5,4,0.000245098,862978,0.973356643
25049,717,10,5,4,0.000245098,862983,0.973362283
20496,632,126,5,4,0.000245098,862988,0.973367922
20734,121,123,5,4,0.000245098,862993,0.973373562
18972,95,501,5,4,0.000245098,862998,0.973379201
16175,379,482,5,4,0.000245098,863003,0.973384841
15229,638,64,5,4,0.000245098,863008,0.97339048
15252,655,30,5,4,0.000245098,863013,0.97339612
20107,265,332,5,4,0.000245098,863018,0.97340176
19010,264,497,5,4,0.000245098,863023,0.973407399
19006,605,14,5,4,0.000245098,863028,0.973413039
14198,332,105,5,4,0.000245098,863033,0.973418678
18996,130,392,5,4,0.000245098,863038,0.973424318
20924,717,15,5,4,0.000245098,863043,0.973429957
22935,511,274,5,4,0.000245098,863048,0.973435597
18796,514,95,5,4,0.000245098,863053,0.973441236
20463,492,535,5,4,0.000245098,863058,0.973446876
22340,6,319,5,4,0.000245098,863063,0.973452515
20145,264,164,5,4,0.000245098,863068,0.973458155
18780,56,508,5,4,0.000245098,863073,0.973463794
20142,367,587,5,4,0.000245098,863078,0.973469434
20140,446,1,5,4,0.000245098,863083,0.973475073
18821,493,393,5,4,0.000245098,863088,0.973480713
22319,219,593,5,4,0.000245098,863093,0.973486352
22332,497,140,5,4,0.000245098,863098,0.973491992
18804,14,26,5,4,0.000245098,863103,0.973497631
24722,335,160,5,4,0.000245098,863108,0.973503271
20456,50,614,5,4,0.000245098,863113,0.97350891
16020,439,243,5,4,0.000245098,863118,0.97351455
17775,392,50,5,4,0.000245098,863123,0.973520189
18739,558,383,5,4,0.000245098,863128,0.973525829
21075,202,131,5,4,0.000245098,863133,0.973531469
18738,663,605,5,4,0.000245098,863138,0.973537108
18733,43,20,5,4,0.000245098,863143,0.973542748
22415,155,77,5,4,0.000245098,863148,0.973548387
18771,655,328,5,4,0.000245098,863153,0.973554027
22925,64,393,5,4,0.000245098,863158,0.973559666
24732,178,498,5,4,0.000245098,863163,0.973565306
22924,335,684,5,4,0.000245098,863168,0.973570945
24763,56,207,5,4,0.000245098,863173,0.973576585
22949,596,673,5,4,0.000245098,863178,0.973582224
15681,655,588,5,4,0.000245098,863183,0.973587864
22285,64,427,5,4,0.000245098,863188,0.973593503
17425,562,689,5,4,0.000245098,863193,0.973599143
22298,114,640,5,4,0.000245098,863198,0.973604782
25962,347,392,5,4,0.000245098,863203,0.973610422
22277,269,131,5,4,0.000245098,863208,0.973616061
21046,167,532,4,4,0.000196078,863212,0.973620573
21256,43,544,4,4,0.000196078,863216,0.973625085
21118,673,383,4,4,0.000196078,863220,0.973629596
28430,638,23,4,4,0.000196078,863224,0.973634108
27176,646,64,4,4,0.000196078,863228,0.973638619
20857,582,668,4,4,0.000196078,863232,0.973643131
20888,683,354,4,4,0.000196078,863236,0.973647643
21078,50,25,4,4,0.000196078,863240,0.973652154
21295,19,97,4,4,0.000196078,863244,0.973656666
21008,202,29,4,4,0.000196078,863248,0.973661178
20709,121,23,4,4,0.000196078,863252,0.973665689
27172,19,280,4,4,0.000196078,863256,0.973670201
27056,13,528,4,4,0.000196078,863260,0.973674712
20769,19,30,4,4,0.000196078,863264,0.973679224
28394,701,646,4,4,0.000196078,863268,0.973683736
21209,392,114,4,4,0.000196078,863272,0.973688247
21214,475,25,4,4,0.000196078,863276,0.973692759
21135,155,123,4,4,0.000196078,863280,0.97369727
20651,543,265,4,4,0.000196078,863284,0.973701782
20712,528,117,4,4,0.000196078,863288,0.973706294
20624,204,265,4,4,0.000196078,863292,0.973710805
21007,22,502,4,4,0.000196078,863296,0.973715317
20940,178,302,4,4,0.000196078,863300,0.973719829
20648,80,181,4,4,0.000196078,863304,0.97372434
20685,364,560,4,4,0.000196078,863308,0.973728852
21020,193,532,4,4,0.000196078,863312,0.973733363
21133,158,571,4,4,0.000196078,863316,0.973737875
21047,140,4,4,4,0.000196078,863320,0.973742387
20959,543,117,4,4,0.000196078,863324,0.973746898
20948,674,195,4,4,0.000196078,863328,0.97375141
27911,141,535,4,4,0.000196078,863332,0.973755921
27361,140,30,4,4,0.000196078,863336,0.973760433
21206,11,64,4,4,0.000196078,863340,0.973764945
27478,463,246,4,4,0.000196078,863344,0.973769456
20667,479,507,4,4,0.000196078,863348,0.973773968
28258,163,652,4,4,0.000196078,863352,0.97377848
27945,492,632,4,4,0.000196078,863356,0.973782991
20932,141,335,4,4,0.000196078,863360,0.973787503
21308,385,170,4,4,0.000196078,863364,0.973792014
21010,12,54,4,4,0.000196078,863368,0.973796526
20949,543,364,4,4,0.000196078,863372,0.973801038
28216,684,85,4,4,0.000196078,863376,0.973805549
20907,471,448,4,4,0.000196078,863380,0.973810061
21098,155,31,4,4,0.000196078,863384,0.973814573
21009,699,471,4,4,0.000196078,863388,0.973819084
28126,571,224,4,4,0.000196078,863392,0.973823596
21132,95,174,4,4,0.000196078,863396,0.973828107
20968,264,605,4,4,0.000196078,863400,0.973832619
20721,383,130,4,4,0.000196078,863404,0.973837131
27677,124,290,4,4,0.000196078,863408,0.973841642
27228,646,475,4,4,0.000196078,863412,0.973846154
21068,682,328,4,4,0.000196078,863416,0.973850665
20879,2,528,4,4,0.000196078,863420,0.973855177
21296,682,414,4,4,0.000196078,863424,0.973859689
20681,12,22,4,4,0.000196078,863428,0.9738642
21301,618,544,4,4,0.000196078,863432,0.973868712
21093,528,158,4,4,0.000196078,863436,0.973873224
20836,497,54,4,4,0.000196078,863440,0.973877735
20823,25,3,4,4,0.000196078,863444,0.973882247
20895,535,673,4,4,0.000196078,863448,0.973886758
20860,13,141,4,4,0.000196078,863452,0.97389127
21272,353,446,4,4,0.000196078,863456,0.973895782
20633,261,130,4,4,0.000196078,863460,0.973900293
20758,290,708,4,4,0.000196078,863464,0.973904805
28549,668,126,4,4,0.000196078,863468,0.973909316
20738,517,511,4,4,0.000196078,863472,0.973913828
20922,514,348,4,4,0.000196078,863476,0.97391834
20673,207,219,4,4,0.000196078,863480,0.973922851
21231,181,473,4,4,0.000196078,863484,0.973927363
21228,364,596,4,4,0.000196078,863488,0.973931875
21175,558,4,4,4,0.000196078,863492,0.973936386
20692,163,404,4,4,0.000196078,863496,0.973940898
20938,33,646,4,4,0.000196078,863500,0.973945409
20693,543,274,4,4,0.000196078,863504,0.973949921
20652,20,514,4,4,0.000196078,863508,0.973954433
20941,586,23,4,4,0.000196078,863512,0.973958944
21183,332,586,4,4,0.000196078,863516,0.973963456
20827,195,335,4,4,0.000196078,863520,0.973967968
28058,14,207,4,4,0.000196078,863524,0.973972479
21267,196,571,4,4,0.000196078,863528,0.973976991
20792,20,393,4,4,0.000196078,863532,0.973981502
20796,19,638,4,4,0.000196078,863536,0.973986014
20640,448,16,4,4,0.000196078,863540,0.973990526
21239,397,85,4,4,0.000196078,863544,0.973995037
20653,219,56,4,4,0.000196078,863548,0.973999549
20800,463,385,4,4,0.000196078,863552,0.97400406
20674,3,613,4,4,0.000196078,863556,0.974008572
21019,544,64,4,4,0.000196078,863560,0.974013084
28183,90,498,4,4,0.000196078,863564,0.974017595
21153,354,163,4,4,0.000196078,863568,0.974022107
20819,307,54,4,4,0.000196078,863572,0.974026619
21108,64,354,4,4,0.000196078,863576,0.97403113
20849,29,158,4,4,0.000196078,863580,0.974035642
27874,97,140,4,4,0.000196078,863584,0.974040153
20804,544,274,4,4,0.000196078,863588,0.974044665
28531,50,90,4,4,0.000196078,863592,0.974049177
20701,20,502,4,4,0.000196078,863596,0.974053688
20704,514,56,4,4,0.000196078,863600,0.9740582
20757,383,56,4,4,0.000196078,863604,0.974062711
21041,471,507,4,4,0.000196078,863608,0.974067223
20978,140,439,4,4,0.000196078,863612,0.974071735
20755,525,50,4,4,0.000196078,863616,0.974076246
21190,502,471,4,4,0.000196078,863620,0.974080758
21116,167,29,4,4,0.000196078,863624,0.97408527
20861,535,167,4,4,0.000196078,863628,0.974089781
21191,528,682,4,4,0.000196078,863632,0.974094293
27170,497,2,4,4,0.000196078,863636,0.974098804
27213,719,103,4,4,0.000196078,863640,0.974103316
28542,114,507,4,4,0.000196078,863644,0.974107828
20981,77,138,4,4,0.000196078,863648,0.974112339
27108,167,501,4,4,0.000196078,863652,0.974116851
21187,219,494,4,4,0.000196078,863656,0.974121363
20737,393,126,4,4,0.000196078,863660,0.974125874
20695,43,29,4,4,0.000196078,863664,0.974130386
21011,219,618,4,4,0.000196078,863668,0.974134897
20658,682,156,4,4,0.000196078,863672,0.974139409
20897,5,394,4,4,0.000196078,863676,0.974143921
27534,427,514,4,4,0.000196078,863680,0.974148432
27193,414,2,4,4,0.000196078,863684,0.974152944
20852,224,668,4,4,0.000196078,863688,0.974157455
28047,684,427,4,4,0.000196078,863692,0.974161967
20925,720,56,4,4,0.000196078,863696,0.974166479
27952,29,508,4,4,0.000196078,863700,0.97417099
20756,32,684,4,4,0.000196078,863704,0.974175502
20659,1,178,4,4,0.000196078,863708,0.974180014
21146,684,347,4,4,0.000196078,863712,0.974184525
21160,398,562,4,4,0.000196078,863716,0.974189037
24131,43,171,4,4,0.000196078,863720,0.974193548
21310,22,3,4,4,0.000196078,863724,0.97419806
25042,719,34,4,4,0.000196078,863728,0.974202572
23227,721,640,4,4,0.000196078,863732,0.974207083
25113,97,178,4,4,0.000196078,863736,0.974211595
25107,236,371,4,4,0.000196078,863740,0.974216106
25106,492,528,4,4,0.000196078,863744,0.974220618
25095,535,193,4,4,0.000196078,863748,0.97422513
23248,5,587,4,4,0.000196078,863752,0.974229641
23251,492,479,4,4,0.000196078,863756,0.974234153
25086,155,5,4,4,0.000196078,863760,0.974238665
25083,20,364,4,4,0.000196078,863764,0.974243176
25077,414,562,4,4,0.000196078,863768,0.974247688
23260,507,562,4,4,0.000196078,863772,0.974252199
23263,364,130,4,4,0.000196078,863776,0.974256711
23270,414,613,4,4,0.000196078,863780,0.974261223
23271,613,68,4,4,0.000196078,863784,0.974265734
23226,503,130,4,4,0.000196078,863788,0.974270246
23224,2,246,4,4,0.000196078,863792,0.974274758
23212,30,448,4,4,0.000196078,863796,0.974279269
23174,414,544,4,4,0.000196078,863800,0.974283781
23133,124,307,4,4,0.000196078,863804,0.974288292
25162,525,638,4,4,0.000196078,863808,0.974292804
25157,30,652,4,4,0.000196078,863812,0.974297316
23166,552,507,4,4,0.000196078,863816,0.974301827
23168,674,392,4,4,0.000196078,863820,0.974306339
23182,124,663,4,4,0.000196078,863824,0.97431085
25154,626,475,4,4,0.000196078,863828,0.974315362
23193,699,331,4,4,0.000196078,863832,0.974319874
25148,202,295,4,4,0.000196078,863836,0.974324385
25139,364,274,4,4,0.000196078,863840,0.974328897
25137,393,13,4,4,0.000196078,863844,0.974333409
23203,121,97,4,4,0.000196078,863848,0.97433792
25130,160,163,4,4,0.000196078,863852,0.974342432
23294,618,242,4,4,0.000196078,863856,0.974346943
24887,448,517,4,4,0.000196078,863860,0.974351455
23389,701,27,4,4,0.000196078,863864,0.974355967
23390,31,207,4,4,0.000196078,863868,0.974360478
23392,50,448,4,4,0.000196078,863872,0.97436499
23397,614,392,4,4,0.000196078,863876,0.974369501
24961,689,587,4,4,0.000196078,863880,0.974374013
24958,714,84,4,4,0.000196078,863884,0.974378525
23400,243,12,4,4,0.000196078,863888,0.974383036
24952,141,265,4,4,0.000196078,863892,0.974387548
23404,290,655,4,4,0.000196078,863896,0.97439206
23413,683,558,4,4,0.000196078,863900,0.974396571
23421,507,97,4,4,0.000196078,863904,0.974401083
23424,97,448,4,4,0.000196078,863908,0.974405594
24949,269,414,4,4,0.000196078,863912,0.974410106
23430,170,26,4,4,0.000196078,863916,0.974414618
23432,3,163,4,4,0.000196078,863920,0.974419129
24925,332,463,4,4,0.000196078,863924,0.974423641
23440,471,543,4,4,0.000196078,863928,0.974428152
24924,15,175,4,4,0.000196078,863932,0.974432664
23386,13,140,4,4,0.000196078,863936,0.974437176
25011,16,525,4,4,0.000196078,863940,0.974441687
25022,522,181,4,4,0.000196078,863944,0.974446199
24973,175,511,4,4,0.000196078,863948,0.974450711
23367,463,140,4,4,0.000196078,863952,0.974455222
24986,261,493,4,4,0.000196078,863956,0.974459734
24981,290,50,4,4,0.000196078,863960,0.974464245
24979,56,181,4,4,0.000196078,863964,0.974468757
25186,126,64,4,4,0.000196078,863968,0.974473269
23128,586,409,4,4,0.000196078,863972,0.97447778
22937,719,471,4,4,0.000196078,863976,0.974482292
22942,482,663,4,4,0.000196078,863980,0.974486804
22943,160,674,4,4,0.000196078,863984,0.974491315
22945,535,171,4,4,0.000196078,863988,0.974495827
22955,126,26,4,4,0.000196078,863992,0.974500338
22961,379,193,4,4,0.000196078,863996,0.97450485
22963,5,544,4,4,0.000196078,864000,0.974509362
25495,126,204,4,4,0.000196078,864004,0.974513873
25488,646,558,4,4,0.000196078,864008,0.974518385
22975,175,558,4,4,0.000196078,864012,0.974522896
22983,155,535,4,4,0.000196078,864016,0.974527408
22984,502,618,4,4,0.000196078,864020,0.97453192
22995,219,195,4,4,0.000196078,864024,0.974536431
25445,367,319,4,4,0.000196078,864028,0.974540943
22868,23,22,4,4,0.000196078,864032,0.974545455
25551,498,332,4,4,0.000196078,864036,0.974549966
25537,130,446,4,4,0.000196078,864040,0.974554478
22849,334,502,4,4,0.000196078,864044,0.974558989
22866,121,85,4,4,0.000196078,864048,0.974563501
25525,126,80,4,4,0.000196078,864052,0.974568013
22873,14,178,4,4,0.000196078,864056,0.974572524
22906,13,171,4,4,0.000196078,864060,0.974577036
25520,264,23,4,4,0.000196078,864064,0.974581547
22889,167,582,4,4,0.000196078,864068,0.974586059
25519,121,54,4,4,0.000196078,864072,0.974590571
22902,719,535,4,4,0.000196078,864076,0.974595082
25508,719,97,4,4,0.000196078,864080,0.974599594
25441,708,328,4,4,0.000196078,864084,0.974604106
25427,353,90,4,4,0.000196078,864088,0.974608617
25261,479,269,4,4,0.000196078,864092,0.974613129
25298,618,398,4,4,0.000196078,864096,0.97461764
23079,243,261,4,4,0.000196078,864100,0.974622152
25293,684,558,4,4,0.000196078,864104,0.974626664
25285,204,701,4,4,0.000196078,864108,0.974631175
23089,16,673,4,4,0.000196078,864112,0.974635687
25265,145,181,4,4,0.000196078,864116,0.974640199
23093,261,689,4,4,0.000196078,864120,0.97464471
23097,5,56,4,4,0.000196078,864124,0.974649222
23072,618,294,4,4,0.000196078,864128,0.974653733
25248,85,224,4,4,0.000196078,864132,0.974658245
25244,290,77,4,4,0.000196078,864136,0.974662757
23108,261,364,4,4,0.000196078,864140,0.974667268
23110,347,701,4,4,0.000196078,864144,0.97467178
25233,409,614,4,4,0.000196078,864148,0.974676291
25213,614,246,4,4,0.000196078,864152,0.974680803
25305,126,471,4,4,0.000196078,864156,0.974685315
25306,446,294,4,4,0.000196078,864160,0.974689826
25390,33,133,4,4,0.000196078,864164,0.974694338
23026,535,261,4,4,0.000196078,864168,0.97469885
25401,121,145,4,4,0.000196078,864172,0.974703361
23029,174,614,4,4,0.000196078,864176,0.974707873
23036,114,383,4,4,0.000196078,864180,0.974712384
25326,224,181,4,4,0.000196078,864184,0.974716896
23040,310,269,4,4,0.000196078,864188,0.974721408
25364,2,507,4,4,0.000196078,864192,0.974725919
23044,497,528,4,4,0.000196078,864196,0.974730431
23046,196,587,4,4,0.000196078,864200,0.974734942
25351,544,155,4,4,0.000196078,864204,0.974739454
23459,19,48,4,4,0.000196078,864208,0.974743966
23986,124,335,4,4,0.000196078,864212,0.974748477
23858,130,137,4,4,0.000196078,864216,0.974752989
24414,155,586,4,4,0.000196078,864220,0.974757501
23864,2,13,4,4,0.000196078,864224,0.974762012
23890,364,614,4,4,0.000196078,864228,0.974766524
24401,652,105,4,4,0.000196078,864232,0.974771035
24392,624,596,4,4,0.000196078,864236,0.974775547
24387,171,528,4,4,0.000196078,864240,0.974780059
24383,202,230,4,4,0.000196078,864244,0.97478457
23926,265,12,4,4,0.000196078,864248,0.974789082
23929,427,385,4,4,0.000196078,864252,0.974793594
23964,167,586,4,4,0.000196078,864256,0.974798105
23965,114,167,4,4,0.000196078,864260,0.974802617
24363,23,9,4,4,0.000196078,864264,0.974807128
23974,439,652,4,4,0.000196078,864268,0.97481164
23851,353,684,4,4,0.000196078,864272,0.974816152
24424,131,624,4,4,0.000196078,864276,0.974820663
24459,174,334,4,4,0.000196078,864280,0.974825175
23814,463,482,4,4,0.000196078,864284,0.974829686
24479,446,646,4,4,0.000196078,864288,0.974834198
24477,719,508,4,4,0.000196078,864292,0.97483871
24476,219,613,4,4,0.000196078,864296,0.974843221
23818,528,126,4,4,0.000196078,864300,0.974847733
24468,13,56,4,4,0.000196078,864304,0.974852245
23819,723,167,4,4,0.000196078,864308,0.974856756
23837,178,29,4,4,0.000196078,864312,0.974861268
23821,699,107,4,4,0.000196078,864316,0.974865779
24445,353,103,4,4,0.000196078,864320,0.974870291
23826,471,156,4,4,0.000196078,864324,0.974874803
24440,124,596,4,4,0.000196078,864328,0.974879314
23833,463,328,4,4,0.000196078,864332,0.974883826
24437,482,3,4,4,0.000196078,864336,0.974888337
23461,332,348,4,4,0.000196078,864340,0.974892849
24215,699,443,4,4,0.000196078,864344,0.974897361
24213,1,587,4,4,0.000196078,864348,0.974901872
24055,280,684,4,4,0.000196078,864352,0.974906384
24057,103,517,4,4,0.000196078,864356,0.974910896
24067,114,482,4,4,0.000196078,864360,0.974915407
24201,29,130,4,4,0.000196078,864364,0.974919919
24187,593,85,4,4,0.000196078,864368,0.97492443
24097,117,674,4,4,0.000196078,864372,0.974928942
24106,475,701,4,4,0.000196078,864376,0.974933454
24112,274,482,4,4,0.000196078,864380,0.974937965
24161,663,684,4,4,0.000196078,864384,0.974942477
24156,156,385,4,4,0.000196078,864388,0.974946988
24153,609,383,4,4,0.000196078,864392,0.9749515
24036,133,544,4,4,0.000196078,864396,0.974956012
24032,723,427,4,4,0.000196078,864400,0.974960523
24027,64,497,4,4,0.000196078,864404,0.974965035
24312,207,13,4,4,0.000196078,864408,0.974969547
24329,31,528,4,4,0.000196078,864412,0.974974058
24328,43,448,4,4,0.000196078,864416,0.97497857
24326,503,463,4,4,0.000196078,864420,0.974983081
24319,224,571,4,4,0.000196078,864424,0.974987593
24007,121,609,4,4,0.000196078,864428,0.974992105
24318,528,552,4,4,0.000196078,864432,0.974996616
24019,503,497,4,4,0.000196078,864436,0.975001128
24294,348,458,4,4,0.000196078,864440,0.97500564
24010,311,371,4,4,0.000196078,864444,0.975010151
24270,138,68,4,4,0.000196078,864448,0.975014663
24268,126,196,4,4,0.000196078,864452,0.975019174
24252,13,250,4,4,0.000196078,864456,0.975023686
24242,97,605,4,4,0.000196078,864460,0.975028198
24018,458,196,4,4,0.000196078,864464,0.975032709
23801,668,170,4,4,0.000196078,864468,0.975037221
23795,114,544,4,4,0.000196078,864472,0.975041732
23788,13,167,4,4,0.000196078,864476,0.975046244
24691,397,103,4,4,0.000196078,864480,0.975050756
23576,5,170,4,4,0.000196078,864484,0.975055267
23583,347,511,4,4,0.000196078,864488,0.975059779
24678,175,618,4,4,0.000196078,864492,0.975064291
23584,482,280,4,4,0.000196078,864496,0.975068802
23592,10,701,4,4,0.000196078,864500,0.975073314
23595,31,364,4,4,0.000196078,864504,0.975077825
24665,155,479,4,4,0.000196078,864508,0.975082337
23616,348,23,4,4,0.000196078,864512,0.975086849
23619,511,265,4,4,0.000196078,864516,0.97509136
23628,54,414,4,4,0.000196078,864520,0.975095872
24651,25,482,4,4,0.000196078,864524,0.975100383
23638,204,332,4,4,0.000196078,864528,0.975104895
23639,409,219,4,4,0.000196078,864532,0.975109407
24700,497,618,4,4,0.000196078,864536,0.975113918
23491,593,269,4,4,0.000196078,864540,0.97511843
24851,64,84,4,4,0.000196078,864544,0.975122942
23463,13,508,4,4,0.000196078,864548,0.975127453
24826,364,501,4,4,0.000196078,864552,0.975131965
23465,507,587,4,4,0.000196078,864556,0.975136476
24820,107,181,4,4,0.000196078,864560,0.975140988
23473,195,97,4,4,0.000196078,864564,0.9751455
24811,167,313,4,4,0.000196078,864568,0.975150011
24809,613,427,4,4,0.000196078,864572,0.975154523
24725,236,492,4,4,0.000196078,864576,0.975159035
23493,133,163,4,4,0.000196078,864580,0.975163546
24788,54,596,4,4,0.000196078,864584,0.975168058
24772,178,64,4,4,0.000196078,864588,0.975172569
24753,1,264,4,4,0.000196078,864592,0.975177081
24737,124,543,4,4,0.000196078,864596,0.975181593
24644,342,586,4,4,0.000196078,864600,0.975186104
23644,562,175,4,4,0.000196078,864604,0.975190616
23711,409,6,4,4,0.000196078,864608,0.975195127
24516,193,552,4,4,0.000196078,864612,0.975199639
23714,68,319,4,4,0.000196078,864616,0.975204151
23735,661,302,4,4,0.000196078,864620,0.975208662
23738,689,446,4,4,0.000196078,864624,0.975213174
23745,16,342,4,4,0.000196078,864628,0.975217686
24510,683,50,4,4,0.000196078,864632,0.975222197
23750,514,133,4,4,0.000196078,864636,0.975226709
24532,414,167,4,4,0.000196078,864640,0.97523122
23758,5,140,4,4,0.000196078,864644,0.975235732
23767,68,371,4,4,0.000196078,864648,0.975240244
23778,586,587,4,4,0.000196078,864652,0.975244755
24523,347,328,4,4,0.000196078,864656,0.975249267
23699,439,274,4,4,0.000196078,864660,0.975253778
24640,19,609,4,4,0.000196078,864664,0.97525829
24603,717,310,4,4,0.000196078,864668,0.975262802
23659,364,114,4,4,0.000196078,864672,0.975267313
23664,141,145,4,4,0.000196078,864676,0.975271825
24614,156,23,4,4,0.000196078,864680,0.975276337
23665,261,347,4,4,0.000196078,864684,0.975280848
23666,673,13,4,4,0.000196078,864688,0.97528536
24605,632,207,4,4,0.000196078,864692,0.975289871
24601,497,126,4,4,0.000196078,864696,0.975294383
23698,618,274,4,4,0.000196078,864700,0.975298895
24583,15,163,4,4,0.000196078,864704,0.975303406
24578,5,193,4,4,0.000196078,864708,0.975307918
24549,332,313,4,4,0.000196078,864712,0.97531243
23673,155,379,4,4,0.000196078,864716,0.975316941
23682,163,414,4,4,0.000196078,864720,0.975321453
24536,6,684,4,4,0.000196078,864724,0.975325964
23696,458,219,4,4,0.000196078,864728,0.975330476
22832,414,383,4,4,0.000196078,864732,0.975334988
22817,243,493,4,4,0.000196078,864736,0.975339499
27051,242,427,4,4,0.000196078,864740,0.975344011
21798,393,613,4,4,0.000196078,864744,0.975348522
21809,302,290,4,4,0.000196078,864748,0.975353034
21820,175,347,4,4,0.000196078,864752,0.975357546
21838,307,482,4,4,0.000196078,864756,0.975362057
26389,717,181,4,4,0.000196078,864760,0.975366569
21859,5,107,4,4,0.000196078,864764,0.975371081
26384,498,493,4,4,0.000196078,864768,0.975375592
21861,684,230,4,4,0.000196078,864772,0.975380104
21862,482,367,4,4,0.000196078,864776,0.975384615
21866,14,439,4,4,0.000196078,864780,0.975389127
21872,334,14,4,4,0.000196078,864784,0.975393639
21876,331,138,4,4,0.000196078,864788,0.97539815
26368,443,618,4,4,0.000196078,864792,0.975402662
21794,673,661,4,4,0.000196078,864796,0.975407173
21789,121,586,4,4,0.000196078,864800,0.975411685
21730,121,2,4,4,0.000196078,864804,0.975416197
21737,398,126,4,4,0.000196078,864808,0.975420708
26481,334,613,4,4,0.000196078,864812,0.97542522
21741,158,328,4,4,0.000196078,864816,0.975429732
21751,471,274,4,4,0.000196078,864820,0.975434243
21764,4,682,4,4,0.000196078,864824,0.975438755
26446,294,167,4,4,0.000196078,864828,0.975443266
21773,167,174,4,4,0.000196078,864832,0.975447778
26445,409,364,4,4,0.000196078,864836,0.97545229
21776,294,105,4,4,0.000196078,864840,0.975456801
21785,43,501,4,4,0.000196078,864844,0.975461313
21885,596,721,4,4,0.000196078,864848,0.975465824
21889,242,475,4,4,0.000196078,864852,0.975470336
22072,586,332,4,4,0.000196078,864856,0.975474848
21892,5,397,4,4,0.000196078,864860,0.975479359
26238,674,494,4,4,0.000196078,864864,0.975483871
21984,613,397,4,4,0.000196078,864868,0.975488383
21986,15,54,4,4,0.000196078,864872,0.975492894
26235,427,605,4,4,0.000196078,864876,0.975497406
26229,522,138,4,4,0.000196078,864880,0.975501917
22007,593,544,4,4,0.000196078,864884,0.975506429
22012,646,497,4,4,0.000196078,864888,0.975510941
22015,720,50,4,4,0.000196078,864892,0.975515452
22017,618,552,4,4,0.000196078,864896,0.975519964
22025,493,121,4,4,0.000196078,864900,0.975524476
22033,661,311,4,4,0.000196078,864904,0.975528987
22044,663,624,4,4,0.000196078,864908,0.975533499
22049,427,242,4,4,0.000196078,864912,0.97553801
22060,552,54,4,4,0.000196078,864916,0.975542522
22063,64,6,4,4,0.000196078,864920,0.975547034
26170,652,30,4,4,0.000196078,864924,0.975551545
21970,174,3,4,4,0.000196078,864928,0.975556057
26318,701,517,4,4,0.000196078,864932,0.975560568
21893,439,544,4,4,0.000196078,864936,0.97556508
21894,552,174,4,4,0.000196078,864940,0.975569592
26337,624,443,4,4,0.000196078,864944,0.975574103
21907,1,609,4,4,0.000196078,864948,0.975578615
21909,353,448,4,4,0.000196078,864952,0.975583127
26332,30,124,4,4,0.000196078,864956,0.975587638
26331,193,535,4,4,0.000196078,864960,0.97559215
21923,269,264,4,4,0.000196078,864964,0.975596661
21950,264,117,4,4,0.000196078,864968,0.975601173
26293,302,124,4,4,0.000196078,864972,0.975605685
21943,463,571,4,4,0.000196078,864976,0.975610196
26288,398,652,4,4,0.000196078,864980,0.975614708
21948,535,507,4,4,0.000196078,864984,0.975619219
21709,609,170,4,4,0.000196078,864988,0.975623731
21698,507,34,4,4,0.000196078,864992,0.975628243
21696,640,364,4,4,0.000196078,864996,0.975632754
21446,311,137,4,4,0.000196078,865000,0.975637266
21452,10,43,4,4,0.000196078,865004,0.975641778
21455,332,614,4,4,0.000196078,865008,0.975646289
26881,124,2,4,4,0.000196078,865012,0.975650801
21459,121,95,4,4,0.000196078,865016,0.975655312
21464,492,439,4,4,0.000196078,865020,0.975659824
21477,347,661,4,4,0.000196078,865024,0.975664336
21486,409,224,4,4,0.000196078,865028,0.975668847
21491,29,385,4,4,0.000196078,865032,0.975673359
21497,535,174,4,4,0.000196078,865036,0.975677871
21499,354,624,4,4,0.000196078,865040,0.975682382
26878,171,54,4,4,0.000196078,865044,0.975686894
26876,155,193,4,4,0.000196078,865048,0.975691405
21445,50,26,4,4,0.000196078,865052,0.975695917
26886,328,195,4,4,0.000196078,865056,0.975700429
21439,448,10,4,4,0.000196078,865060,0.97570494
27047,5,130,4,4,0.000196078,865064,0.975709452
21328,353,613,4,4,0.000196078,865068,0.975713963
26995,684,64,4,4,0.000196078,865072,0.975718475
21340,311,23,4,4,0.000196078,865076,0.975722987
21346,668,236,4,4,0.000196078,865080,0.975727498
26987,107,569,4,4,0.000196078,865084,0.97573201
21364,131,246,4,4,0.000196078,865088,0.975736522
21372,683,11,4,4,0.000196078,865092,0.975741033
21432,202,367,4,4,0.000196078,865096,0.975745545
26971,535,319,4,4,0.000196078,865100,0.975750056
21380,571,522,4,4,0.000196078,865104,0.975754568
21384,493,463,4,4,0.000196078,865108,0.97575908
26926,280,571,4,4,0.000196078,865112,0.975763591
26915,126,243,4,4,0.000196078,865116,0.975768103
21402,160,334,4,4,0.000196078,865120,0.975772614
21406,242,708,4,4,0.000196078,865124,0.975777126
26910,571,463,4,4,0.000196078,865128,0.975781638
21513,34,56,4,4,0.000196078,865132,0.975786149
21523,364,31,4,4,0.000196078,865136,0.975790661
26662,124,535,4,4,0.000196078,865140,0.975795173
21628,261,114,4,4,0.000196078,865144,0.975799684
21630,529,196,4,4,0.000196078,865148,0.975804196
21640,334,560,4,4,0.000196078,865152,0.975808707
21645,380,124,4,4,0.000196078,865156,0.975813219
21650,178,30,4,4,0.000196078,865160,0.975817731
21670,121,723,4,4,0.000196078,865164,0.975822242
21681,34,652,4,4,0.000196078,865168,0.975826754
21685,439,4,4,4,0.000196078,865172,0.975831266
21690,427,543,4,4,0.000196078,865176,0.975835777
21693,313,90,4,4,0.000196078,865180,0.975840289
26611,181,131,4,4,0.000196078,865184,0.9758448
21625,398,163,4,4,0.000196078,865188,0.975849312
21621,596,133,4,4,0.000196078,865192,0.975853824
21569,9,175,4,4,0.000196078,865196,0.975858335
21530,250,552,4,4,0.000196078,865200,0.975862847
21533,392,11,4,4,0.000196078,865204,0.975867358
21535,544,164,4,4,0.000196078,865208,0.97587187
21550,525,723,4,4,0.000196078,865212,0.975876382
21551,160,77,4,4,0.000196078,865216,0.975880893
21557,446,33,4,4,0.000196078,865220,0.975885405
21563,517,242,4,4,0.000196078,865224,0.975889917
21620,140,414,4,4,0.000196078,865228,0.975894428
21586,502,646,4,4,0.000196078,865232,0.97589894
21594,479,140,4,4,0.000196078,865236,0.975903451
26775,156,624,4,4,0.000196078,865240,0.975907963
21601,160,514,4,4,0.000196078,865244,0.975912475
26761,34,673,4,4,0.000196078,865248,0.975916986
26760,392,682,4,4,0.000196078,865252,0.975921498
22075,492,638,4,4,0.000196078,865256,0.975926009
22814,34,446,4,4,0.000196078,865260,0.975930521
22582,181,123,4,4,0.000196078,865264,0.975935033
25769,302,319,4,4,0.000196078,865268,0.975939544
22589,507,404,4,4,0.000196078,865272,0.975944056
25765,19,501,4,4,0.000196078,865276,0.975948568
22604,522,163,4,4,0.000196078,865280,0.975953079
22611,3,103,4,4,0.000196078,865284,0.975957591
25746,586,1,4,4,0.000196078,865288,0.975962102
22624,126,95,4,4,0.000196078,865292,0.975966614
25744,560,552,4,4,0.000196078,865296,0.975971126
22633,9,458,4,4,0.000196078,865300,0.975975637
22634,56,103,4,4,0.000196078,865304,0.975980149
25733,458,543,4,4,0.000196078,865308,0.975984661
22652,80,492,4,4,0.000196078,865312,0.975989172
25851,618,502,4,4,0.000196078,865316,0.975993684
22449,33,446,4,4,0.000196078,865320,0.975998195
22457,511,114,4,4,0.000196078,865324,0.976002707
22466,605,517,4,4,0.000196078,865328,0.976007219
22473,77,342,4,4,0.000196078,865332,0.97601173
25862,10,175,4,4,0.000196078,865336,0.976016242
22479,193,507,4,4,0.000196078,865340,0.976020753
22542,517,4,4,4,0.000196078,865344,0.976025265
22501,193,26,4,4,0.000196078,865348,0.976029777
22503,708,560,4,4,0.000196078,865352,0.976034288
25798,471,613,4,4,0.000196078,865356,0.9760388
22521,19,145,4,4,0.000196078,865360,0.976043312
22525,9,138,4,4,0.000196078,865364,0.976047823
22527,684,379,4,4,0.000196078,865368,0.976052335
22531,683,236,4,4,0.000196078,865372,0.976056846
25726,195,632,4,4,0.000196078,865376,0.976061358
25702,117,167,4,4,0.000196078,865380,0.97606587
22077,269,367,4,4,0.000196078,865384,0.976070381
22666,32,12,4,4,0.000196078,865388,0.976074893
25603,140,171,4,4,0.000196078,865392,0.976079404
22769,684,34,4,4,0.000196078,865396,0.976083916
25579,50,661,4,4,0.000196078,865400,0.976088428
22771,131,332,4,4,0.000196078,865404,0.976092939
25570,528,502,4,4,0.000196078,865408,0.976097451
22778,140,714,4,4,0.000196078,865412,0.976101963
22780,582,684,4,4,0.000196078,865416,0.976106474
22786,392,68,4,4,0.000196078,865420,0.976110986
22792,170,522,4,4,0.000196078,865424,0.976115497
22794,379,174,4,4,0.000196078,865428,0.976120009
22802,335,137,4,4,0.000196078,865432,0.976124521
22806,178,632,4,4,0.000196078,865436,0.976129032
25557,517,290,4,4,0.000196078,865440,0.976133544
22753,493,385,4,4,0.000196078,865444,0.976138055
25627,503,501,4,4,0.000196078,865448,0.976142567
22752,123,494,4,4,0.000196078,865452,0.976147079
22706,261,558,4,4,0.000196078,865456,0.97615159
25683,517,714,4,4,0.000196078,865460,0.976156102
25671,5,328,4,4,0.000196078,865464,0.976160614
22688,392,655,4,4,0.000196078,865468,0.976165125
22698,145,364,4,4,0.000196078,865472,0.976169637
22701,22,414,4,4,0.000196078,865476,0.976174148
25664,6,43,4,4,0.000196078,865480,0.97617866
22705,353,673,4,4,0.000196078,865484,0.976183172
22707,133,170,4,4,0.000196078,865488,0.976187683
25655,181,302,4,4,0.000196078,865492,0.976192195
25650,124,29,4,4,0.000196078,865496,0.976196707
22715,26,482,4,4,0.000196078,865500,0.976201218
22723,294,334,4,4,0.000196078,865504,0.97620573
22728,719,331,4,4,0.000196078,865508,0.976210241
25884,331,319,4,4,0.000196078,865512,0.976214753
25892,427,587,4,4,0.000196078,865516,0.976219265
25895,618,517,4,4,0.000196078,865520,0.976223776
26020,593,508,4,4,0.000196078,865524,0.976228288
22167,492,117,4,4,0.000196078,865528,0.976232799
22169,6,593,4,4,0.000196078,865532,0.976237311
26009,313,124,4,4,0.000196078,865536,0.976241823
26000,427,507,4,4,0.000196078,865540,0.976246334
25996,178,10,4,4,0.000196078,865544,0.976250846
22202,708,25,4,4,0.000196078,865548,0.976255358
22203,5,13,4,4,0.000196078,865552,0.976259869
22214,475,274,4,4,0.000196078,865556,0.976264381
22216,354,29,4,4,0.000196078,865560,0.976268892
22217,50,560,4,4,0.000196078,865564,0.976273404
22220,414,714,4,4,0.000196078,865568,0.976277916
22223,331,525,4,4,0.000196078,865572,0.976282427
25992,404,571,4,4,0.000196078,865576,0.976286939
26055,593,652,4,4,0.000196078,865580,0.97629145
22143,684,354,4,4,0.000196078,865584,0.976295962
22141,721,6,4,4,0.000196078,865588,0.976300474
22111,618,614,4,4,0.000196078,865592,0.976304985
22080,609,587,4,4,0.000196078,865596,0.976309497
22086,624,29,4,4,0.000196078,865600,0.976314009
26089,204,103,4,4,0.000196078,865604,0.97631852
22098,571,543,4,4,0.000196078,865608,0.976323032
22101,50,646,4,4,0.000196078,865612,0.976327543
22106,475,175,4,4,0.000196078,865616,0.976332055
26087,124,614,4,4,0.000196078,865620,0.976336567
22139,29,618,4,4,0.000196078,865624,0.976341078
22120,26,319,4,4,0.000196078,865628,0.97634559
22121,219,193,4,4,0.000196078,865632,0.976350102
26077,20,605,4,4,0.000196078,865636,0.976354613
26072,22,618,4,4,0.000196078,865640,0.976359125
22135,618,427,4,4,0.000196078,865644,0.976363636
22136,528,562,4,4,0.000196078,865648,0.976368148
25976,19,529,4,4,0.000196078,865652,0.97637266
22254,195,171,4,4,0.000196078,865656,0.976377171
22409,492,655,4,4,0.000196078,865660,0.976381683
22384,385,674,4,4,0.000196078,865664,0.976386194
22387,242,479,4,4,0.000196078,865668,0.976390706
22395,9,319,4,4,0.000196078,865672,0.976395218
22399,14,25,4,4,0.000196078,865676,0.976399729
22402,364,33,4,4,0.000196078,865680,0.976404241
22404,6,493,4,4,0.000196078,865684,0.976408753
25919,19,26,4,4,0.000196078,865688,0.976413264
25908,207,605,4,4,0.000196078,865692,0.976417776
22377,560,582,4,4,0.000196078,865696,0.976422287
22423,202,354,4,4,0.000196078,865700,0.976426799
22431,714,219,4,4,0.000196078,865704,0.976431311
25906,380,193,4,4,0.000196078,865708,0.976435822
22436,242,632,4,4,0.000196078,865712,0.976440334
25903,20,414,4,4,0.000196078,865716,0.976444845
22437,131,569,4,4,0.000196078,865720,0.976449357
22267,482,522,4,4,0.000196078,865724,0.976453869
22307,155,393,4,4,0.000196078,865728,0.97645838
25974,171,29,4,4,0.000196078,865732,0.976462892
25966,348,668,4,4,0.000196078,865736,0.976467404
22282,30,364,4,4,0.000196078,865740,0.976471915
25956,683,562,4,4,0.000196078,865744,0.976476427
22294,532,137,4,4,0.000196078,865748,0.976480938
22308,543,13,4,4,0.000196078,865752,0.97648545
22318,97,528,4,4,0.000196078,865756,0.976489962
22326,663,383,4,4,0.000196078,865760,0.976494473
25941,155,130,4,4,0.000196078,865764,0.976498985
22350,328,140,4,4,0.000196078,865768,0.976503497
12080,640,586,4,4,0.000196078,865772,0.976508008
14606,311,618,4,4,0.000196078,865776,0.97651252
16857,689,632,4,4,0.000196078,865780,0.976517031
16861,514,114,4,4,0.000196078,865784,0.976521543
19890,503,331,4,4,0.000196078,865788,0.976526055
16862,123,171,4,4,0.000196078,865792,0.976530566
19889,482,588,4,4,0.000196078,865796,0.976535078
19105,514,15,4,4,0.000196078,865800,0.976539589
19107,439,655,4,4,0.000196078,865804,0.976544101
16874,307,22,4,4,0.000196078,865808,0.976548613
16880,638,56,4,4,0.000196078,865812,0.976553124
19883,30,156,4,4,0.000196078,865816,0.976557636
14621,618,64,4,4,0.000196078,865820,0.976562148
14620,498,121,4,4,0.000196078,865824,0.976566659
16881,458,310,4,4,0.000196078,865828,0.976571171
14617,26,30,4,4,0.000196078,865832,0.976575682
18023,163,274,4,4,0.000196078,865836,0.976580194
19874,156,609,4,4,0.000196078,865840,0.976584706
19115,14,54,4,4,0.000196078,865844,0.976589217
19116,683,107,4,4,0.000196078,865848,0.976593729
16888,588,261,4,4,0.000196078,865852,0.97659824
16890,383,295,4,4,0.000196078,865856,0.976602752
11576,103,80,4,4,0.000196078,865860,0.976607264
13260,632,30,4,4,0.000196078,865864,0.976611775
19075,439,196,4,4,0.000196078,865868,0.976616287
14796,475,155,4,4,0.000196078,865872,0.976620799
14783,646,123,4,4,0.000196078,865876,0.97662531
18084,332,501,4,4,0.000196078,865880,0.976629822
18074,23,498,4,4,0.000196078,865884,0.976634333
14725,494,310,4,4,0.000196078,865888,0.976638845
19928,170,16,4,4,0.000196078,865892,0.976643357
18067,640,328,4,4,0.000196078,865896,0.976647868
16821,30,242,4,4,0.000196078,865900,0.97665238
16822,145,404,4,4,0.000196078,865904,0.976656891
14720,448,230,4,4,0.000196078,865908,0.976661403
18047,5,586,4,4,0.000196078,865912,0.976665915
14673,605,280,4,4,0.000196078,865916,0.976670426
19915,655,196,4,4,0.000196078,865920,0.976674938
19077,663,174,4,4,0.000196078,865924,0.97667945
19912,439,30,4,4,0.000196078,865928,0.976683961
19910,448,638,4,4,0.000196078,865932,0.976688473
19909,689,5,4,4,0.000196078,865936,0.976692984
14658,16,85,4,4,0.000196078,865940,0.976697496
16851,586,479,4,4,0.000196078,865944,0.976702008
18035,174,543,4,4,0.000196078,865948,0.976706519
13289,522,392,4,4,0.000196078,865952,0.976711031
16925,22,295,4,4,0.000196078,865956,0.976715543
16780,34,22,4,4,0.000196078,865960,0.976720054
16939,1,54,4,4,0.000196078,865964,0.976724566
17031,27,721,4,4,0.000196078,865968,0.976729077
17973,16,90,4,4,0.000196078,865972,0.976733589
19791,105,178,4,4,0.000196078,865976,0.976738101
17035,219,383,4,4,0.000196078,865980,0.976742612
17967,332,84,4,4,0.000196078,865984,0.976747124
14536,4,204,4,4,0.000196078,865988,0.976751635
17037,448,123,4,4,0.000196078,865992,0.976756147
19168,164,471,4,4,0.000196078,865996,0.976760659
14524,19,473,4,4,0.000196078,866000,0.97676517
19784,385,261,4,4,0.000196078,866004,0.976769682
14500,655,562,4,4,0.000196078,866008,0.976774194
17962,514,307,4,4,0.000196078,866012,0.976778705
19778,708,274,4,4,0.000196078,866016,0.976783217
19777,605,204,4,4,0.000196078,866020,0.976787728
19180,155,380,4,4,0.000196078,866024,0.97679224
17062,347,393,4,4,0.000196078,866028,0.976796752
13301,4,439,4,4,0.000196078,866032,0.976801263
17960,507,48,4,4,0.000196078,866036,0.976805775
14495,261,302,4,4,0.000196078,866040,0.976810286
19773,311,133,4,4,0.000196078,866044,0.976814798
11686,332,80,4,4,0.000196078,866048,0.97681931
11708,674,85,4,4,0.000196078,866052,0.976823821
19795,269,529,4,4,0.000196078,866056,0.976828333
19153,448,471,4,4,0.000196078,866060,0.976832845
19151,114,56,4,4,0.000196078,866064,0.976837356
14590,196,181,4,4,0.000196078,866068,0.976841868
16946,427,586,4,4,0.000196078,866072,0.976846379
18003,529,6,4,4,0.000196078,866076,0.976850891
19856,673,507,4,4,0.000196078,866080,0.976855403
19851,492,443,4,4,0.000196078,866084,0.976859914
14587,138,32,4,4,0.000196078,866088,0.976864426
19846,5,655,4,4,0.000196078,866092,0.976868938
19844,535,482,4,4,0.000196078,866096,0.976873449
19841,511,398,4,4,0.000196078,866100,0.976877961
19840,347,586,4,4,0.000196078,866104,0.976882472
17000,133,347,4,4,0.000196078,866108,0.976886984
19811,10,163,4,4,0.000196078,866112,0.976891496
17002,196,427,4,4,0.000196078,866116,0.976896007
17004,514,605,4,4,0.000196078,866120,0.976900519
17983,682,114,4,4,0.000196078,866124,0.97690503
19144,97,587,4,4,0.000196078,866128,0.976909542
17017,261,236,4,4,0.000196078,866132,0.976914054
17022,529,307,4,4,0.000196078,866136,0.976918565
19813,163,164,4,4,0.000196078,866140,0.976923077
17978,196,511,4,4,0.000196078,866144,0.976927589
11596,475,439,4,4,0.000196078,866148,0.9769321
19812,614,64,4,4,0.000196078,866152,0.976936612
19148,103,367,4,4,0.000196078,866156,0.976941123
18088,723,27,4,4,0.000196078,866160,0.976945635
20148,310,446,4,4,0.000196078,866164,0.976950147
20090,397,332,4,4,0.000196078,866168,0.976954658
18946,673,508,4,4,0.000196078,866172,0.97695917
18948,26,560,4,4,0.000196078,866176,0.976963681
16611,638,507,4,4,0.000196078,866180,0.976968193
15061,720,380,4,4,0.000196078,866184,0.976972705
18194,682,479,4,4,0.000196078,866188,0.976977216
20070,493,219,4,4,0.000196078,866192,0.976981728
18188,50,204,4,4,0.000196078,866196,0.97698624
18187,95,170,4,4,0.000196078,866200,0.976990751
20067,196,25,4,4,0.000196078,866204,0.976995263
16628,164,56,4,4,0.000196078,866208,0.976999774
18961,117,463,4,4,0.000196078,866212,0.977004286
20054,207,2,4,4,0.000196078,866216,0.977008798
18181,588,383,4,4,0.000196078,866220,0.977013309
18179,193,655,4,4,0.000196078,866224,0.977017821
13091,448,582,4,4,0.000196078,866228,0.977022333
18176,586,328,4,4,0.000196078,866232,0.977026844
15065,243,145,4,4,0.000196078,866236,0.977031356
20093,158,383,4,4,0.000196078,866240,0.977035867
20094,544,501,4,4,0.000196078,866244,0.977040379
15114,655,163,4,4,0.000196078,866248,0.977044891
20144,167,105,4,4,0.000196078,866252,0.977049402
18245,458,479,4,4,0.000196078,866256,0.977053914
16488,655,114,4,4,0.000196078,866260,0.977058425
16525,532,528,4,4,0.000196078,866264,0.977062937
18220,269,586,4,4,0.000196078,866268,0.977067449
20127,19,77,4,4,0.000196078,866272,0.97707196
20126,708,121,4,4,0.000196078,866276,0.977076472
18202,103,84,4,4,0.000196078,866280,0.977080984
18215,682,517,4,4,0.000196078,866284,0.977085495
16533,708,498,4,4,0.000196078,866288,0.977090007
15103,12,164,4,4,0.000196078,866292,0.977094518
18934,30,511,4,4,0.000196078,866296,0.97709903
18211,1,170,4,4,0.000196078,866300,0.977103542
11367,4,33,4,4,0.000196078,866304,0.977108053
20108,48,25,4,4,0.000196078,866308,0.977112565
16572,640,385,4,4,0.000196078,866312,0.977117076
20100,543,439,4,4,0.000196078,866316,0.977121588
15029,543,3,4,4,0.000196078,866320,0.9771261
20044,593,511,4,4,0.000196078,866324,0.977130611
19992,502,562,4,4,0.000196078,866328,0.977135123
19987,367,613,4,4,0.000196078,866332,0.977139635
16756,543,121,4,4,0.000196078,866336,0.977144146
14885,721,614,4,4,0.000196078,866340,0.977148658
19979,14,141,4,4,0.000196078,866344,0.977153169
19977,624,663,4,4,0.000196078,866348,0.977157681
18107,313,494,4,4,0.000196078,866352,0.977162193
16761,158,508,4,4,0.000196078,866356,0.977166704
19027,1,193,4,4,0.000196078,866360,0.977171216
16764,29,588,4,4,0.000196078,866364,0.977175727
19968,638,482,4,4,0.000196078,866368,0.977180239
19965,383,95,4,4,0.000196078,866372,0.977184751
19046,261,514,4,4,0.000196078,866376,0.977189262
16767,2,439,4,4,0.000196078,866380,0.977193774
19957,525,307,4,4,0.000196078,866384,0.977198286
19055,1,250,4,4,0.000196078,866388,0.977202797
19953,528,674,4,4,0.000196078,866392,0.977207309
19952,290,6,4,4,0.000196078,866396,0.97721182
14920,501,414,4,4,0.000196078,866400,0.977216332
16726,174,663,4,4,0.000196078,866404,0.977220844
14990,497,511,4,4,0.000196078,866408,0.977225355
11391,9,503,4,4,0.000196078,866412,0.977229867
18969,261,471,4,4,0.000196078,866416,0.977234379
15018,4,348,4,4,0.000196078,866420,0.97723889
18971,475,652,4,4,0.000196078,866424,0.977243402
18982,588,720,4,4,0.000196078,866428,0.977247913
20026,719,353,4,4,0.000196078,866432,0.977252425
18984,294,230,4,4,0.000196078,866436,0.977256937
18148,331,174,4,4,0.000196078,866440,0.977261448
18125,224,261,4,4,0.000196078,866444,0.97726596
20015,22,714,4,4,0.000196078,866448,0.977270471
20013,31,264,4,4,0.000196078,866452,0.977274983
16695,32,383,4,4,0.000196078,866456,0.977279495
18989,558,12,4,4,0.000196078,866460,0.977284006
18133,392,48,4,4,0.000196078,866464,0.977288518
16709,673,613,4,4,0.000196078,866468,0.97729303
16711,638,511,4,4,0.000196078,866472,0.977297541
18995,80,171,4,4,0.000196078,866476,0.977302053
19196,13,236,4,4,0.000196078,866480,0.977306564
19198,156,618,4,4,0.000196078,866484,0.977311076
17952,463,618,4,4,0.000196078,866488,0.977315588
13799,307,414,4,4,0.000196078,866492,0.977320099
13897,30,178,4,4,0.000196078,866496,0.977324611
19553,492,313,4,4,0.000196078,866500,0.977329122
19551,9,701,4,4,0.000196078,866504,0.977333634
17399,544,117,4,4,0.000196078,866508,0.977338146
19548,155,532,4,4,0.000196078,866512,0.977342657
19545,133,614,4,4,0.000196078,866516,0.977347169
19543,473,261,4,4,0.000196078,866520,0.977351681
19349,174,379,4,4,0.000196078,866524,0.977356192
17702,138,280,4,4,0.000196078,866528,0.977360704
17405,443,246,4,4,0.000196078,866532,0.977365215
13435,514,130,4,4,0.000196078,866536,0.977369727
19538,311,269,4,4,0.000196078,866540,0.977374239
19358,586,156,4,4,0.000196078,866544,0.97737875
17414,160,501,4,4,0.000196078,866548,0.977383262
19362,13,701,4,4,0.000196078,866552,0.977387774
17417,302,175,4,4,0.000196078,866556,0.977392285
19373,529,20,4,4,0.000196078,866560,0.977396797
13526,624,9,4,4,0.000196078,866564,0.977401308
17691,246,334,4,4,0.000196078,866568,0.97740582
17689,171,596,4,4,0.000196078,866572,0.977410332
13895,708,156,4,4,0.000196078,866576,0.977414843
19555,193,22,4,4,0.000196078,866580,0.977419355
17726,311,193,4,4,0.000196078,866584,0.977423866
17749,529,638,4,4,0.000196078,866588,0.977428378
19318,720,10,4,4,0.000196078,866592,0.97743289
17313,15,439,4,4,0.000196078,866596,0.977437401
19589,501,383,4,4,0.000196078,866600,0.977441913
19587,274,439,4,4,0.000196078,866604,0.977446425
19585,64,638,4,4,0.000196078,866608,0.977450936
19575,414,593,4,4,0.000196078,866612,0.977455448
19573,43,280,4,4,0.000196078,866616,0.977459959
19572,394,683,4,4,0.000196078,866620,0.977464471
17369,501,117,4,4,0.000196078,866624,0.977468983
17754,562,475,4,4,0.000196078,866628,0.977473494
19328,544,264,4,4,0.000196078,866632,0.977478006
19566,224,493,4,4,0.000196078,866636,0.977482517
17763,140,95,4,4,0.000196078,866640,0.977487029
17380,331,290,4,4,0.000196078,866644,0.977491541
13997,501,507,4,4,0.000196078,866648,0.977496052
19336,605,682,4,4,0.000196078,866652,0.977500564
19563,25,6,4,4,0.000196078,866656,0.977505076
19380,95,507,4,4,0.000196078,866660,0.977509587
17658,618,171,4,4,0.000196078,866664,0.977514099
17069,482,331,4,4,0.000196078,866668,0.97751861
19384,448,95,4,4,0.000196078,866672,0.977523122
17504,475,181,4,4,0.000196078,866676,0.977527634
13756,26,475,4,4,0.000196078,866680,0.977532145
19465,107,29,4,4,0.000196078,866684,0.977536657
19461,720,9,4,4,0.000196078,866688,0.977541169
17597,4,508,4,4,0.000196078,866692,0.97754568
19459,543,618,4,4,0.000196078,866696,0.977550192
17590,124,640,4,4,0.000196078,866700,0.977554703
19448,682,439,4,4,0.000196078,866704,0.977559215
17572,640,274,4,4,0.000196078,866708,0.977563727
17567,1,562,4,4,0.000196078,866712,0.977568238
19439,379,171,4,4,0.000196078,866716,0.97757275
19438,302,448,4,4,0.000196078,866720,0.977577261
17546,242,163,4,4,0.000196078,866724,0.977581773
19419,492,16,4,4,0.000196078,866728,0.977586285
13722,383,501,4,4,0.000196078,866732,0.977590796
19427,196,264,4,4,0.000196078,866736,0.977595308
19425,6,12,4,4,0.000196078,866740,0.97759982
19423,699,380,4,4,0.000196078,866744,0.977604331
19467,84,446,4,4,0.000196078,866748,0.977608843
19468,117,274,4,4,0.000196078,866752,0.977613354
17624,439,640,4,4,0.000196078,866756,0.977617866
19386,246,586,4,4,0.000196078,866760,0.977622378
13599,398,638,4,4,0.000196078,866764,0.977626889
17656,10,571,4,4,0.000196078,866768,0.977631401
17648,699,588,4,4,0.000196078,866772,0.977635912
17450,195,123,4,4,0.000196078,866776,0.977640424
19392,609,12,4,4,0.000196078,866780,0.977644936
13789,593,6,4,4,0.000196078,866784,0.977649447
13631,367,85,4,4,0.000196078,866788,0.977653959
19488,236,181,4,4,0.000196078,866792,0.977658471
17476,170,105,4,4,0.000196078,866796,0.977662982
17615,178,145,4,4,0.000196078,866800,0.977667494
19479,385,97,4,4,0.000196078,866804,0.977672005
19477,50,22,4,4,0.000196078,866808,0.977676517
17608,475,242,4,4,0.000196078,866812,0.977681029
17478,158,22,4,4,0.000196078,866816,0.97768554
12097,562,560,4,4,0.000196078,866820,0.977690052
19406,655,155,4,4,0.000196078,866824,0.977694564
14028,294,6,4,4,0.000196078,866828,0.977699075
19604,4,605,4,4,0.000196078,866832,0.977703587
19220,511,682,4,4,0.000196078,866836,0.977708098
19734,64,311,4,4,0.000196078,866840,0.97771261
19733,335,133,4,4,0.000196078,866844,0.977717122
19235,720,475,4,4,0.000196078,866848,0.977721633
19730,398,64,4,4,0.000196078,866852,0.977726145
17910,114,560,4,4,0.000196078,866856,0.977730656
17125,347,439,4,4,0.000196078,866860,0.977735168
19722,501,593,4,4,0.000196078,866864,0.97773968
17904,593,3,4,4,0.000196078,866868,0.977744191
19711,502,121,4,4,0.000196078,866872,0.977748703
17138,383,609,4,4,0.000196078,866876,0.977753215
19709,528,50,4,4,0.000196078,866880,0.977757726
19706,535,652,4,4,0.000196078,866884,0.977762238
17149,290,16,4,4,0.000196078,866888,0.977766749
17900,471,164,4,4,0.000196078,866892,0.977771261
17150,342,80,4,4,0.000196078,866896,0.977775773
17165,682,33,4,4,0.000196078,866900,0.977780284
19218,265,427,4,4,0.000196078,866904,0.977784796
17102,163,117,4,4,0.000196078,866908,0.977789307
11923,246,230,4,4,0.000196078,866912,0.977793819
19756,663,294,4,4,0.000196078,866916,0.977798331
17950,164,14,4,4,0.000196078,866920,0.977802842
17949,528,4,4,4,0.000196078,866924,0.977807354
17072,394,475,4,4,0.000196078,866928,0.977811866
17937,29,394,4,4,0.000196078,866932,0.977816377
17934,385,638,4,4,0.000196078,866936,0.977820889
17079,353,137,4,4,0.000196078,866940,0.9778254
14450,274,471,4,4,0.000196078,866944,0.977829912
17084,107,20,4,4,0.000196078,866948,0.977834424
17101,721,501,4,4,0.000196078,866952,0.977838935
19748,32,646,4,4,0.000196078,866956,0.977843447
19746,593,640,4,4,0.000196078,866960,0.977847958
17919,655,683,4,4,0.000196078,866964,0.97785247
14445,544,529,4,4,0.000196078,866968,0.977856982
14420,661,582,4,4,0.000196078,866972,0.977861493
19743,503,80,4,4,0.000196078,866976,0.977866005
14390,274,723,4,4,0.000196078,866980,0.977870517
19216,103,48,4,4,0.000196078,866984,0.977875028
17091,614,23,4,4,0.000196078,866988,0.97787954
13304,721,334,4,4,0.000196078,866992,0.977884051
19257,668,34,4,4,0.000196078,866996,0.977888563
19700,158,682,4,4,0.000196078,867000,0.977893075
19301,30,54,4,4,0.000196078,867004,0.977897586
19293,181,314,4,4,0.000196078,867008,0.977902098
19642,409,56,4,4,0.000196078,867012,0.97790661
17254,2,26,4,4,0.000196078,867016,0.977911121
17260,43,236,4,4,0.000196078,867020,0.977915633
19639,613,48,4,4,0.000196078,867024,0.977920144
14131,494,582,4,4,0.000196078,867028,0.977924656
17844,380,525,4,4,0.000196078,867032,0.977929168
17263,655,4,4,4,0.000196078,867036,0.977933679
19631,14,535,4,4,0.000196078,867040,0.977938191
17252,105,133,4,4,0.000196078,867044,0.977942702
17826,507,682,4,4,0.000196078,867048,0.977947214
12083,97,353,4,4,0.000196078,867052,0.977951726
17806,54,313,4,4,0.000196078,867056,0.977956237
17283,145,117,4,4,0.000196078,867060,0.977960749
17284,219,646,4,4,0.000196078,867064,0.977965261
17285,219,364,4,4,0.000196078,867068,0.977969772
17795,383,348,4,4,0.000196078,867072,0.977974284
19613,719,15,4,4,0.000196078,867076,0.977978795
13386,164,674,4,4,0.000196078,867080,0.977983307
14317,274,404,4,4,0.000196078,867084,0.977987819
14260,397,475,4,4,0.000196078,867088,0.97799233
14252,22,614,4,4,0.000196078,867092,0.977996842
19698,501,171,4,4,0.000196078,867096,0.978001353
19690,50,502,4,4,0.000196078,867100,0.978005865
19267,130,90,4,4,0.000196078,867104,0.978010377
19687,302,446,4,4,0.000196078,867108,0.978014888
17213,20,264,4,4,0.000196078,867112,0.9780194
17878,514,638,4,4,0.000196078,867116,0.978023912
19677,562,174,4,4,0.000196078,867120,0.978028423
19672,207,640,4,4,0.000196078,867124,0.978032935
19669,699,95,4,4,0.000196078,867128,0.978037446
19662,683,588,4,4,0.000196078,867132,0.978041958
17236,596,552,4,4,0.000196078,867136,0.97804647
17869,721,145,4,4,0.000196078,867140,0.978050981
17239,29,1,4,4,0.000196078,867144,0.978055493
17868,97,609,4,4,0.000196078,867148,0.978060005
17241,632,193,4,4,0.000196078,867152,0.978064516
13370,640,1,4,4,0.000196078,867156,0.978069028
16481,20,84,4,4,0.000196078,867160,0.978073539
14964,264,501,4,4,0.000196078,867164,0.978078051
18912,140,497,4,4,0.000196078,867168,0.978082563
20363,164,348,4,4,0.000196078,867172,0.978087074
16045,43,529,4,4,0.000196078,867176,0.978091586
20378,54,16,4,4,0.000196078,867180,0.978096097
20377,471,501,4,4,0.000196078,867184,0.978100609
16047,640,193,4,4,0.000196078,867188,0.978105121
18761,145,193,4,4,0.000196078,867192,0.978109632
20373,701,68,4,4,0.000196078,867196,0.978114144
18766,84,207,4,4,0.000196078,867200,0.978118656
20370,274,593,4,4,0.000196078,867204,0.978123167
10152,392,3,4,4,0.000196078,867208,0.978127679
20362,133,167,4,4,0.000196078,867212,0.97813219
16018,668,310,4,4,0.000196078,867216,0.978136702
18767,328,593,4,4,0.000196078,867220,0.978141214
15500,446,313,4,4,0.000196078,867224,0.978145725
18769,502,404,4,4,0.000196078,867228,0.978150237
20345,507,723,4,4,0.000196078,867232,0.978154748
20337,12,605,4,4,0.000196078,867236,0.97815926
20335,175,224,4,4,0.000196078,867240,0.978163772
15493,708,535,4,4,0.000196078,867244,0.978168283
18773,4,20,4,4,0.000196078,867248,0.978172795
16090,708,674,4,4,0.000196078,867252,0.978177307
20381,528,242,4,4,0.000196078,867256,0.978181818
18470,646,588,4,4,0.000196078,867260,0.97818633
15543,383,33,4,4,0.000196078,867264,0.978190841
18743,552,683,4,4,0.000196078,867268,0.978195353
15540,701,479,4,4,0.000196078,867272,0.978199865
9003,302,170,4,4,0.000196078,867276,0.978204376
18746,522,155,4,4,0.000196078,867280,0.978208888
20413,56,156,4,4,0.000196078,867284,0.9782134
16038,274,543,4,4,0.000196078,867288,0.978217911
15538,507,614,4,4,0.000196078,867292,0.978222423
18477,290,331,4,4,0.000196078,867296,0.978226934
12557,163,314,4,4,0.000196078,867300,0.978231446
20403,511,596,4,4,0.000196078,867304,0.978235958
18474,16,246,4,4,0.000196078,867308,0.978240469
15523,354,714,4,4,0.000196078,867312,0.978244981
18472,507,307,4,4,0.000196078,867316,0.978249492
18751,367,652,4,4,0.000196078,867320,0.978254004
20394,77,371,4,4,0.000196078,867324,0.978258516
16044,714,80,4,4,0.000196078,867328,0.978263027
15504,246,588,4,4,0.000196078,867332,0.978267539
20391,497,427,4,4,0.000196078,867336,0.978272051
16091,302,85,4,4,0.000196078,867340,0.978276562
12558,2,353,4,4,0.000196078,867344,0.978281074
15489,385,56,4,4,0.000196078,867348,0.978285585
18785,195,310,4,4,0.000196078,867352,0.978290097
18385,14,501,4,4,0.000196078,867356,0.978294609
16163,30,552,4,4,0.000196078,867360,0.97829912
20294,133,535,4,4,0.000196078,867364,0.978303632
20291,364,586,4,4,0.000196078,867368,0.978308143
20289,394,552,4,4,0.000196078,867372,0.978312655
15438,562,683,4,4,0.000196078,867376,0.978317167
16181,532,1,4,4,0.000196078,867380,0.978321678
18789,514,528,4,4,0.000196078,867384,0.97832619
16183,502,95,4,4,0.000196078,867388,0.978330702
18794,404,364,4,4,0.000196078,867392,0.978335213
20278,19,34,4,4,0.000196078,867396,0.978339725
20269,717,473,4,4,0.000196078,867400,0.978344236
18352,558,571,4,4,0.000196078,867404,0.978348748
20262,502,674,4,4,0.000196078,867408,0.97835326
18810,721,414,4,4,0.000196078,867412,0.978357771
12680,26,544,4,4,0.000196078,867416,0.978362283
16155,544,50,4,4,0.000196078,867420,0.978366794
16154,613,311,4,4,0.000196078,867424,0.978371306
15483,475,586,4,4,0.000196078,867428,0.978375818
16146,497,663,4,4,0.000196078,867432,0.978380329
16102,682,471,4,4,0.000196078,867436,0.978384841
15476,497,170,4,4,0.000196078,867440,0.978389353
16107,673,528,4,4,0.000196078,867444,0.978393864
16117,529,479,4,4,0.000196078,867448,0.978398376
12643,543,156,4,4,0.000196078,867452,0.978402887
16122,2,655,4,4,0.000196078,867456,0.978407399
15465,605,414,4,4,0.000196078,867460,0.978411911
16124,668,84,4,4,0.000196078,867464,0.978416422
18399,25,50,4,4,0.000196078,867468,0.978420934
15453,683,85,4,4,0.000196078,867472,0.978425446
15448,31,393,4,4,0.000196078,867476,0.978429957
10440,207,663,4,4,0.000196078,867480,0.978434469
20303,332,367,4,4,0.000196078,867484,0.97843898
18394,582,175,4,4,0.000196078,867488,0.978443492
15445,552,560,4,4,0.000196078,867492,0.978448004
18779,701,310,4,4,0.000196078,867496,0.978452515
15439,29,380,4,4,0.000196078,867500,0.978457027
15558,163,123,4,4,0.000196078,867504,0.978461538
20426,397,156,4,4,0.000196078,867508,0.97846605
20259,250,640,4,4,0.000196078,867512,0.978470562
18637,624,230,4,4,0.000196078,867516,0.978475073
20563,4,145,4,4,0.000196078,867520,0.978479585
20559,261,121,4,4,0.000196078,867524,0.978484097
15899,295,174,4,4,0.000196078,867528,0.978488608
15907,684,80,4,4,0.000196078,867532,0.97849312
20557,34,414,4,4,0.000196078,867536,0.978497631
15743,131,683,4,4,0.000196078,867540,0.978502143
18605,613,219,4,4,0.000196078,867544,0.978506655
20548,265,170,4,4,0.000196078,867548,0.978511166
15735,80,1,4,4,0.000196078,867552,0.978515678
20540,525,250,4,4,0.000196078,867556,0.978520189
20427,171,507,4,4,0.000196078,867560,0.978524701
20539,528,544,4,4,0.000196078,867564,0.978529213
15713,313,261,4,4,0.000196078,867568,0.978533724
18647,398,34,4,4,0.000196078,867572,0.978538236
20534,392,131,4,4,0.000196078,867576,0.978542748
18661,558,193,4,4,0.000196078,867580,0.978547259
15701,507,588,4,4,0.000196078,867584,0.978551771
20524,13,414,4,4,0.000196078,867588,0.978556282
15936,302,90,4,4,0.000196078,867592,0.978560794
20565,529,632,4,4,0.000196078,867596,0.978565306
15760,655,723,4,4,0.000196078,867600,0.978569817
15784,683,9,4,4,0.000196078,867604,0.978574329
20611,103,29,4,4,0.000196078,867608,0.978578841
18620,529,167,4,4,0.000196078,867612,0.978583352
15814,334,479,4,4,0.000196078,867616,0.978587864
15818,32,103,4,4,0.000196078,867620,0.978592375
15800,544,439,4,4,0.000196078,867624,0.978596887
15839,9,448,4,4,0.000196078,867628,0.978601399
15851,367,560,4,4,0.000196078,867632,0.97860591
18612,264,33,4,4,0.000196078,867636,0.978610422
12439,640,114,4,4,0.000196078,867640,0.978614933
12445,367,605,4,4,0.000196078,867644,0.978619445
15861,133,522,4,4,0.000196078,867648,0.978623957
20594,19,195,4,4,0.000196078,867652,0.978628468
20593,514,463,4,4,0.000196078,867656,0.97863298
20587,624,588,4,4,0.000196078,867660,0.978637492
15787,385,117,4,4,0.000196078,867664,0.978642003
12412,409,48,4,4,0.000196078,867668,0.978646515
18607,404,274,4,4,0.000196078,867672,0.978651026
20579,632,398,4,4,0.000196078,867676,0.978655538
20577,105,202,4,4,0.000196078,867680,0.97866005
20575,56,195,4,4,0.000196078,867684,0.978664561
20574,334,562,4,4,0.000196078,867688,0.978669073
18594,274,140,4,4,0.000196078,867692,0.978673584
18593,532,195,4,4,0.000196078,867696,0.978678096
15632,95,274,4,4,0.000196078,867700,0.978682608
20474,586,140,4,4,0.000196078,867704,0.978687119
20470,562,682,4,4,0.000196078,867708,0.978691631
18696,409,609,4,4,0.000196078,867712,0.978696143
18703,117,264,4,4,0.000196078,867716,0.978700654
15948,529,56,4,4,0.000196078,867720,0.978705166
15612,689,655,4,4,0.000196078,867724,0.978709677
18553,167,295,4,4,0.000196078,867728,0.978714189
18541,264,385,4,4,0.000196078,867732,0.978718701
15972,682,609,4,4,0.000196078,867736,0.978723212
20446,50,1,4,4,0.000196078,867740,0.978727724
18724,30,571,4,4,0.000196078,867744,0.978732236
18528,511,471,4,4,0.000196078,867748,0.978736747
20435,97,274,4,4,0.000196078,867752,0.978741259
18507,95,593,4,4,0.000196078,867756,0.97874577
18499,682,6,4,4,0.000196078,867760,0.978750282
12530,502,302,4,4,0.000196078,867764,0.978754794
15561,138,532,4,4,0.000196078,867768,0.978759305
16006,334,427,4,4,0.000196078,867772,0.978763817
20428,475,682,4,4,0.000196078,867776,0.978768328
20481,22,640,4,4,0.000196078,867780,0.97877284
18685,167,347,4,4,0.000196078,867784,0.978777352
20488,614,126,4,4,0.000196078,867788,0.978781863
15652,11,593,4,4,0.000196078,867792,0.978786375
18587,701,105,4,4,0.000196078,867796,0.978790887
18666,97,661,4,4,0.000196078,867800,0.978795398
20515,347,25,4,4,0.000196078,867804,0.97879991
18667,463,1,4,4,0.000196078,867808,0.978804421
18668,12,503,4,4,0.000196078,867812,0.978808933
15648,379,20,4,4,0.000196078,867816,0.978813445
20511,64,475,4,4,0.000196078,867820,0.978817956
15939,164,155,4,4,0.000196078,867824,0.978822468
18673,34,404,4,4,0.000196078,867828,0.978826979
15943,264,230,4,4,0.000196078,867832,0.978831491
20509,586,383,4,4,0.000196078,867836,0.978836003
12332,246,582,4,4,0.000196078,867840,0.978840514
20503,689,126,4,4,0.000196078,867844,0.978845026
18680,43,265,4,4,0.000196078,867848,0.978849538
20498,50,517,4,4,0.000196078,867852,0.978854049
20494,528,31,4,4,0.000196078,867856,0.978858561
20489,2,140,4,4,0.000196078,867860,0.978863072
12690,14,13,4,4,0.000196078,867864,0.978867584
16375,383,502,4,4,0.000196078,867868,0.978872096
20183,97,294,4,4,0.000196078,867872,0.978876607
16280,26,64,4,4,0.000196078,867876,0.978881119
16430,439,498,4,4,0.000196078,867880,0.97888563
18264,529,64,4,4,0.000196078,867884,0.978890142
15351,4,64,4,4,0.000196078,867888,0.978894654
16253,2,618,4,4,0.000196078,867892,0.978899165
16247,383,117,4,4,0.000196078,867896,0.978903677
18828,280,195,4,4,0.000196078,867900,0.978908189
10868,682,158,4,4,0.000196078,867904,0.9789127
20215,30,140,4,4,0.000196078,867908,0.978917212
18823,56,446,4,4,0.000196078,867912,0.978921723
16434,22,242,4,4,0.000196078,867916,0.978926235
18325,133,15,4,4,0.000196078,867920,0.978930747
10733,439,236,4,4,0.000196078,867924,0.978935258
18328,246,84,4,4,0.000196078,867928,0.97893977
16444,689,614,4,4,0.000196078,867932,0.978944282
18330,77,494,4,4,0.000196078,867936,0.978948793
16447,163,11,4,4,0.000196078,867940,0.978953305
20242,80,332,4,4,0.000196078,867944,0.978957816
16230,586,708,4,4,0.000196078,867948,0.978962328
18900,2,167,4,4,0.000196078,867952,0.97896684
16410,638,385,4,4,0.000196078,867956,0.978971351
20223,2,242,4,4,0.000196078,867960,0.978975863
18281,721,156,4,4,0.000196078,867964,0.978980374
18300,427,14,4,4,0.000196078,867968,0.978984886
20169,721,295,4,4,0.000196078,867972,0.978989398
16304,638,264,4,4,0.000196078,867976,0.978993909
18272,392,219,4,4,0.000196078,867980,0.978998421
15303,640,250,4,4,0.000196078,867984,0.979002933
18316,683,471,4,4,0.000196078,867988,0.979007444
16300,614,383,4,4,0.000196078,867992,0.979011956
15337,302,593,4,4,0.000196078,867996,0.979016467
18287,701,33,4,4,0.000196078,868000,0.979020979
18883,160,131,4,4,0.000196078,868004,0.979025491
16343,682,674,4,4,0.000196078,868008,0.979030002
16349,163,250,4,4,0.000196078,868012,0.979034514
20166,246,48,4,4,0.000196078,868016,0.979039025
20208,311,332,4,4,0.000196078,868020,0.979043537
18319,397,544,4,4,0.000196078,868024,0.979048049
18886,133,196,4,4,0.000196078,868028,0.97905256
18869,638,156,4,4,0.000196078,868032,0.979057072
16219,97,174,4,4,0.000196078,868036,0.979061584
18904,56,5,4,4,0.000196078,868040,0.979066095
18854,140,204,4,4,0.000196078,868044,0.979070607
16213,160,105,4,4,0.000196078,868048,0.979075118
20184,30,714,4,4,0.000196078,868052,0.97907963
15278,714,27,4,4,0.000196078,868056,0.979084142
15255,33,242,4,4,0.000196078,868060,0.979088653
20257,646,398,4,4,0.000196078,868064,0.979093165
15370,655,544,4,4,0.000196078,868068,0.979097677
11205,123,605,4,4,0.000196078,868072,0.979102188
18251,141,393,4,4,0.000196078,868076,0.9791067
12707,6,155,4,4,0.000196078,868080,0.979111211
19025,34,328,7,3,0.000343137,868087,0.979119107
21614,714,569,7,3,0.000343137,868094,0.979127002
21571,9,668,7,3,0.000343137,868101,0.979134897
20162,310,137,6,3,0.000294118,868107,0.979141665
18652,294,204,6,3,0.000294118,868113,0.979148432
18117,164,130,6,3,0.000294118,868119,0.9791552
21434,114,261,6,3,0.000294118,868125,0.979161967
19761,178,204,6,3,0.000294118,868131,0.979168734
19935,618,367,6,3,0.000294118,868137,0.979175502
18992,348,392,6,3,0.000294118,868143,0.979182269
20050,443,85,6,3,0.000294118,868149,0.979189037
20082,30,404,6,3,0.000294118,868155,0.979195804
17430,353,174,6,3,0.000294118,868161,0.979202572
11444,4,261,6,3,0.000294118,868167,0.979209339
20798,124,532,6,3,0.000294118,868173,0.979216106
17533,9,571,6,3,0.000294118,868179,0.979222874
20436,479,593,6,3,0.000294118,868185,0.979229641
24175,684,155,6,3,0.000294118,868191,0.979236409
24203,43,528,6,3,0.000294118,868197,0.979243176
11317,31,174,6,3,0.000294118,868203,0.979249944
19295,29,640,5,3,0.000245098,868208,0.979255583
21884,90,250,5,3,0.000245098,868213,0.979261223
19351,529,246,5,3,0.000245098,868218,0.979266862
21935,10,448,5,3,0.000245098,868223,0.979272502
23885,684,532,5,3,0.000245098,868228,0.979278141
20670,29,522,5,3,0.000245098,868233,0.979283781
18051,141,9,5,3,0.000245098,868238,0.97928942
23043,525,328,5,3,0.000245098,868243,0.97929506
23914,48,13,5,3,0.000245098,868248,0.979300699
20375,193,307,5,3,0.000245098,868253,0.979306339
21194,121,68,5,3,0.000245098,868258,0.979311978
20305,624,689,5,3,0.000245098,868263,0.979317618
20306,528,196,5,3,0.000245098,868268,0.979323257
14070,394,274,5,3,0.000245098,868273,0.979328897
19074,380,181,5,3,0.000245098,868278,0.979334536
26090,204,19,5,3,0.000245098,868283,0.979340176
20085,95,171,5,3,0.000245098,868288,0.979345815
20530,14,398,5,3,0.000245098,868293,0.979351455
18089,97,170,5,3,0.000245098,868298,0.979357095
21969,126,380,5,3,0.000245098,868303,0.979362734
16344,158,23,5,3,0.000245098,868308,0.979368374
23025,138,117,5,3,0.000245098,868313,0.979374013
17841,290,353,5,3,0.000245098,868318,0.979379653
19195,294,32,5,3,0.000245098,868323,0.979385292
23245,126,34,5,3,0.000245098,868328,0.979390932
20066,689,294,5,3,0.000245098,868333,0.979396571
11221,4,6,5,3,0.000245098,868338,0.979402211
21276,498,392,5,3,0.000245098,868343,0.97940785
21479,50,141,5,3,0.000245098,868348,0.97941349
21266,11,661,5,3,0.000245098,868353,0.979419129
24257,103,34,5,3,0.000245098,868358,0.979424769
15471,54,479,5,3,0.000245098,868363,0.979430408
24233,613,498,5,3,0.000245098,868368,0.979436048
25175,427,511,5,3,0.000245098,868373,0.979441687
20347,27,458,5,3,0.000245098,868378,0.979447327
21362,353,175,5,3,0.000245098,868383,0.979452966
20349,514,97,5,3,0.000245098,868388,0.979458606
19808,501,174,5,3,0.000245098,868393,0.979464245
24190,114,593,5,3,0.000245098,868398,0.979469885
20569,12,30,5,3,0.000245098,868403,0.979475524
21664,202,522,5,3,0.000245098,868408,0.979481164
23987,334,514,5,3,0.000245098,868413,0.979486804
21238,178,80,5,3,0.000245098,868418,0.979492443
18041,257,397,5,3,0.000245098,868423,0.979498083
17034,20,290,5,3,0.000245098,868428,0.979503722
19626,618,535,5,3,0.000245098,868433,0.979509362
21576,167,170,5,3,0.000245098,868438,0.979515001
19635,280,2,5,3,0.000245098,868443,0.979520641
21260,646,68,5,3,0.000245098,868448,0.97952628
19670,624,195,5,3,0.000245098,868453,0.97953192
20364,529,482,5,3,0.000245098,868458,0.979537559
21639,34,207,5,3,0.000245098,868463,0.979543199
16536,614,140,5,3,0.000245098,868468,0.979548838
16580,525,32,5,3,0.000245098,868473,0.979554478
20088,618,56,5,3,0.000245098,868478,0.979560117
18578,683,68,5,3,0.000245098,868483,0.979565757
22625,202,479,5,3,0.000245098,868488,0.979571396
20449,269,274,5,3,0.000245098,868493,0.979577036
25040,652,97,5,3,0.000245098,868498,0.979582675
14535,193,80,5,3,0.000245098,868503,0.979588315
18619,448,50,5,3,0.000245098,868508,0.979593954
22895,446,15,5,3,0.000245098,868513,0.979599594
25835,335,576,5,3,0.000245098,868518,0.979605233
25819,626,348,5,3,0.000245098,868523,0.979610873
15942,514,33,5,3,0.000245098,868528,0.979616513
18368,34,605,5,3,0.000245098,868533,0.979622152
22842,170,145,5,3,0.000245098,868538,0.979627792
18360,507,50,5,3,0.000245098,868543,0.979633431
12036,529,404,5,3,0.000245098,868548,0.979639071
22755,475,511,5,3,0.000245098,868553,0.97964471
23368,609,507,5,3,0.000245098,868558,0.97965035
20414,624,164,5,3,0.000245098,868563,0.979655989
20425,719,532,5,3,0.000245098,868568,0.979661629
15822,385,414,5,3,0.000245098,868573,0.979667268
23374,264,130,5,3,0.000245098,868578,0.979672908
21106,103,5,5,3,0.000245098,868583,0.979678547
17801,14,164,5,3,0.000245098,868588,0.979684187
23604,121,475,5,3,0.000245098,868593,0.979689826
17389,43,64,5,3,0.000245098,868598,0.979695466
19030,250,708,5,3,0.000245098,868603,0.979701105
17288,103,558,5,3,0.000245098,868608,0.979706745
22979,661,347,5,3,0.000245098,868613,0.979712384
16195,458,10,5,3,0.000245098,868618,0.979718024
22352,682,511,5,3,0.000245098,868623,0.979723663
18816,385,204,5,3,0.000245098,868628,0.979729303
16007,385,280,5,3,0.000245098,868633,0.979734942
22397,427,274,5,3,0.000245098,868638,0.979740582
22389,126,15,5,3,0.000245098,868643,0.979746222
18843,242,307,5,3,0.000245098,868648,0.979751861
20751,511,164,5,3,0.000245098,868653,0.979757501
20290,207,243,5,3,0.000245098,868658,0.97976314
22280,463,593,5,3,0.000245098,868663,0.97976878
18826,25,674,5,3,0.000245098,868668,0.979774419
20969,174,393,4,3,0.000196078,868672,0.979778931
20869,242,640,4,3,0.000196078,868676,0.979783442
21291,498,174,4,3,0.000196078,868680,0.979787954
27737,646,409,4,3,0.000196078,868684,0.979792466
21059,80,525,4,3,0.000196078,868688,0.979796977
21253,22,171,4,3,0.000196078,868692,0.979801489
28573,409,348,4,3,0.000196078,868696,0.979806
28132,124,701,4,3,0.000196078,868700,0.979810512
20931,117,475,4,3,0.000196078,868704,0.979815024
20749,661,95,4,3,0.000196078,868708,0.979819535
21125,364,196,4,3,0.000196078,868712,0.979824047
20662,16,493,4,3,0.000196078,868716,0.979828559
21302,663,12,4,3,0.000196078,868720,0.97983307
20832,174,1,4,3,0.000196078,868724,0.979837582
20683,558,569,4,3,0.000196078,868728,0.979842093
20966,141,32,4,3,0.000196078,868732,0.979846605
21053,33,90,4,3,0.000196078,868736,0.979851117
28166,683,269,4,3,0.000196078,868740,0.979855628
21148,640,482,4,3,0.000196078,868744,0.97986014
20779,195,1,4,3,0.000196078,868748,0.979864651
20995,502,544,4,3,0.000196078,868752,0.979869163
20632,682,544,4,3,0.000196078,868756,0.979873675
21186,409,3,4,3,0.000196078,868760,0.979878186
20971,243,155,4,3,0.000196078,868764,0.979882698
28511,497,13,4,3,0.000196078,868768,0.97988721
27950,274,202,4,3,0.000196078,868772,0.979891721
21241,532,482,4,3,0.000196078,868776,0.979896233
28380,683,560,4,3,0.000196078,868780,0.979900744
20799,243,392,4,3,0.000196078,868784,0.979905256
21262,334,97,4,3,0.000196078,868788,0.979909768
20985,138,471,4,3,0.000196078,868792,0.979914279
28030,131,178,4,3,0.000196078,868796,0.979918791
28091,171,458,4,3,0.000196078,868800,0.979923303
20853,393,560,4,3,0.000196078,868804,0.979927814
20628,50,632,4,3,0.000196078,868808,0.979932326
20974,383,475,4,3,0.000196078,868812,0.979936837
21279,494,367,4,3,0.000196078,868816,0.979941349
27103,720,498,4,3,0.000196078,868820,0.979945861
20929,97,242,4,3,0.000196078,868824,0.979950372
23228,646,114,4,3,0.000196078,868828,0.979954884
25090,511,502,4,3,0.000196078,868832,0.979959395
25075,294,558,4,3,0.000196078,868836,0.979963907
23262,543,171,4,3,0.000196078,868840,0.979968419
23132,613,443,4,3,0.000196078,868844,0.97997293
23153,446,311,4,3,0.000196078,868848,0.979977442
25167,126,219,4,3,0.000196078,868852,0.979981954
23209,103,443,4,3,0.000196078,868856,0.979986465
23188,290,348,4,3,0.000196078,868860,0.979990977
25037,663,701,4,3,0.000196078,868864,0.979995488
24962,13,439,4,3,0.000196078,868868,0.98
24971,242,64,4,3,0.000196078,868872,0.980004512
23382,202,174,4,3,0.000196078,868876,0.980009023
23311,121,535,4,3,0.000196078,868880,0.980013535
23315,618,141,4,3,0.000196078,868884,0.980018046
25024,560,302,4,3,0.000196078,868888,0.980022558
25021,54,463,4,3,0.000196078,868892,0.98002707
23322,64,236,4,3,0.000196078,868896,0.980031581
23336,131,720,4,3,0.000196078,868900,0.980036093
23351,708,439,4,3,0.000196078,868904,0.980040605
24989,482,131,4,3,0.000196078,868908,0.980045116
23373,310,103,4,3,0.000196078,868912,0.980049628
24975,385,708,4,3,0.000196078,868916,0.980054139
25184,158,569,4,3,0.000196078,868920,0.980058651
23120,138,501,4,3,0.000196078,868924,0.980063163
22934,141,473,4,3,0.000196078,868928,0.980067674
25464,307,261,4,3,0.000196078,868932,0.980072186
22986,280,652,4,3,0.000196078,868936,0.980076697
22987,544,507,4,3,0.000196078,868940,0.980081209
22988,34,124,4,3,0.000196078,868944,0.980085721
22910,502,196,4,3,0.000196078,868948,0.980090232
22907,138,558,4,3,0.000196078,868952,0.980094744
22844,164,97,4,3,0.000196078,868956,0.980099256
22855,517,446,4,3,0.000196078,868960,0.980103767
22860,207,114,4,3,0.000196078,868964,0.980108279
22890,174,243,4,3,0.000196078,868968,0.98011279
22996,160,167,4,3,0.000196078,868972,0.980117302
23083,560,16,4,3,0.000196078,868976,0.980121814
25255,463,193,4,3,0.000196078,868980,0.980126325
23119,22,54,4,3,0.000196078,868984,0.980130837
23020,54,11,4,3,0.000196078,868988,0.980135349
25402,446,193,4,3,0.000196078,868992,0.98013986
25394,364,502,4,3,0.000196078,868996,0.980144372
23037,34,140,4,3,0.000196078,869000,0.980148883
23038,56,294,4,3,0.000196078,869004,0.980153395
23039,4,673,4,3,0.000196078,869008,0.980157907
25359,174,404,4,3,0.000196078,869012,0.980162418
23055,77,193,4,3,0.000196078,869016,0.98016693
24910,511,508,4,3,0.000196078,869020,0.980171441
22825,587,123,4,3,0.000196078,869024,0.980175953
24407,708,661,4,3,0.000196078,869028,0.980180465
23898,414,14,4,3,0.000196078,869032,0.980184976
23906,126,16,4,3,0.000196078,869036,0.980189488
24370,141,131,4,3,0.000196078,869040,0.980194
23962,525,243,4,3,0.000196078,869044,0.980198511
24430,246,663,4,3,0.000196078,869048,0.980203023
23803,522,493,4,3,0.000196078,869052,0.980207534
24463,646,385,4,3,0.000196078,869056,0.980212046
24452,274,618,4,3,0.000196078,869060,0.980216558
23823,719,689,4,3,0.000196078,869064,0.980221069
23989,503,586,4,3,0.000196078,869068,0.980225581
24207,48,332,4,3,0.000196078,869072,0.980230092
24074,202,155,4,3,0.000196078,869076,0.980234604
24107,14,4,4,3,0.000196078,869080,0.980239116
24180,50,482,4,3,0.000196078,869084,0.980243627
24121,56,618,4,3,0.000196078,869088,0.980248139
23994,19,126,4,3,0.000196078,869092,0.980252651
24299,181,347,4,3,0.000196078,869096,0.980257162
24011,626,30,4,3,0.000196078,869100,0.980261674
24483,30,673,4,3,0.000196078,869104,0.980266185
23586,385,562,4,3,0.000196078,869108,0.980270697
24668,586,673,4,3,0.000196078,869112,0.980275209
24657,230,571,4,3,0.000196078,869116,0.98027972
24656,674,701,4,3,0.000196078,869120,0.980284232
23642,723,195,4,3,0.000196078,869124,0.980288744
23537,13,107,4,3,0.000196078,869128,0.980293255
23530,492,398,4,3,0.000196078,869132,0.980297767
23466,138,6,4,3,0.000196078,869136,0.980302278
24802,204,503,4,3,0.000196078,869140,0.98030679
23646,719,475,4,3,0.000196078,869144,0.980311302
23746,14,571,4,3,0.000196078,869148,0.980315813
24514,383,64,4,3,0.000196078,869152,0.980320325
23751,121,130,4,3,0.000196078,869156,0.980324836
23752,493,674,4,3,0.000196078,869160,0.980329348
24509,56,90,4,3,0.000196078,869164,0.98033386
23773,471,673,4,3,0.000196078,869168,0.980338371
24490,683,126,4,3,0.000196078,869172,0.980342883
24618,280,207,4,3,0.000196078,869176,0.980347395
24606,514,269,4,3,0.000196078,869180,0.980351906
23672,398,269,4,3,0.000196078,869184,0.980356418
26360,19,265,4,3,0.000196078,869188,0.980360929
21808,646,6,4,3,0.000196078,869192,0.980365441
26396,64,535,4,3,0.000196078,869196,0.980369953
21841,95,193,4,3,0.000196078,869200,0.980374464
21847,393,587,4,3,0.000196078,869204,0.980378976
21853,33,482,4,3,0.000196078,869208,0.980383487
21879,170,230,4,3,0.000196078,869212,0.980387999
21790,15,85,4,3,0.000196078,869216,0.980392511
21761,522,409,4,3,0.000196078,869220,0.980397022
28580,23,507,4,3,0.000196078,869224,0.980401534
26567,103,364,4,3,0.000196078,869228,0.980406046
21747,717,195,4,3,0.000196078,869232,0.980410557
21762,632,328,4,3,0.000196078,869236,0.980415069
26416,613,528,4,3,0.000196078,869240,0.98041958
26441,54,392,4,3,0.000196078,869244,0.980424092
26431,219,624,4,3,0.000196078,869248,0.980428604
22029,11,12,4,3,0.000196078,869252,0.980433115
26175,133,328,4,3,0.000196078,869256,0.980437627
22052,171,64,4,3,0.000196078,869260,0.980442139
26266,354,448,4,3,0.000196078,869264,0.98044665
21896,13,243,4,3,0.000196078,869268,0.980451162
21933,43,294,4,3,0.000196078,869272,0.980455673
26306,196,269,4,3,0.000196078,869276,0.980460185
26296,131,458,4,3,0.000196078,869280,0.980464697
21945,475,117,4,3,0.000196078,869284,0.980469208
26582,290,171,4,3,0.000196078,869288,0.98047372
21453,133,171,4,3,0.000196078,869292,0.980478231
21468,409,243,4,3,0.000196078,869296,0.980482743
21475,587,224,4,3,0.000196078,869300,0.980487255
21478,290,310,4,3,0.000196078,869304,0.980491766
21502,699,121,4,3,0.000196078,869308,0.980496278
21505,522,569,4,3,0.000196078,869312,0.98050079
26973,446,508,4,3,0.000196078,869316,0.980505301
27026,269,170,4,3,0.000196078,869320,0.980509813
26821,202,167,4,3,0.000196078,869324,0.980514324
26732,23,156,4,3,0.000196078,869328,0.980518836
21629,16,446,4,3,0.000196078,869332,0.980523348
21622,397,269,4,3,0.000196078,869336,0.980527859
26639,85,397,4,3,0.000196078,869340,0.980532371
26632,552,207,4,3,0.000196078,869344,0.980536882
21683,15,414,4,3,0.000196078,869348,0.980541394
26816,614,103,4,3,0.000196078,869352,0.980545906
21532,646,131,4,3,0.000196078,869356,0.980550417
21577,29,114,4,3,0.000196078,869360,0.980554929
21591,383,156,4,3,0.000196078,869364,0.980559441
25773,443,138,4,3,0.000196078,869368,0.980563952
22584,64,596,4,3,0.000196078,869372,0.980568464
25761,354,492,4,3,0.000196078,869376,0.980572975
25731,492,328,4,3,0.000196078,869380,0.980577487
22639,501,646,4,3,0.000196078,869384,0.980581999
25779,502,5,4,3,0.000196078,869388,0.98058651
22552,721,114,4,3,0.000196078,869392,0.980591022
22551,97,683,4,3,0.000196078,869396,0.980595533
22454,26,661,4,3,0.000196078,869400,0.980600045
25839,121,56,4,3,0.000196078,869404,0.980604557
25818,347,720,4,3,0.000196078,869408,0.980609068
25583,140,593,4,3,0.000196078,869412,0.98061358
22781,463,4,4,3,0.000196078,869416,0.980618092
22809,207,174,4,3,0.000196078,869420,0.980622603
22811,514,503,4,3,0.000196078,869424,0.980627115
25552,443,207,4,3,0.000196078,869428,0.980631626
22734,43,103,4,3,0.000196078,869432,0.980636138
22713,624,532,4,3,0.000196078,869436,0.98064065
25646,269,25,4,3,0.000196078,869440,0.980645161
22440,586,507,4,3,0.000196078,869444,0.980649673
22144,632,514,4,3,0.000196078,869448,0.980654185
22151,204,673,4,3,0.000196078,869452,0.980658696
26017,721,167,4,3,0.000196078,869456,0.980663208
22195,514,674,4,3,0.000196078,869460,0.980667719
22205,525,414,4,3,0.000196078,869464,0.980672231
22093,95,13,4,3,0.000196078,869468,0.980676743
22112,719,64,4,3,0.000196078,869472,0.980681254
22113,701,14,4,3,0.000196078,869476,0.980685766
22261,614,4,4,3,0.000196078,869480,0.980690277
25910,613,587,4,3,0.000196078,869484,0.980694789
22426,48,525,4,3,0.000196078,869488,0.980699301
22428,15,605,4,3,0.000196078,869492,0.980703812
22381,717,295,4,3,0.000196078,869496,0.980708324
22368,458,443,4,3,0.000196078,869500,0.980712836
22276,195,207,4,3,0.000196078,869504,0.980717347
22290,5,181,4,3,0.000196078,869508,0.980721859
25933,364,155,4,3,0.000196078,869512,0.98072637
22323,219,673,4,3,0.000196078,869516,0.980730882
25953,167,264,4,3,0.000196078,869520,0.980735394
25950,114,552,4,3,0.000196078,869524,0.980739905
22441,640,4,4,3,0.000196078,869528,0.980744417
17810,48,661,4,3,0.000196078,869532,0.980748928
18025,9,569,4,3,0.000196078,869536,0.98075344
16886,140,334,4,3,0.000196078,869540,0.980757952
18017,404,31,4,3,0.000196078,869544,0.980762463
14613,494,331,4,3,0.000196078,869548,0.980766975
14626,638,2,4,3,0.000196078,869552,0.980771487
19093,23,331,4,3,0.000196078,869556,0.980775998
11481,673,164,4,3,0.000196078,869560,0.98078051
16841,274,246,4,3,0.000196078,869564,0.980785021
19904,393,20,4,3,0.000196078,869568,0.980789533
19172,302,392,4,3,0.000196078,869572,0.980794045
17038,397,30,4,3,0.000196078,869576,0.980798556
19131,511,141,4,3,0.000196078,869580,0.980803068
16944,586,167,4,3,0.000196078,869584,0.98080758
16790,701,335,4,3,0.000196078,869588,0.980812091
20046,613,236,4,3,0.000196078,869592,0.980816603
15048,269,394,4,3,0.000196078,869596,0.980821114
18198,646,10,4,3,0.000196078,869600,0.980825626
18195,48,20,4,3,0.000196078,869604,0.980830138
20079,511,171,4,3,0.000196078,869608,0.980834649
20072,25,307,4,3,0.000196078,869612,0.980839161
16621,33,193,4,3,0.000196078,869616,0.980843672
20060,558,503,4,3,0.000196078,869620,0.980848184
18237,593,117,4,3,0.000196078,869624,0.980852696
15133,160,380,4,3,0.000196078,869628,0.980857207
18931,475,528,4,3,0.000196078,869632,0.980861719
20122,155,335,4,3,0.000196078,869636,0.980866231
20105,379,269,4,3,0.000196078,869640,0.980870742
20097,624,48,4,3,0.000196078,869644,0.980875254
20045,673,364,4,3,0.000196078,869648,0.980879765
19950,525,354,4,3,0.000196078,869652,0.980884277
14887,683,123,4,3,0.000196078,869656,0.980888789
16740,56,543,4,3,0.000196078,869660,0.9808933
12275,498,475,4,3,0.000196078,869664,0.980897812
14861,307,156,4,3,0.000196078,869668,0.980902323
18105,43,158,4,3,0.000196078,869672,0.980906835
18097,673,171,4,3,0.000196078,869676,0.980911347
18123,439,158,4,3,0.000196078,869680,0.980915858
20039,593,22,4,3,0.000196078,869684,0.98092037
16682,138,77,4,3,0.000196078,869688,0.980924882
15004,174,29,4,3,0.000196078,869692,0.980929393
16693,246,16,4,3,0.000196078,869696,0.980933905
16700,123,155,4,3,0.000196078,869700,0.980938416
18132,4,97,4,3,0.000196078,869704,0.980942928
18997,242,114,4,3,0.000196078,869708,0.98094744
17723,482,68,4,3,0.000196078,869712,0.980951951
19540,463,242,4,3,0.000196078,869716,0.980956463
19361,160,242,4,3,0.000196078,869720,0.980960975
17696,721,582,4,3,0.000196078,869724,0.980965486
14014,264,131,4,3,0.000196078,869728,0.980969998
19323,163,502,4,3,0.000196078,869732,0.980974509
19569,230,138,4,3,0.000196078,869736,0.980979021
17377,721,123,4,3,0.000196078,869740,0.980983533
17379,708,50,4,3,0.000196078,869744,0.980988044
19564,138,141,4,3,0.000196078,869748,0.980992556
19337,19,105,4,3,0.000196078,869752,0.980997067
19412,126,314,4,3,0.000196078,869756,0.981001579
17578,497,155,4,3,0.000196078,869760,0.981006091
19437,493,10,4,3,0.000196078,869764,0.981010602
19420,588,13,4,3,0.000196078,869768,0.981015114
19432,517,64,4,3,0.000196078,869772,0.981019626
17548,618,130,4,3,0.000196078,869776,0.981024137
19421,605,15,4,3,0.000196078,869780,0.981028649
17492,529,517,4,3,0.000196078,869784,0.98103316
17655,475,264,4,3,0.000196078,869788,0.981037672
19513,354,587,4,3,0.000196078,869792,0.981042184
19506,56,560,4,3,0.000196078,869796,0.981046695
17474,196,155,4,3,0.000196078,869800,0.981051207
19470,133,145,4,3,0.000196078,869804,0.981055718
19399,668,77,4,3,0.000196078,869808,0.98106023
19473,22,64,4,3,0.000196078,869812,0.981064742
17783,593,535,4,3,0.000196078,869816,0.981069253
19598,613,588,4,3,0.000196078,869820,0.981073765
17909,117,243,4,3,0.000196078,869824,0.981078277
17908,663,246,4,3,0.000196078,869828,0.981082788
19726,178,105,4,3,0.000196078,869832,0.9810873
17116,25,348,4,3,0.000196078,869836,0.981091811
19250,529,140,4,3,0.000196078,869840,0.981096323
19713,34,117,4,3,0.000196078,869844,0.981100835
17131,29,475,4,3,0.000196078,869848,0.981105346
17941,719,347,4,3,0.000196078,869852,0.981109858
19764,392,117,4,3,0.000196078,869856,0.98111437
19763,562,502,4,3,0.000196078,869860,0.981118881
19759,663,195,4,3,0.000196078,869864,0.981123393
19745,307,1,4,3,0.000196078,869868,0.981127904
19256,2,265,4,3,0.000196078,869872,0.981132416
17842,719,588,4,3,0.000196078,869876,0.981136928
17264,174,463,4,3,0.000196078,869880,0.981141439
14079,586,31,4,3,0.000196078,869884,0.981145951
19610,661,230,4,3,0.000196078,869888,0.981150462
19605,163,522,4,3,0.000196078,869892,0.981154974
13381,246,314,4,3,0.000196078,869896,0.981159486
19652,243,646,4,3,0.000196078,869900,0.981163997
17220,393,640,4,3,0.000196078,869904,0.981168509
19691,133,605,4,3,0.000196078,869908,0.981173021
17201,492,331,4,3,0.000196078,869912,0.981177532
19281,613,243,4,3,0.000196078,869916,0.981182044
19655,50,294,4,3,0.000196078,869920,0.981186555
19676,609,34,4,3,0.000196078,869924,0.981191067
14141,544,543,4,3,0.000196078,869928,0.981195579
10057,95,84,4,3,0.000196078,869932,0.98120009
20336,593,674,4,3,0.000196078,869936,0.981204602
18467,29,311,4,3,0.000196078,869940,0.981209113
16026,439,535,4,3,0.000196078,869944,0.981213625
20388,77,103,4,3,0.000196078,869948,0.981218137
18781,448,379,4,3,0.000196078,869952,0.981222648
16161,721,311,4,3,0.000196078,869956,0.98122716
20276,614,593,4,3,0.000196078,869960,0.981231672
18356,618,498,4,3,0.000196078,869964,0.981236183
12640,498,708,4,3,0.000196078,869968,0.981240695
20321,13,511,4,3,0.000196078,869972,0.981245206
15468,618,3,4,3,0.000196078,869976,0.981249718
20310,532,85,4,3,0.000196078,869980,0.98125423
18603,48,290,4,3,0.000196078,869984,0.981258741
20533,552,364,4,3,0.000196078,869988,0.981263253
18597,529,503,4,3,0.000196078,869992,0.981267764
15755,613,84,4,3,0.000196078,869996,0.981272276
15937,90,243,4,3,0.000196078,870000,0.981276788
20472,202,310,4,3,0.000196078,870004,0.981281299
15952,721,310,4,3,0.000196078,870008,0.981285811
18588,498,646,4,3,0.000196078,870012,0.981290323
18682,335,43,4,3,0.000196078,870016,0.981294834
20491,207,164,4,3,0.000196078,870020,0.981299346
19422,708,394,4,3,0.000196078,870024,0.981303857
20227,414,475,4,3,0.000196078,870028,0.981308369
15352,105,569,4,3,0.000196078,870032,0.981312881
18885,668,307,4,3,0.000196078,870036,0.981317392
20211,138,158,4,3,0.000196078,870040,0.981321904
18307,25,347,4,3,0.000196078,870044,0.981326416
15282,242,302,4,3,0.000196078,870048,0.981330927
18831,613,250,4,3,0.000196078,870052,0.981335439
18829,552,2,4,3,0.000196078,870056,0.98133995
16325,525,522,4,3,0.000196078,870060,0.981344462
13042,250,674,4,3,0.000196078,870064,0.981348974
20187,9,90,4,3,0.000196078,870068,0.981353485
16214,133,638,4,3,0.000196078,870072,0.981357997
20185,20,265,4,3,0.000196078,870076,0.981362508
26480,328,163,3,3,0.000147059,870079,0.981365892
17853,13,571,3,3,0.000147059,870082,0.981369276
27145,269,475,3,3,0.000147059,870085,0.98137266
17855,242,167,3,3,0.000147059,870088,0.981376043
22610,178,354,3,3,0.000147059,870091,0.981379427
18559,721,302,3,3,0.000147059,870094,0.981382811
27146,354,85,3,3,0.000147059,870097,0.981386194
13398,719,14,3,3,0.000147059,870100,0.981389578
23229,646,532,3,3,0.000147059,870103,0.981392962
18562,498,193,3,3,0.000147059,870106,0.981396346
23303,668,543,3,3,0.000147059,870109,0.981399729
22926,586,652,3,3,0.000147059,870112,0.981403113
26787,632,140,3,3,0.000147059,870115,0.981406497
23301,409,532,3,3,0.000147059,870118,0.98140988
22930,347,528,3,3,0.000147059,870121,0.981413264
22931,19,618,3,3,0.000147059,870124,0.981416648
22586,528,29,3,3,0.000147059,870127,0.981420032
22608,160,605,3,3,0.000147059,870130,0.981423415
18583,31,107,3,3,0.000147059,870133,0.981426799
17817,582,290,3,3,0.000147059,870136,0.981430183
26479,383,640,3,3,0.000147059,870139,0.981433566
18554,618,334,3,3,0.000147059,870142,0.98143695
30145,433,347,3,3,0.000147059,870145,0.981440334
23318,613,522,3,3,0.000147059,870148,0.981443718
17735,544,20,3,3,0.000147059,870151,0.981447101
22841,117,158,3,3,0.000147059,870154,0.981450485
18557,385,497,3,3,0.000147059,870157,0.981453869
17751,682,145,3,3,0.000147059,870160,0.981457252
18586,492,473,3,3,0.000147059,870163,0.981460636
22579,587,582,3,3,0.000147059,870166,0.98146402
18584,529,90,3,3,0.000147059,870169,0.981467404
17867,492,236,3,3,0.000147059,870172,0.981470787
18280,529,12,3,3,0.000147059,870175,0.981474171
26900,269,56,3,3,0.000147059,870178,0.981477555
23220,174,501,3,3,0.000147059,870181,0.981480938
22923,174,560,3,3,0.000147059,870184,0.981484322
27149,34,571,3,3,0.000147059,870187,0.981487706
26482,721,64,3,3,0.000147059,870190,0.98149109
26568,364,683,3,3,0.000147059,870193,0.981494473
26902,502,383,3,3,0.000147059,870196,0.981497857
22946,103,11,3,3,0.000147059,870199,0.981501241
26483,261,494,3,3,0.000147059,870202,0.981504624
23299,133,588,3,3,0.000147059,870205,0.981508008
23265,503,11,3,3,0.000147059,870208,0.981511392
18282,290,473,3,3,0.000147059,870211,0.981514776
26515,394,508,3,3,0.000147059,870214,0.981518159
22936,124,130,3,3,0.000147059,870217,0.981521543
26526,274,652,3,3,0.000147059,870220,0.981524927
12923,313,409,3,3,0.000147059,870223,0.98152831
26797,145,528,3,3,0.000147059,870226,0.981531694
23266,145,673,3,3,0.000147059,870229,0.981535078
26913,171,587,3,3,0.000147059,870232,0.981538462
23264,195,230,3,3,0.000147059,870235,0.981541845
17847,708,141,3,3,0.000147059,870238,0.981545229
26545,126,295,3,3,0.000147059,870241,0.981548613
22941,90,353,3,3,0.000147059,870244,0.981551996
26529,409,274,3,3,0.000147059,870247,0.98155538
17802,133,14,3,3,0.000147059,870250,0.981558764
23250,618,497,3,3,0.000147059,870253,0.981562148
17832,394,85,3,3,0.000147059,870256,0.981565531
26914,507,1,3,3,0.000147059,870259,0.981568915
26514,544,175,3,3,0.000147059,870262,0.981572299
22595,13,264,3,3,0.000147059,870265,0.981575682
22607,714,331,3,3,0.000147059,870268,0.981579066
26560,175,174,3,3,0.000147059,870271,0.98158245
27136,723,30,3,3,0.000147059,870274,0.981585834
22606,13,587,3,3,0.000147059,870277,0.981589217
22587,383,140,3,3,0.000147059,870280,0.981592601
22933,558,493,3,3,0.000147059,870283,0.981595985
26559,202,204,3,3,0.000147059,870286,0.981599368
26489,6,269,3,3,0.000147059,870289,0.981602752
22605,219,261,3,3,0.000147059,870292,0.981606136
23287,140,479,3,3,0.000147059,870295,0.98160952
22591,313,492,3,3,0.000147059,870298,0.981612903
17779,158,250,3,3,0.000147059,870301,0.981616287
23280,90,10,3,3,0.000147059,870304,0.981619671
17780,294,314,3,3,0.000147059,870307,0.981623054
13088,517,170,3,3,0.000147059,870310,0.981626438
18564,528,145,3,3,0.000147059,870313,0.981629822
22593,503,236,3,3,0.000147059,870316,0.981633206
30165,181,224,3,3,0.000147059,870319,0.981636589
18065,347,195,3,3,0.000147059,870322,0.981639973
23338,699,158,3,3,0.000147059,870325,0.981643357
26814,160,14,3,3,0.000147059,870328,0.98164674
13662,167,20,3,3,0.000147059,870331,0.981650124
22537,383,274,3,3,0.000147059,870334,0.981653508
22888,31,25,3,3,0.000147059,870337,0.981656891
22891,164,605,3,3,0.000147059,870340,0.981660275
22544,140,196,3,3,0.000147059,870343,0.981663659
26359,494,517,3,3,0.000147059,870346,0.981667043
22893,492,243,3,3,0.000147059,870349,0.981670426
26362,181,2,3,3,0.000147059,870352,0.98167381
26363,121,334,3,3,0.000147059,870355,0.981677194
23408,207,11,3,3,0.000147059,870358,0.981680577
17610,394,543,3,3,0.000147059,870361,0.981683961
23403,141,243,3,3,0.000147059,870364,0.981687345
22545,243,171,3,3,0.000147059,870367,0.981690729
22546,230,175,3,3,0.000147059,870370,0.981694112
22547,717,380,3,3,0.000147059,870373,0.981697496
17613,605,6,3,3,0.000147059,870376,0.98170088
26842,274,207,3,3,0.000147059,870379,0.981704263
22862,479,163,3,3,0.000147059,870382,0.981707647
17616,674,23,3,3,0.000147059,870385,0.981711031
18263,661,9,3,3,0.000147059,870388,0.981714415
18608,193,560,3,3,0.000147059,870391,0.981717798
22886,699,638,3,3,0.000147059,870394,0.981721182
27173,427,528,3,3,0.000147059,870397,0.981724566
26871,22,174,3,3,0.000147059,870400,0.981727949
18247,593,158,3,3,0.000147059,870403,0.981731333
22876,720,663,3,3,0.000147059,870406,0.981734717
22867,638,171,3,3,0.000147059,870409,0.981738101
22877,193,230,3,3,0.000147059,870412,0.981741484
22526,404,156,3,3,0.000147059,870415,0.981744868
18242,33,593,3,3,0.000147059,870418,0.981748252
22884,593,371,3,3,0.000147059,870421,0.981751635
17562,265,414,3,3,0.000147059,870424,0.981755019
27174,528,156,3,3,0.000147059,870427,0.981758403
26325,20,684,3,3,0.000147059,870430,0.981761787
22864,392,347,3,3,0.000147059,870433,0.98176517
18609,158,479,3,3,0.000147059,870436,0.981768554
23442,614,160,3,3,0.000147059,870439,0.981771938
26327,250,133,3,3,0.000147059,870442,0.981775321
17576,514,32,3,3,0.000147059,870445,0.981778705
26329,682,12,3,3,0.000147059,870448,0.981782089
13708,655,638,3,3,0.000147059,870451,0.981785473
18261,721,22,3,3,0.000147059,870454,0.981788856
27171,708,163,3,3,0.000147059,870457,0.98179224
17588,20,397,3,3,0.000147059,870460,0.981795624
13689,397,34,3,3,0.000147059,870463,0.981799007
18218,265,163,3,3,0.000147059,870466,0.981802391
17619,95,156,3,3,0.000147059,870469,0.981805775
26371,131,701,3,3,0.000147059,870472,0.981809159
13462,264,236,3,3,0.000147059,870475,0.981812542
26426,354,319,3,3,0.000147059,870478,0.981815926
26430,684,508,3,3,0.000147059,870481,0.98181931
23352,202,22,3,3,0.000147059,870484,0.981822693
23346,19,353,3,3,0.000147059,870487,0.981826077
18204,156,501,3,3,0.000147059,870490,0.981829461
30141,328,175,3,3,0.000147059,870493,0.981832845
23345,155,202,3,3,0.000147059,870496,0.981836228
22563,43,482,3,3,0.000147059,870499,0.981839612
22908,332,385,3,3,0.000147059,870502,0.981842996
23337,501,673,3,3,0.000147059,870505,0.981846379
17626,720,80,3,3,0.000147059,870508,0.981849763
22566,714,236,3,3,0.000147059,870511,0.981853147
27156,342,379,3,3,0.000147059,870514,0.981856531
26823,250,13,3,3,0.000147059,870517,0.981859914
13051,97,236,3,3,0.000147059,870520,0.981863298
23331,2,446,3,3,0.000147059,870523,0.981866682
30144,646,347,3,3,0.000147059,870526,0.981870065
26461,718,32,3,3,0.000147059,870529,0.981873449
23326,193,243,3,3,0.000147059,870532,0.981876833
22848,367,174,3,3,0.000147059,870535,0.981880217
23323,544,25,3,3,0.000147059,870538,0.9818836
18267,492,522,3,3,0.000147059,870541,0.981886984
23320,140,517,3,3,0.000147059,870544,0.981890368
27159,364,497,3,3,0.000147059,870547,0.981893751
23357,23,497,3,3,0.000147059,870550,0.981897135
26418,532,90,3,3,0.000147059,870553,0.981900519
22858,160,10,3,3,0.000147059,870556,0.981903903
17627,596,605,3,3,0.000147059,870559,0.981907286
17628,174,353,3,3,0.000147059,870562,0.98191067
26837,314,202,3,3,0.000147059,870565,0.981914054
27166,310,458,3,3,0.000147059,870568,0.981917437
17639,117,479,3,3,0.000147059,870571,0.981920821
22550,302,43,3,3,0.000147059,870574,0.981924205
23378,507,56,3,3,0.000147059,870577,0.981927589
18209,4,632,3,3,0.000147059,870580,0.981930972
22854,15,482,3,3,0.000147059,870583,0.981934356
22553,29,364,3,3,0.000147059,870586,0.98193774
18600,2,640,3,3,0.000147059,870589,0.981941123
26407,552,652,3,3,0.000147059,870592,0.981944507
22850,64,501,3,3,0.000147059,870595,0.981947891
27161,683,14,3,3,0.000147059,870598,0.981951275
18266,3,12,3,3,0.000147059,870601,0.981954658
26573,90,140,3,3,0.000147059,870604,0.981958042
26593,560,219,3,3,0.000147059,870607,0.981961426
22948,586,126,3,3,0.000147059,870610,0.981964809
23092,25,646,3,3,0.000147059,870613,0.981968193
26751,155,126,3,3,0.000147059,870616,0.981971577
18411,25,552,3,3,0.000147059,870619,0.981974961
18109,605,497,3,3,0.000147059,870622,0.981978344
23096,261,242,3,3,0.000147059,870625,0.981981728
18405,265,638,3,3,0.000147059,870628,0.981985112
23094,668,655,3,3,0.000147059,870631,0.981988495
26673,25,30,3,3,0.000147059,870634,0.981991879
23091,514,708,3,3,0.000147059,870637,0.981995263
23102,482,11,3,3,0.000147059,870640,0.981998647
26953,661,663,3,3,0.000147059,870643,0.98200203
17988,498,632,3,3,0.000147059,870646,0.982005414
22714,334,392,3,3,0.000147059,870649,0.982008798
17990,383,398,3,3,0.000147059,870652,0.982012181
26679,552,290,3,3,0.000147059,870655,0.982015565
23084,427,156,3,3,0.000147059,870658,0.982018949
18398,626,196,3,3,0.000147059,870661,0.982022333
26750,663,668,3,3,0.000147059,870664,0.982025716
17995,398,475,3,3,0.000147059,870667,0.9820291
26748,514,64,3,3,0.000147059,870670,0.982032484
22717,167,331,3,3,0.000147059,870673,0.982035867
18007,3,448,3,3,0.000147059,870676,0.982039251
26670,661,14,3,3,0.000147059,870679,0.982042635
27052,427,85,3,3,0.000147059,870682,0.982046018
18010,494,9,3,3,0.000147059,870685,0.982049402
26949,334,5,3,3,0.000147059,870688,0.982052786
22689,84,174,3,3,0.000147059,870691,0.98205617
13152,379,543,3,3,0.000147059,870694,0.982059553
23113,313,720,3,3,0.000147059,870697,0.982062937
18445,471,26,3,3,0.000147059,870700,0.982066321
22691,156,398,3,3,0.000147059,870703,0.982069704
23112,699,131,3,3,0.000147059,870706,0.982073088
27065,502,54,3,3,0.000147059,870709,0.982076472
26666,25,673,3,3,0.000147059,870712,0.982079856
18440,103,30,3,3,0.000147059,870715,0.982083239
27063,171,290,3,3,0.000147059,870718,0.982086623
22991,50,20,3,3,0.000147059,870721,0.982090007
26669,265,383,3,3,0.000147059,870724,0.98209339
18433,164,22,3,3,0.000147059,870727,0.982096774
22700,380,319,3,3,0.000147059,870730,0.982100158
27057,50,605,3,3,0.000147059,870733,0.982103542
18324,397,140,3,3,0.000147059,870736,0.982106925
26757,511,514,3,3,0.000147059,870739,0.982110309
23106,493,479,3,3,0.000147059,870742,0.982113693
18122,353,294,3,3,0.000147059,870745,0.982117076
27053,25,383,3,3,0.000147059,870748,0.98212046
23008,632,265,3,3,0.000147059,870751,0.982123844
27041,193,107,3,3,0.000147059,870754,0.982127228
26939,90,393,3,3,0.000147059,870757,0.982130611
26709,242,332,3,3,0.000147059,870760,0.982133995
27004,19,264,3,3,0.000147059,870763,0.982137379
18345,682,196,3,3,0.000147059,870766,0.982140762
22750,26,493,3,3,0.000147059,870769,0.982144146
18043,265,121,3,3,0.000147059,870772,0.98214753
23024,614,673,3,3,0.000147059,870775,0.982150914
26707,274,661,3,3,0.000147059,870778,0.982154297
18359,385,130,3,3,0.000147059,870781,0.982157681
22768,124,141,3,3,0.000147059,870784,0.982161065
22766,335,433,3,3,0.000147059,870787,0.982164448
18353,673,414,3,3,0.000147059,870790,0.982167832
23051,265,708,3,3,0.000147059,870793,0.982171216
26712,626,380,3,3,0.000147059,870796,0.9821746
26705,708,181,3,3,0.000147059,870799,0.982177983
22764,207,543,3,3,0.000147059,870802,0.982181367
22757,605,33,3,3,0.000147059,870805,0.982184751
22758,196,661,3,3,0.000147059,870808,0.982188134
26996,19,171,3,3,0.000147059,870811,0.982191518
23027,204,23,3,3,0.000147059,870814,0.982194902
18072,409,334,3,3,0.000147059,870817,0.982198286
22763,20,56,3,3,0.000147059,870820,0.982201669
23042,170,31,3,3,0.000147059,870823,0.982205053
23041,261,497,3,3,0.000147059,870826,0.982208437
18062,544,265,3,3,0.000147059,870829,0.98221182
18063,683,532,3,3,0.000147059,870832,0.982215204
26992,1,605,3,3,0.000147059,870835,0.982218588
18338,380,137,3,3,0.000147059,870838,0.982221972
22785,264,347,3,3,0.000147059,870841,0.982225355
18099,674,571,3,3,0.000147059,870844,0.982228739
22720,195,158,3,3,0.000147059,870847,0.982232123
23012,16,624,3,3,0.000147059,870850,0.982235506
26685,15,332,3,3,0.000147059,870853,0.98223889
18388,4,15,3,3,0.000147059,870856,0.982242274
26686,64,714,3,3,0.000147059,870859,0.982245658
18093,525,123,3,3,0.000147059,870862,0.982249041
22726,668,141,3,3,0.000147059,870865,0.982252425
23019,367,446,3,3,0.000147059,870868,0.982255809
23022,508,32,3,3,0.000147059,870871,0.982259192
12759,163,77,3,3,0.000147059,870874,0.982262576
22729,204,290,3,3,0.000147059,870877,0.98226596
18383,265,528,3,3,0.000147059,870880,0.982269344
27020,719,596,3,3,0.000147059,870883,0.982272727
18371,443,155,3,3,0.000147059,870886,0.982276111
22740,719,348,3,3,0.000147059,870889,0.982279495
23068,618,11,3,3,0.000147059,870892,0.982282878
22742,668,640,3,3,0.000147059,870895,0.982286262
23062,638,593,3,3,0.000147059,870898,0.982289646
26703,385,613,3,3,0.000147059,870901,0.98229303
18447,507,3,3,3,0.000147059,870904,0.982296413
17958,50,4,3,3,0.000147059,870907,0.982299797
22620,43,683,3,3,0.000147059,870910,0.982303181
13151,507,31,3,3,0.000147059,870913,0.982306564
26608,138,121,3,3,0.000147059,870916,0.982309948
22823,684,243,3,3,0.000147059,870919,0.982313332
13334,367,383,3,3,0.000147059,870922,0.982316716
18496,29,9,3,3,0.000147059,870925,0.982320099
22648,392,121,3,3,0.000147059,870928,0.982323483
18175,443,613,3,3,0.000147059,870931,0.982326867
23184,683,95,3,3,0.000147059,870934,0.98233025
27098,503,14,3,3,0.000147059,870937,0.982333634
23183,12,683,3,3,0.000147059,870940,0.982337018
22962,155,501,3,3,0.000147059,870943,0.982340402
22822,414,708,3,3,0.000147059,870946,0.982343785
23189,130,103,3,3,0.000147059,870949,0.982347169
22820,482,393,3,3,0.000147059,870952,0.982350553
26615,14,163,3,3,0.000147059,870955,0.982353936
22654,26,409,3,3,0.000147059,870958,0.98235732
23173,525,517,3,3,0.000147059,870961,0.982360704
26621,328,446,3,3,0.000147059,870964,0.982364088
17897,471,714,3,3,0.000147059,870967,0.982367471
26603,14,552,3,3,0.000147059,870970,0.982370855
18289,5,334,3,3,0.000147059,870973,0.982374239
27115,663,319,3,3,0.000147059,870976,0.982377622
18540,682,404,3,3,0.000147059,870979,0.982381006
22824,269,379,3,3,0.000147059,870982,0.98238439
23214,294,347,3,3,0.000147059,870985,0.982387774
23213,97,446,3,3,0.000147059,870988,0.982391157
18535,5,535,3,3,0.000147059,870991,0.982394541
18534,131,587,3,3,0.000147059,870994,0.982397925
26578,364,482,3,3,0.000147059,870997,0.982401308
13359,4,479,3,3,0.000147059,871000,0.982404692
22627,508,708,3,3,0.000147059,871003,0.982408076
30177,261,29,3,3,0.000147059,871006,0.98241146
26586,718,95,3,3,0.000147059,871009,0.982414843
26781,404,90,3,3,0.000147059,871012,0.982418227
22632,532,613,3,3,0.000147059,871015,0.982421611
26592,385,652,3,3,0.000147059,871018,0.982424994
23202,50,508,3,3,0.000147059,871021,0.982428378
18070,265,543,3,3,0.000147059,871024,0.982431762
22954,167,443,3,3,0.000147059,871027,0.982435145
23197,443,661,3,3,0.000147059,871030,0.982438529
23195,673,12,3,3,0.000147059,871033,0.982441913
18524,383,663,3,3,0.000147059,871036,0.982445297
23194,632,446,3,3,0.000147059,871039,0.98244868
17892,163,32,3,3,0.000147059,871042,0.982452064
18509,593,56,3,3,0.000147059,871045,0.982455448
22967,195,155,3,3,0.000147059,871048,0.982458831
23169,624,463,3,3,0.000147059,871051,0.982462215
22685,103,463,3,3,0.000147059,871054,0.982465599
15808,543,242,3,3,0.000147059,871057,0.982468983
26641,15,4,3,3,0.000147059,871060,0.982472366
23144,683,529,3,3,0.000147059,871063,0.98247575
26642,525,507,3,3,0.000147059,871066,0.982479134
23139,97,164,3,3,0.000147059,871069,0.982482517
23137,558,246,3,3,0.000147059,871072,0.982485901
26653,393,493,3,3,0.000147059,871075,0.982489285
22977,195,5,3,3,0.000147059,871078,0.982492669
18455,684,335,3,3,0.000147059,871081,0.982496052
22978,482,638,3,3,0.000147059,871084,0.982499436
23135,133,511,3,3,0.000147059,871087,0.98250282
17931,264,107,3,3,0.000147059,871090,0.982506203
22680,721,121,3,3,0.000147059,871093,0.982509587
26640,170,443,3,3,0.000147059,871096,0.982512971
26872,178,313,3,3,0.000147059,871099,0.982516355
13303,503,158,3,3,0.000147059,871102,0.982519738
22982,264,674,3,3,0.000147059,871105,0.982523122
23123,558,23,3,3,0.000147059,871108,0.982526506
27077,558,576,3,3,0.000147059,871111,0.982529889
22985,43,56,3,3,0.000147059,871114,0.982533273
18128,543,155,3,3,0.000147059,871117,0.982536657
23121,719,10,3,3,0.000147059,871120,0.982540041
17957,32,85,3,3,0.000147059,871123,0.982543424
18141,156,265,3,3,0.000147059,871126,0.982546808
17927,4,544,3,3,0.000147059,871129,0.982550192
22815,138,25,3,3,0.000147059,871132,0.982553575
17914,379,652,3,3,0.000147059,871135,0.982556959
27091,84,290,3,3,0.000147059,871138,0.982560343
17907,544,552,3,3,0.000147059,871141,0.982563727
18291,219,207,3,3,0.000147059,871144,0.98256711
22661,364,141,3,3,0.000147059,871147,0.982570494
22812,394,342,3,3,0.000147059,871150,0.982573878
26771,525,439,3,3,0.000147059,871153,0.982577261
17912,571,68,3,3,0.000147059,871156,0.982580645
23163,334,22,3,3,0.000147059,871159,0.982584029
22665,332,302,3,3,0.000147059,871162,0.982587413
23161,392,535,3,3,0.000147059,871165,0.982590796
26625,19,155,3,3,0.000147059,871168,0.98259418
23158,414,156,3,3,0.000147059,871171,0.982597564
22804,54,367,3,3,0.000147059,871174,0.982600947
23157,427,126,3,3,0.000147059,871177,0.982604331
26768,354,290,3,3,0.000147059,871180,0.982607715
13323,4,274,3,3,0.000147059,871183,0.982611099
27080,265,137,3,3,0.000147059,871186,0.982614482
17917,274,64,3,3,0.000147059,871189,0.982617866
26932,167,1,3,3,0.000147059,871192,0.98262125
22973,586,593,3,3,0.000147059,871195,0.982624633
23151,160,347,3,3,0.000147059,871198,0.982628017
18471,43,535,3,3,0.000147059,871201,0.982631401
22675,618,175,3,3,0.000147059,871204,0.982634785
18453,448,302,3,3,0.000147059,871207,0.982638168
24672,439,632,3,3,0.000147059,871210,0.982641552
17549,30,25,3,3,0.000147059,871213,0.982644936
24436,347,364,3,3,0.000147059,871216,0.982648319
25469,517,514,3,3,0.000147059,871219,0.982651703
16397,302,383,3,3,0.000147059,871222,0.982655087
25466,614,195,3,3,0.000147059,871225,0.982658471
25465,90,497,3,3,0.000147059,871228,0.982661854
24444,587,588,3,3,0.000147059,871231,0.982665238
24451,121,6,3,3,0.000147059,871234,0.982668622
25457,207,353,3,3,0.000147059,871237,0.982672005
24453,393,269,3,3,0.000147059,871240,0.982675389
25446,699,3,3,3,0.000147059,871243,0.982678773
16350,655,3,3,3,0.000147059,871246,0.982682157
24465,535,23,3,3,0.000147059,871249,0.98268554
24466,668,404,3,3,0.000147059,871252,0.982688924
16348,689,543,3,3,0.000147059,871255,0.982692308
16336,310,155,3,3,0.000147059,871258,0.982695691
16412,264,334,3,3,0.000147059,871261,0.982699075
24434,193,164,3,3,0.000147059,871264,0.982702459
24433,562,140,3,3,0.000147059,871267,0.982705843
24406,498,482,3,3,0.000147059,871270,0.982709226
15249,334,250,3,3,0.000147059,871273,0.98271261
25484,202,33,3,3,0.000147059,871276,0.982715994
25482,246,364,3,3,0.000147059,871279,0.982719377
16424,448,105,3,3,0.000147059,871282,0.982722761
24419,97,502,3,3,0.000147059,871285,0.982726145
24432,448,367,3,3,0.000147059,871288,0.982729529
24420,124,443,3,3,0.000147059,871291,0.982732912
24421,133,528,3,3,0.000147059,871294,0.982736296
16419,367,593,3,3,0.000147059,871297,0.98273968
24425,23,314,3,3,0.000147059,871300,0.982743063
24426,684,22,3,3,0.000147059,871303,0.982746447
24428,32,290,3,3,0.000147059,871306,0.982749831
24429,13,103,3,3,0.000147059,871309,0.982753215
24482,342,596,3,3,0.000147059,871312,0.982756598
16315,207,3,3,3,0.000147059,871315,0.982759982
24494,364,562,3,3,0.000147059,871318,0.982763366
25329,95,43,3,3,0.000147059,871321,0.982766749
25353,398,1,3,3,0.000147059,871324,0.982770133
25350,124,311,3,3,0.000147059,871327,0.982773517
24562,105,342,3,3,0.000147059,871330,0.982776901
25348,34,163,3,3,0.000147059,871333,0.982780284
25343,56,269,3,3,0.000147059,871336,0.982783668
25325,673,646,3,3,0.000147059,871339,0.982787052
16198,673,30,3,3,0.000147059,871342,0.982790435
25323,103,64,3,3,0.000147059,871345,0.982793819
25318,219,493,3,3,0.000147059,871348,0.982797203
25316,124,97,3,3,0.000147059,871351,0.982800587
24586,15,404,3,3,0.000147059,871354,0.98280397
24587,347,613,3,3,0.000147059,871357,0.982807354
24588,114,174,3,3,0.000147059,871360,0.982810738
25314,269,50,3,3,0.000147059,871363,0.982814121
24551,103,280,3,3,0.000147059,871366,0.982817505
25413,517,56,3,3,0.000147059,871369,0.982820889
25411,105,576,3,3,0.000147059,871372,0.982824273
25407,20,398,3,3,0.000147059,871375,0.982827656
16294,95,364,3,3,0.000147059,871378,0.98283104
24506,701,558,3,3,0.000147059,871381,0.982834424
24507,48,178,3,3,0.000147059,871384,0.982837807
15355,10,383,3,3,0.000147059,871387,0.982841191
25388,560,32,3,3,0.000147059,871390,0.982844575
24550,103,723,3,3,0.000147059,871393,0.982847958
16239,532,4,3,3,0.000147059,871396,0.982851342
25381,646,586,3,3,0.000147059,871399,0.982854726
24530,242,126,3,3,0.000147059,871402,0.98285811
25374,242,683,3,3,0.000147059,871405,0.982861493
24540,207,307,3,3,0.000147059,871408,0.982864877
25370,614,493,3,3,0.000147059,871411,0.982868261
16216,532,392,3,3,0.000147059,871414,0.982871644
16208,140,141,3,3,0.000147059,871417,0.982875028
24403,6,576,3,3,0.000147059,871420,0.982878412
23453,463,163,3,3,0.000147059,871423,0.982881796
25604,684,121,3,3,0.000147059,871426,0.982885179
15041,701,123,3,3,0.000147059,871429,0.982888563
16636,14,77,3,3,0.000147059,871432,0.982891947
24269,348,19,3,3,0.000147059,871435,0.98289533
16633,264,614,3,3,0.000147059,871438,0.982898714
24272,397,492,3,3,0.000147059,871441,0.982902098
24275,471,13,3,3,0.000147059,871444,0.982905482
16626,307,20,3,3,0.000147059,871447,0.982908865
24283,708,701,3,3,0.000147059,871450,0.982912249
24285,202,471,3,3,0.000147059,871453,0.982915633
24288,174,497,3,3,0.000147059,871456,0.982919016
25584,493,723,3,3,0.000147059,871459,0.9829224
24290,618,562,3,3,0.000147059,871462,0.982925784
16619,307,294,3,3,0.000147059,871465,0.982929168
16612,274,689,3,3,0.000147059,871468,0.982932551
25573,394,29,3,3,0.000147059,871471,0.982935935
24263,178,3,3,3,0.000147059,871474,0.982939319
25614,141,552,3,3,0.000147059,871477,0.982942702
25619,528,613,3,3,0.000147059,871480,0.982946086
24232,310,494,3,3,0.000147059,871483,0.98294947
24217,196,646,3,3,0.000147059,871486,0.982952854
24218,613,117,3,3,0.000147059,871489,0.982956237
24219,31,507,3,3,0.000147059,871492,0.982959621
24221,170,708,3,3,0.000147059,871495,0.982963005
25644,22,126,3,3,0.000147059,871498,0.982966388
24227,699,145,3,3,0.000147059,871501,0.982969772
24231,48,493,3,3,0.000147059,871504,0.982973156
24237,493,497,3,3,0.000147059,871507,0.98297654
25634,471,683,3,3,0.000147059,871510,0.982979923
25632,145,133,3,3,0.000147059,871513,0.982983307
25629,543,661,3,3,0.000147059,871516,0.982986691
24244,261,33,3,3,0.000147059,871519,0.982990074
24246,140,121,3,3,0.000147059,871522,0.982993458
25571,261,392,3,3,0.000147059,871525,0.982996842
24303,90,32,3,3,0.000147059,871528,0.983000226
15196,5,114,3,3,0.000147059,871531,0.983003609
16528,164,638,3,3,0.000147059,871534,0.983006993
16511,30,427,3,3,0.000147059,871537,0.983010377
15172,310,714,3,3,0.000147059,871540,0.98301376
25516,528,30,3,3,0.000147059,871543,0.983017144
24371,535,493,3,3,0.000147059,871546,0.983020528
15174,97,114,3,3,0.000147059,871549,0.983023912
25507,596,494,3,3,0.000147059,871552,0.983027295
24379,404,511,3,3,0.000147059,871555,0.983030679
24381,507,439,3,3,0.000147059,871558,0.983034063
16458,50,586,3,3,0.000147059,871561,0.983037446
25502,498,103,3,3,0.000147059,871564,0.98304083
24385,246,328,3,3,0.000147059,871567,0.983044214
16456,163,264,3,3,0.000147059,871570,0.983047598
24388,511,383,3,3,0.000147059,871573,0.983050981
25523,121,532,3,3,0.000147059,871576,0.983054365
16606,20,720,3,3,0.000147059,871579,0.983057749
16569,295,193,3,3,0.000147059,871582,0.983061132
16602,43,443,3,3,0.000147059,871585,0.983064516
24315,158,661,3,3,0.000147059,871588,0.9830679
15076,31,26,3,3,0.000147059,871591,0.983071284
24320,15,673,3,3,0.000147059,871594,0.983074667
24321,398,587,3,3,0.000147059,871597,0.983078051
15077,4,307,3,3,0.000147059,871600,0.983081435
15100,97,30,3,3,0.000147059,871603,0.983084818
16544,9,613,3,3,0.000147059,871606,0.983088202
16540,613,33,3,3,0.000147059,871609,0.983091586
24336,141,250,3,3,0.000147059,871612,0.98309497
24337,503,48,3,3,0.000147059,871615,0.983098353
24341,562,661,3,3,0.000147059,871618,0.983101737
25539,640,383,3,3,0.000147059,871621,0.983105121
24349,655,332,3,3,0.000147059,871624,0.983108504
25530,274,85,3,3,0.000147059,871627,0.983111888
24591,618,560,3,3,0.000147059,871630,0.983115272
24592,719,393,3,3,0.000147059,871633,0.983118656
24594,311,138,3,3,0.000147059,871636,0.983122039
24852,353,569,3,3,0.000147059,871639,0.983125423
25078,701,145,3,3,0.000147059,871642,0.983128807
24854,493,535,3,3,0.000147059,871645,0.98313219
24856,242,269,3,3,0.000147059,871648,0.983135574
25073,3,624,3,3,0.000147059,871651,0.983138958
25069,224,133,3,3,0.000147059,871654,0.983142342
25067,310,90,3,3,0.000147059,871657,0.983145725
25066,364,334,3,3,0.000147059,871660,0.983149109
24870,307,290,3,3,0.000147059,871663,0.983152493
24871,202,123,3,3,0.000147059,871666,0.983155876
25056,4,195,3,3,0.000147059,871669,0.98315926
24876,543,404,3,3,0.000147059,871672,0.983162644
25055,397,613,3,3,0.000147059,871675,0.983166028
15938,673,22,3,3,0.000147059,871678,0.983169411
25053,50,29,3,3,0.000147059,871681,0.983172795
24884,133,29,3,3,0.000147059,871684,0.983176179
24885,393,140,3,3,0.000147059,871687,0.983179562
24850,130,319,3,3,0.000147059,871690,0.983182946
24849,22,471,3,3,0.000147059,871693,0.98318633
25092,25,364,3,3,0.000147059,871696,0.983189714
25098,503,311,3,3,0.000147059,871699,0.983193097
15613,682,95,3,3,0.000147059,871702,0.983196481
24827,714,77,3,3,0.000147059,871705,0.983199865
24828,404,64,3,3,0.000147059,871708,0.983203248
24829,393,195,3,3,0.000147059,871711,0.983206632
25094,33,383,3,3,0.000147059,871714,0.983210016
25093,95,290,3,3,0.000147059,871717,0.9832134
25082,230,133,3,3,0.000147059,871720,0.983216783
24834,167,507,3,3,0.000147059,871723,0.983220167
25088,646,543,3,3,0.000147059,871726,0.983223551
24842,48,571,3,3,0.000147059,871729,0.983226934
24843,514,507,3,3,0.000147059,871732,0.983230318
15636,160,314,3,3,0.000147059,871735,0.983233702
24846,141,587,3,3,0.000147059,871738,0.983237085
24886,596,571,3,3,0.000147059,871741,0.983240469
15672,107,684,3,3,0.000147059,871744,0.983243853
24889,632,528,3,3,0.000147059,871747,0.983247237
24998,674,103,3,3,0.000147059,871750,0.98325062
25006,525,15,3,3,0.000147059,871753,0.983254004
24943,264,196,3,3,0.000147059,871756,0.983257388
24944,587,522,3,3,0.000147059,871759,0.983260771
24946,20,439,3,3,0.000147059,871762,0.983264155
15891,264,9,3,3,0.000147059,871765,0.983267539
24950,107,133,3,3,0.000147059,871768,0.983270923
25010,348,261,3,3,0.000147059,871771,0.983274306
24992,501,246,3,3,0.000147059,871774,0.98327769
24990,207,528,3,3,0.000147059,871777,0.983281074
15858,609,501,3,3,0.000147059,871780,0.983284457
15792,525,80,3,3,0.000147059,871783,0.983287841
24960,588,133,3,3,0.000147059,871786,0.983291225
15806,507,6,3,3,0.000147059,871789,0.983294609
25009,141,674,3,3,0.000147059,871792,0.983297992
25012,552,503,3,3,0.000147059,871795,0.983301376
15679,398,196,3,3,0.000147059,871798,0.98330476
24896,48,90,3,3,0.000147059,871801,0.983308143
24898,202,64,3,3,0.000147059,871804,0.983311527
25041,626,204,3,3,0.000147059,871807,0.983314911
15709,494,535,3,3,0.000147059,871810,0.983318295
25038,414,269,3,3,0.000147059,871813,0.983321678
24904,479,684,3,3,0.000147059,871816,0.983325062
24907,448,2,3,3,0.000147059,871819,0.983328446
25032,50,640,3,3,0.000147059,871822,0.983331829
24928,334,64,3,3,0.000147059,871825,0.983335213
24912,593,605,3,3,0.000147059,871828,0.983338597
15911,605,588,3,3,0.000147059,871831,0.983341981
15722,498,30,3,3,0.000147059,871834,0.983345364
24919,48,163,3,3,0.000147059,871837,0.983348748
25020,43,525,3,3,0.000147059,871840,0.983352132
24923,269,514,3,3,0.000147059,871843,0.983355515
15909,97,393,3,3,0.000147059,871846,0.983358899
25099,5,624,3,3,0.000147059,871849,0.983362283
15605,64,3,3,3,0.000147059,871852,0.983365667
25220,264,114,3,3,0.000147059,871855,0.98336905
24669,163,33,3,3,0.000147059,871858,0.983372434
24673,20,163,3,3,0.000147059,871861,0.983375818
24680,528,618,3,3,0.000147059,871864,0.983379201
24682,246,463,3,3,0.000147059,871867,0.983382585
16087,114,121,3,3,0.000147059,871870,0.983385969
24687,54,640,3,3,0.000147059,871873,0.983389353
24689,427,652,3,3,0.000147059,871876,0.983392736
25219,171,404,3,3,0.000147059,871879,0.98339612
25216,668,708,3,3,0.000147059,871882,0.983399504
24701,482,302,3,3,0.000147059,871885,0.983402887
25214,661,107,3,3,0.000147059,871888,0.983406271
24703,243,174,3,3,0.000147059,871891,0.983409655
24705,409,68,3,3,0.000147059,871894,0.983413039
24706,446,126,3,3,0.000147059,871897,0.983416422
25211,364,164,3,3,0.000147059,871900,0.983419806
24711,458,2,3,3,0.000147059,871903,0.98342319
24666,719,443,3,3,0.000147059,871906,0.983426573
24659,624,517,3,3,0.000147059,871909,0.983429957
24714,1,502,3,3,0.000147059,871912,0.983433341
16178,624,310,3,3,0.000147059,871915,0.983436725
16165,404,95,3,3,0.000147059,871918,0.983440108
24611,25,97,3,3,0.000147059,871921,0.983443492
24613,471,261,3,3,0.000147059,871924,0.983446876
24615,6,23,3,3,0.000147059,871927,0.983450259
24616,503,121,3,3,0.000147059,871930,0.983453643
16145,624,295,3,3,0.000147059,871933,0.983457027
25260,193,236,3,3,0.000147059,871936,0.983460411
24627,535,103,3,3,0.000147059,871939,0.983463794
25277,522,576,3,3,0.000147059,871942,0.983467178
16121,103,479,3,3,0.000147059,871945,0.983470562
15470,458,80,3,3,0.000147059,871948,0.983473945
16112,721,497,3,3,0.000147059,871951,0.983477329
24713,181,230,3,3,0.000147059,871954,0.983480713
25199,54,31,3,3,0.000147059,871957,0.983484097
25108,307,684,3,3,0.000147059,871960,0.98348748
15991,586,15,3,3,0.000147059,871963,0.983490864
25142,503,95,3,3,0.000147059,871966,0.983494248
24778,294,195,3,3,0.000147059,871969,0.983497631
25140,5,155,3,3,0.000147059,871972,0.983501015
25138,158,624,3,3,0.000147059,871975,0.983504399
24782,117,646,3,3,0.000147059,871978,0.983507783
24784,11,155,3,3,0.000147059,871981,0.983511166
16004,507,171,3,3,0.000147059,871984,0.98351455
25126,511,195,3,3,0.000147059,871987,0.983517934
16023,6,124,3,3,0.000147059,871990,0.983521317
25116,56,503,3,3,0.000147059,871993,0.983524701
24805,269,23,3,3,0.000147059,871996,0.983528085
15971,261,586,3,3,0.000147059,871999,0.983531469
25151,29,264,3,3,0.000147059,872002,0.983534852
25160,25,475,3,3,0.000147059,872005,0.983538236
24741,446,331,3,3,0.000147059,872008,0.98354162
15503,207,380,3,3,0.000147059,872011,0.983545003
25193,479,178,3,3,0.000147059,872014,0.983548387
24727,155,517,3,3,0.000147059,872017,0.983551771
24728,328,126,3,3,0.000147059,872020,0.983555155
15517,475,174,3,3,0.000147059,872023,0.983558538
24738,95,23,3,3,0.000147059,872026,0.983561922
25182,624,103,3,3,0.000147059,872029,0.983565306
25181,380,175,3,3,0.000147059,872032,0.983568689
24747,525,385,3,3,0.000147059,872035,0.983572073
24750,552,673,3,3,0.000147059,872038,0.983575457
24752,332,427,3,3,0.000147059,872041,0.983578841
16034,605,3,3,3,0.000147059,872044,0.983582224
25171,458,107,3,3,0.000147059,872047,0.983585608
15541,383,614,3,3,0.000147059,872050,0.983588992
24211,683,158,3,3,0.000147059,872053,0.983592375
14972,167,511,3,3,0.000147059,872056,0.983595759
17188,25,117,3,3,0.000147059,872059,0.983599143
26132,471,155,3,3,0.000147059,872062,0.983602527
26131,717,517,3,3,0.000147059,872065,0.98360591
17321,158,503,3,3,0.000147059,872068,0.983609294
23677,661,348,3,3,0.000147059,872071,0.983612678
26121,155,397,3,3,0.000147059,872074,0.983616061
17294,473,409,3,3,0.000147059,872077,0.983619445
26114,383,528,3,3,0.000147059,872080,0.983622829
26108,663,613,3,3,0.000147059,872083,0.983626212
23688,586,525,3,3,0.000147059,872086,0.983629596
17292,646,26,3,3,0.000147059,872089,0.98363298
23692,163,663,3,3,0.000147059,872092,0.983636364
26103,202,77,3,3,0.000147059,872095,0.983639747
26102,13,242,3,3,0.000147059,872098,0.983643131
26101,364,242,3,3,0.000147059,872101,0.983646515
26096,114,1,3,3,0.000147059,872104,0.983649898
26095,64,121,3,3,0.000147059,872107,0.983653282
17346,525,394,3,3,0.000147059,872110,0.983656666
17356,160,331,3,3,0.000147059,872113,0.98366005
23640,29,404,3,3,0.000147059,872116,0.983663433
26167,138,689,3,3,0.000147059,872119,0.983666817
17390,448,588,3,3,0.000147059,872122,0.983670201
26165,124,236,3,3,0.000147059,872125,0.983673584
23634,721,4,3,3,0.000147059,872128,0.983676968
23643,313,133,3,3,0.000147059,872131,0.983680352
23663,97,264,3,3,0.000147059,872134,0.983683736
26156,124,394,3,3,0.000147059,872137,0.983687119
26154,171,103,3,3,0.000147059,872140,0.983690503
23652,668,529,3,3,0.000147059,872143,0.983693887
23656,117,347,3,3,0.000147059,872146,0.98369727
26143,525,265,3,3,0.000147059,872149,0.983700654
23658,392,463,3,3,0.000147059,872152,0.983704038
23661,674,290,3,3,0.000147059,872155,0.983707422
26094,26,13,3,3,0.000147059,872158,0.983710805
23704,514,6,3,3,0.000147059,872161,0.983714189
26093,528,714,3,3,0.000147059,872164,0.983717573
23775,167,311,3,3,0.000147059,872167,0.983720956
17229,638,552,3,3,0.000147059,872170,0.98372434
26041,433,479,3,3,0.000147059,872173,0.983727724
23764,439,2,3,3,0.000147059,872176,0.983731108
14171,32,482,3,3,0.000147059,872179,0.983734491
26034,145,175,3,3,0.000147059,872182,0.983737875
23772,90,230,3,3,0.000147059,872185,0.983741259
23774,367,207,3,3,0.000147059,872188,0.983744642
23776,493,614,3,3,0.000147059,872191,0.983748026
17237,261,479,3,3,0.000147059,872194,0.98375141
23779,274,383,3,3,0.000147059,872197,0.983754794
14204,103,32,3,3,0.000147059,872200,0.983758177
26021,202,723,3,3,0.000147059,872203,0.983761561
14209,30,2,3,3,0.000147059,872206,0.983764945
26016,613,532,3,3,0.000147059,872209,0.983768328
23792,328,269,3,3,0.000147059,872212,0.983771712
17194,394,22,3,3,0.000147059,872215,0.983775096
23756,155,596,3,3,0.000147059,872218,0.98377848
23748,448,609,3,3,0.000147059,872221,0.983781863
14045,529,552,3,3,0.000147059,872224,0.983785247
23728,427,632,3,3,0.000147059,872227,0.983788631
26088,140,126,3,3,0.000147059,872230,0.983792014
23708,497,439,3,3,0.000147059,872233,0.983795398
26085,174,364,3,3,0.000147059,872236,0.983798782
14085,640,393,3,3,0.000147059,872239,0.983802166
26081,130,261,3,3,0.000147059,872242,0.983805549
23721,392,31,3,3,0.000147059,872245,0.983808933
23722,155,367,3,3,0.000147059,872248,0.983812317
17256,682,638,3,3,0.000147059,872251,0.9838157
14139,682,532,3,3,0.000147059,872254,0.983819084
26061,613,347,3,3,0.000147059,872257,0.983822468
23730,195,532,3,3,0.000147059,872260,0.983825852
23732,719,26,3,3,0.000147059,872263,0.983829235
23737,682,2,3,3,0.000147059,872266,0.983832619
17251,624,34,3,3,0.000147059,872269,0.983836003
26169,525,264,3,3,0.000147059,872272,0.983839386
26177,708,511,3,3,0.000147059,872275,0.98384277
17397,439,307,3,3,0.000147059,872278,0.983846154
23511,458,517,3,3,0.000147059,872281,0.983849538
26279,3,494,3,3,0.000147059,872284,0.983852921
23500,392,265,3,3,0.000147059,872287,0.983856305
26273,274,673,3,3,0.000147059,872290,0.983859689
23506,56,193,3,3,0.000147059,872293,0.983863072
23508,64,640,3,3,0.000147059,872296,0.983866456
23509,517,503,3,3,0.000147059,872299,0.98386984
23510,16,137,3,3,0.000147059,872302,0.983873224
23512,682,5,3,3,0.000147059,872305,0.983876607
26268,331,43,3,3,0.000147059,872308,0.983879991
26267,720,560,3,3,0.000147059,872311,0.983883375
13769,26,246,3,3,0.000147059,872314,0.983886758
17475,331,137,3,3,0.000147059,872317,0.983890142
23523,674,618,3,3,0.000147059,872320,0.983893526
23524,473,124,3,3,0.000147059,872323,0.98389691
17473,661,80,3,3,0.000147059,872326,0.983900293
17470,50,307,3,3,0.000147059,872329,0.983903677
23495,19,535,3,3,0.000147059,872332,0.983907061
23529,195,596,3,3,0.000147059,872335,0.983910444
13743,307,398,3,3,0.000147059,872338,0.983913828
23458,721,14,3,3,0.000147059,872341,0.983917212
26312,492,674,3,3,0.000147059,872344,0.983920596
26310,663,90,3,3,0.000147059,872347,0.983923979
13736,133,334,3,3,0.000147059,872350,0.983927363
17528,593,638,3,3,0.000147059,872353,0.983930747
23468,503,32,3,3,0.000147059,872356,0.98393413
26300,64,107,3,3,0.000147059,872359,0.983937514
23472,708,427,3,3,0.000147059,872362,0.983940898
23485,207,236,3,3,0.000147059,872365,0.983944282
17520,43,609,3,3,0.000147059,872368,0.983947665
13747,525,105,3,3,0.000147059,872371,0.983951049
17514,95,414,3,3,0.000147059,872374,0.983954433
17512,33,514,3,3,0.000147059,872377,0.983957816
23482,29,195,3,3,0.000147059,872380,0.9839612
23483,242,507,3,3,0.000147059,872383,0.983964584
23484,160,265,3,3,0.000147059,872386,0.983967968
17465,507,560,3,3,0.000147059,872389,0.983971351
17455,439,532,3,3,0.000147059,872392,0.983974735
23617,655,5,3,3,0.000147059,872395,0.983978119
26199,167,497,3,3,0.000147059,872398,0.983981502
23587,393,319,3,3,0.000147059,872401,0.983984886
26202,3,290,3,3,0.000147059,872404,0.98398827
23589,482,475,3,3,0.000147059,872407,0.983991654
23591,385,196,3,3,0.000147059,872410,0.983995037
17415,624,158,3,3,0.000147059,872413,0.983998421
23594,302,525,3,3,0.000147059,872416,0.984001805
26200,202,48,3,3,0.000147059,872419,0.984005188
23598,90,522,3,3,0.000147059,872422,0.984008572
26203,544,720,3,3,0.000147059,872425,0.984011956
26193,543,290,3,3,0.000147059,872428,0.984015339
17403,507,313,3,3,0.000147059,872431,0.984018723
26189,482,33,3,3,0.000147059,872434,0.984022107
17401,522,12,3,3,0.000147059,872437,0.984025491
23612,458,95,3,3,0.000147059,872440,0.984028874
26185,64,397,3,3,0.000147059,872443,0.984032258
17416,446,30,3,3,0.000147059,872446,0.984035642
23579,683,302,3,3,0.000147059,872449,0.984039025
26263,5,448,3,3,0.000147059,872452,0.984042409
23548,1,414,3,3,0.000147059,872455,0.984045793
23535,171,503,3,3,0.000147059,872458,0.984049177
26257,158,195,3,3,0.000147059,872461,0.98405256
26254,511,175,3,3,0.000147059,872464,0.984055944
23542,174,2,3,3,0.000147059,872467,0.984059328
26252,404,552,3,3,0.000147059,872470,0.984062711
26251,471,12,3,3,0.000147059,872473,0.984066095
23547,673,163,3,3,0.000147059,872476,0.984069479
23553,618,501,3,3,0.000147059,872479,0.984072863
17431,174,723,3,3,0.000147059,872482,0.984076246
13848,544,84,3,3,0.000147059,872485,0.98407963
23561,167,80,3,3,0.000147059,872488,0.984083014
23566,646,528,3,3,0.000147059,872491,0.984086397
26219,364,140,3,3,0.000147059,872494,0.984089781
23569,503,107,3,3,0.000147059,872497,0.984093165
23570,640,682,3,3,0.000147059,872500,0.984096549
26213,448,307,3,3,0.000147059,872503,0.984099932
26012,683,117,3,3,0.000147059,872506,0.984103316
25998,525,689,3,3,0.000147059,872509,0.9841067
25656,84,371,3,3,0.000147059,872512,0.984110083
17176,543,174,3,3,0.000147059,872515,0.984113467
24056,632,507,3,3,0.000147059,872518,0.984116851
24058,11,90,3,3,0.000147059,872521,0.984120235
24062,364,264,3,3,0.000147059,872524,0.984123618
14643,95,529,3,3,0.000147059,872527,0.984127002
24064,204,207,3,3,0.000147059,872530,0.984130386
25792,448,155,3,3,0.000147059,872533,0.984133769
16853,605,130,3,3,0.000147059,872536,0.984137153
24068,19,532,3,3,0.000147059,872539,0.984140537
24070,507,121,3,3,0.000147059,872542,0.984143921
25785,156,13,3,3,0.000147059,872545,0.984147304
24072,13,501,3,3,0.000147059,872548,0.984150688
25781,682,13,3,3,0.000147059,872551,0.984154072
14672,170,130,3,3,0.000147059,872554,0.984157455
24081,479,668,3,3,0.000147059,872557,0.984160839
24082,84,195,3,3,0.000147059,872560,0.984164223
25770,618,569,3,3,0.000147059,872563,0.984167607
14678,138,310,3,3,0.000147059,872566,0.98417099
24006,652,230,3,3,0.000147059,872569,0.984174374
16997,15,587,3,3,0.000147059,872572,0.984177758
16996,97,544,3,3,0.000147059,872575,0.984181141
25855,544,503,3,3,0.000147059,872578,0.984184525
23992,174,117,3,3,0.000147059,872581,0.984187909
23995,721,714,3,3,0.000147059,872584,0.984191293
23998,56,587,3,3,0.000147059,872587,0.984194676
24003,140,646,3,3,0.000147059,872590,0.98419806
24012,95,673,3,3,0.000147059,872593,0.984201444
24042,274,294,3,3,0.000147059,872596,0.984204827
24014,674,12,3,3,0.000147059,872599,0.984208211
24023,64,11,3,3,0.000147059,872602,0.984211595
24025,164,503,3,3,0.000147059,872605,0.984214979
25824,280,13,3,3,0.000147059,872608,0.984218362
25823,167,54,3,3,0.000147059,872611,0.984221746
24029,673,261,3,3,0.000147059,872614,0.98422513
14622,313,332,3,3,0.000147059,872617,0.984228513
24093,160,522,3,3,0.000147059,872620,0.984231897
16831,380,174,3,3,0.000147059,872623,0.984235281
25757,5,383,3,3,0.000147059,872626,0.984238665
24185,13,497,3,3,0.000147059,872629,0.984242048
25687,193,397,3,3,0.000147059,872632,0.984245432
25681,609,673,3,3,0.000147059,872635,0.984248816
16752,138,655,3,3,0.000147059,872638,0.984252199
16738,196,164,3,3,0.000147059,872641,0.984255583
24183,242,463,3,3,0.000147059,872644,0.984258967
24189,392,141,3,3,0.000147059,872647,0.984262351
25695,328,137,3,3,0.000147059,872650,0.984265734
14927,661,380,3,3,0.000147059,872653,0.984269118
24192,544,673,3,3,0.000147059,872656,0.984272502
25663,64,126,3,3,0.000147059,872659,0.984275885
25659,367,571,3,3,0.000147059,872662,0.984279269
24198,721,30,3,3,0.000147059,872665,0.984282653
25657,473,138,3,3,0.000147059,872668,0.984286037
16712,582,624,3,3,0.000147059,872671,0.98428942
16760,174,331,3,3,0.000147059,872674,0.984292804
25701,703,68,3,3,0.000147059,872677,0.984296188
25751,22,508,3,3,0.000147059,872680,0.984299571
25723,171,605,3,3,0.000147059,872683,0.984302955
16815,703,196,3,3,0.000147059,872686,0.984306339
24116,720,196,3,3,0.000147059,872689,0.984309723
24119,246,131,3,3,0.000147059,872692,0.984313106
16796,443,508,3,3,0.000147059,872695,0.98431649
14774,10,193,3,3,0.000147059,872698,0.984319874
24130,498,13,3,3,0.000147059,872701,0.984323257
16770,383,535,3,3,0.000147059,872704,0.984326641
25720,503,243,3,3,0.000147059,872707,0.984330025
14847,640,264,3,3,0.000147059,872710,0.984333409
24136,404,723,3,3,0.000147059,872713,0.984336792
25716,383,163,3,3,0.000147059,872716,0.984340176
25714,16,684,3,3,0.000147059,872719,0.98434356
25711,13,502,3,3,0.000147059,872722,0.984346943
25709,544,652,3,3,0.000147059,872725,0.984350327
14838,673,246,3,3,0.000147059,872728,0.984353711
16762,498,528,3,3,0.000147059,872731,0.984357095
25857,544,29,3,3,0.000147059,872734,0.984360478
23981,525,114,3,3,0.000147059,872737,0.984363862
17090,502,638,3,3,0.000147059,872740,0.984367246
14366,264,582,3,3,0.000147059,872743,0.984370629
23854,535,195,3,3,0.000147059,872746,0.984374013
23855,114,25,3,3,0.000147059,872749,0.984377397
14376,95,264,3,3,0.000147059,872752,0.984380781
23857,85,196,3,3,0.000147059,872755,0.984384164
23859,307,618,3,3,0.000147059,872758,0.984387548
17100,393,34,3,3,0.000147059,872761,0.984390932
14380,458,123,3,3,0.000147059,872764,0.984394315
23871,482,347,3,3,0.000147059,872767,0.984397699
17104,414,12,3,3,0.000147059,872770,0.984401083
25948,552,414,3,3,0.000147059,872773,0.984404467
23876,562,5,3,3,0.000147059,872776,0.98440785
25946,43,514,3,3,0.000147059,872779,0.984411234
23878,427,560,3,3,0.000147059,872782,0.984414618
23880,32,163,3,3,0.000147059,872785,0.984418001
23883,443,721,3,3,0.000147059,872788,0.984421385
17088,379,661,3,3,0.000147059,872791,0.984424769
23852,130,181,3,3,0.000147059,872794,0.984428152
23850,446,367,3,3,0.000147059,872797,0.984431536
23828,242,170,3,3,0.000147059,872800,0.98443492
25989,498,571,3,3,0.000147059,872803,0.984438304
25987,16,668,3,3,0.000147059,872806,0.984441687
17175,25,605,3,3,0.000147059,872809,0.984445071
23820,392,353,3,3,0.000147059,872812,0.984448455
23822,552,328,3,3,0.000147059,872815,0.984451838
17139,586,22,3,3,0.000147059,872818,0.984455222
25985,605,155,3,3,0.000147059,872821,0.984458606
23827,655,193,3,3,0.000147059,872824,0.98446199
23830,626,141,3,3,0.000147059,872827,0.984465373
23849,398,156,3,3,0.000147059,872830,0.984468757
23832,439,708,3,3,0.000147059,872833,0.984472141
17112,471,158,3,3,0.000147059,872836,0.984475524
25975,193,587,3,3,0.000147059,872839,0.984478908
14362,310,20,3,3,0.000147059,872842,0.984482292
23846,614,133,3,3,0.000147059,872845,0.984485676
25968,364,280,3,3,0.000147059,872848,0.984489059
23889,719,397,3,3,0.000147059,872851,0.984492443
23893,503,379,3,3,0.000147059,872854,0.984495827
17007,507,264,3,3,0.000147059,872857,0.98449921
17028,133,367,3,3,0.000147059,872860,0.984502594
25905,265,714,3,3,0.000147059,872863,0.984505978
25902,397,673,3,3,0.000147059,872866,0.984509362
23940,529,364,3,3,0.000147059,872869,0.984512745
23943,385,517,3,3,0.000147059,872872,0.984516129
25898,261,640,3,3,0.000147059,872875,0.984519513
14558,103,588,3,3,0.000147059,872878,0.984522896
23955,114,364,3,3,0.000147059,872881,0.98452628
25909,719,250,3,3,0.000147059,872884,0.984529664
25887,719,663,3,3,0.000147059,872887,0.984533048
23959,90,334,3,3,0.000147059,872890,0.984536431
25881,392,501,3,3,0.000147059,872893,0.984539815
25877,587,34,3,3,0.000147059,872896,0.984543199
25873,511,528,3,3,0.000147059,872899,0.984546582
14512,640,56,3,3,0.000147059,872902,0.984549966
23894,701,230,3,3,0.000147059,872905,0.98455335
25937,126,353,3,3,0.000147059,872908,0.984556734
17077,164,114,3,3,0.000147059,872911,0.984560117
14456,242,473,3,3,0.000147059,872914,0.984563501
23903,246,646,3,3,0.000147059,872917,0.984566885
23904,56,613,3,3,0.000147059,872920,0.984570268
25927,544,502,3,3,0.000147059,872923,0.984573652
23907,43,618,3,3,0.000147059,872926,0.984577036
25926,404,140,3,3,0.000147059,872929,0.98458042
23911,609,196,3,3,0.000147059,872932,0.984583803
25911,294,463,3,3,0.000147059,872935,0.984587187
23913,117,503,3,3,0.000147059,872938,0.984590571
17066,4,638,3,3,0.000147059,872941,0.984593954
25918,23,25,3,3,0.000147059,872944,0.984597338
23919,219,269,3,3,0.000147059,872947,0.984600722
17057,493,443,3,3,0.000147059,872950,0.984604106
17055,4,514,3,3,0.000147059,872953,0.984607489
22523,280,133,3,3,0.000147059,872956,0.984610873
18317,29,107,3,3,0.000147059,872959,0.984614257
22520,404,261,3,3,0.000147059,872962,0.98461764
27974,448,114,3,3,0.000147059,872965,0.984621024
19703,683,674,3,3,0.000147059,872968,0.984624408
21520,558,290,3,3,0.000147059,872971,0.984627792
21522,661,32,3,3,0.000147059,872974,0.984631175
19699,202,236,3,3,0.000147059,872977,0.984634559
19695,95,195,3,3,0.000147059,872980,0.984637943
29416,124,618,3,3,0.000147059,872983,0.984641326
21538,6,246,3,3,0.000147059,872986,0.98464471
21511,503,84,3,3,0.000147059,872989,0.984648094
19685,22,588,3,3,0.000147059,872992,0.984651478
21541,5,443,3,3,0.000147059,872995,0.984654861
29427,568,230,3,3,0.000147059,872998,0.984658245
21545,141,596,3,3,0.000147059,873001,0.984661629
27965,5,164,3,3,0.000147059,873004,0.984665012
28000,367,43,3,3,0.000147059,873007,0.984668396
27962,493,170,3,3,0.000147059,873010,0.98467178
19735,22,663,3,3,0.000147059,873013,0.984675164
28035,334,181,3,3,0.000147059,873016,0.984678547
28031,261,517,3,3,0.000147059,873019,0.984681931
21473,392,158,3,3,0.000147059,873022,0.984685315
21474,383,364,3,3,0.000147059,873025,0.984688698
19736,250,22,3,3,0.000147059,873028,0.984692082
29366,699,652,3,3,0.000147059,873031,0.984695466
19716,246,56,3,3,0.000147059,873034,0.98469885
21487,613,131,3,3,0.000147059,873037,0.984702233
19731,195,174,3,3,0.000147059,873040,0.984705617
21489,684,498,3,3,0.000147059,873043,0.984709001
28011,126,6,3,3,0.000147059,873046,0.984712384
21500,498,64,3,3,0.000147059,873049,0.984715768
19718,552,126,3,3,0.000147059,873052,0.984719152
19679,655,511,3,3,0.000147059,873055,0.984722536
21554,640,181,3,3,0.000147059,873058,0.984725919
29535,167,114,3,3,0.000147059,873061,0.984729303
19608,525,404,3,3,0.000147059,873064,0.984732687
27909,626,14,3,3,0.000147059,873067,0.98473607
21606,673,85,3,3,0.000147059,873070,0.984739454
19623,354,613,3,3,0.000147059,873073,0.984742838
19617,439,328,3,3,0.000147059,873076,0.984746222
21618,717,14,3,3,0.000147059,873079,0.984749605
21619,204,714,3,3,0.000147059,873082,0.984752989
27913,174,544,3,3,0.000147059,873085,0.984756373
19594,25,34,3,3,0.000147059,873088,0.984759756
19588,525,48,3,3,0.000147059,873091,0.98476314
19581,264,295,3,3,0.000147059,873094,0.984766524
29526,193,683,3,3,0.000147059,873097,0.984769908
29529,236,668,3,3,0.000147059,873100,0.984773291
27868,121,632,3,3,0.000147059,873103,0.984776675
19627,274,507,3,3,0.000147059,873106,0.984780059
27914,719,171,3,3,0.000147059,873109,0.984783442
21555,719,334,3,3,0.000147059,873112,0.984786826
29460,121,34,3,3,0.000147059,873115,0.98479021
19659,655,479,3,3,0.000147059,873118,0.984793594
11925,264,158,3,3,0.000147059,873121,0.984796977
29449,19,334,3,3,0.000147059,873124,0.984800361
19654,14,156,3,3,0.000147059,873127,0.984803745
21574,155,354,3,3,0.000147059,873130,0.984807128
21575,193,155,3,3,0.000147059,873133,0.984810512
19645,246,532,3,3,0.000147059,873136,0.984813896
21579,535,593,3,3,0.000147059,873139,0.984817279
19641,463,503,3,3,0.000147059,873142,0.984820663
19638,174,335,3,3,0.000147059,873145,0.984824047
21590,160,164,3,3,0.000147059,873148,0.984827431
19634,414,632,3,3,0.000147059,873151,0.984830814
19633,655,508,3,3,0.000147059,873154,0.984834198
21595,535,156,3,3,0.000147059,873157,0.984837582
21469,646,502,3,3,0.000147059,873160,0.984840965
21465,246,404,3,3,0.000147059,873163,0.984844349
19744,535,714,3,3,0.000147059,873166,0.984847733
21349,242,121,3,3,0.000147059,873169,0.984851117
21351,103,475,3,3,0.000147059,873172,0.9848545
21353,311,319,3,3,0.000147059,873175,0.984857884
21354,167,10,3,3,0.000147059,873178,0.984861268
29283,364,14,3,3,0.000147059,873181,0.984864651
19838,195,105,3,3,0.000147059,873184,0.984868035
19865,385,295,3,3,0.000147059,873187,0.984871419
19837,689,385,3,3,0.000147059,873190,0.984874803
28107,392,34,3,3,0.000147059,873193,0.984878186
19833,721,130,3,3,0.000147059,873196,0.98488157
28105,661,618,3,3,0.000147059,873199,0.984884954
29299,342,347,3,3,0.000147059,873202,0.984888337
29302,347,133,3,3,0.000147059,873205,0.984891721
29281,544,646,3,3,0.000147059,873208,0.984895105
19868,535,560,3,3,0.000147059,873211,0.984898489
21463,29,655,3,3,0.000147059,873214,0.984901872
21327,19,586,3,3,0.000147059,873217,0.984905256
21315,682,605,3,3,0.000147059,873220,0.98490864
19892,689,156,3,3,0.000147059,873223,0.984912023
21318,261,145,3,3,0.000147059,873226,0.984915407
21321,655,174,3,3,0.000147059,873229,0.984918791
21322,331,701,3,3,0.000147059,873232,0.984922175
19887,50,85,3,3,0.000147059,873235,0.984925558
19886,646,529,3,3,0.000147059,873238,0.984928942
21330,29,131,3,3,0.000147059,873241,0.984932326
21331,14,193,3,3,0.000147059,873244,0.984935709
21333,334,552,3,3,0.000147059,873247,0.984939093
19880,16,448,3,3,0.000147059,873250,0.984942477
28140,717,202,3,3,0.000147059,873253,0.984945861
21338,684,97,3,3,0.000147059,873256,0.984949244
11549,596,85,3,3,0.000147059,873259,0.984952628
21379,544,682,3,3,0.000147059,873262,0.984956012
19818,14,614,3,3,0.000147059,873265,0.984959395
28096,2,493,3,3,0.000147059,873268,0.984962779
28046,719,175,3,3,0.000147059,873271,0.984966163
19769,498,29,3,3,0.000147059,873274,0.984969547
28056,717,632,3,3,0.000147059,873277,0.98497293
28055,250,23,3,3,0.000147059,873280,0.984976314
21436,207,145,3,3,0.000147059,873283,0.984979698
21440,332,514,3,3,0.000147059,873286,0.984983081
19797,265,544,3,3,0.000147059,873289,0.984986465
21448,48,714,3,3,0.000147059,873292,0.984989849
21450,586,517,3,3,0.000147059,873295,0.984993233
19755,310,175,3,3,0.000147059,873298,0.984996616
19754,353,482,3,3,0.000147059,873301,0.985
19749,295,646,3,3,0.000147059,873304,0.985003384
29355,661,3,3,3,0.000147059,873307,0.985006767
21424,22,114,3,3,0.000147059,873310,0.985010151
28076,13,482,3,3,0.000147059,873313,0.985013535
21401,163,334,3,3,0.000147059,873316,0.985016919
19789,383,158,3,3,0.000147059,873319,0.985020302
21407,261,502,3,3,0.000147059,873322,0.985023686
21411,463,414,3,3,0.000147059,873325,0.98502707
21412,13,155,3,3,0.000147059,873328,0.985030453
21414,605,64,3,3,0.000147059,873331,0.985033837
21415,193,543,3,3,0.000147059,873334,0.985037221
21419,14,517,3,3,0.000147059,873337,0.985040605
29332,661,596,3,3,0.000147059,873340,0.985043988
21421,514,475,3,3,0.000147059,873343,0.985047372
21423,482,10,3,3,0.000147059,873346,0.985050756
21649,133,23,3,3,0.000147059,873349,0.985054139
27864,141,492,3,3,0.000147059,873352,0.985057523
19903,6,392,3,3,0.000147059,873355,0.985060907
21888,33,409,3,3,0.000147059,873358,0.985064291
19382,131,392,3,3,0.000147059,873361,0.985067674
21865,22,250,3,3,0.000147059,873364,0.985071058
27711,714,663,3,3,0.000147059,873367,0.985074442
27705,126,14,3,3,0.000147059,873370,0.985077825
21881,290,15,3,3,0.000147059,873373,0.985081209
19356,95,181,3,3,0.000147059,873376,0.985084593
19347,195,80,3,3,0.000147059,873379,0.985087977
21858,632,385,3,3,0.000147059,873382,0.98509136
19342,673,64,3,3,0.000147059,873385,0.985094744
21897,1,155,3,3,0.000147059,873388,0.985098128
21900,439,25,3,3,0.000147059,873391,0.985101511
29712,392,196,3,3,0.000147059,873394,0.985104895
19389,313,525,3,3,0.000147059,873397,0.985108279
27716,475,409,3,3,0.000147059,873400,0.985111663
27663,674,684,3,3,0.000147059,873403,0.985115046
21832,196,529,3,3,0.000147059,873406,0.98511843
19415,720,335,3,3,0.000147059,873409,0.985121814
19414,193,479,3,3,0.000147059,873412,0.985125197
27747,5,54,3,3,0.000147059,873415,0.985128581
21835,236,448,3,3,0.000147059,873418,0.985131965
21854,364,443,3,3,0.000147059,873421,0.985135349
21836,167,33,3,3,0.000147059,873424,0.985138732
27734,25,171,3,3,0.000147059,873427,0.985142116
19401,2,652,3,3,0.000147059,873430,0.9851455
19397,708,13,3,3,0.000147059,873433,0.985148883
27722,170,385,3,3,0.000147059,873436,0.985152267
19393,4,1,3,3,0.000147059,873439,0.985155651
19322,103,174,3,3,0.000147059,873442,0.985159035
21916,280,29,3,3,0.000147059,873445,0.985162418
21655,311,624,3,3,0.000147059,873448,0.985165802
21980,26,571,3,3,0.000147059,873451,0.985169186
21963,683,586,3,3,0.000147059,873454,0.985172569
21964,394,646,3,3,0.000147059,873457,0.985175953
29779,155,569,3,3,0.000147059,873460,0.985179337
21972,48,22,3,3,0.000147059,873463,0.985182721
19278,614,171,3,3,0.000147059,873466,0.985186104
27599,124,674,3,3,0.000147059,873469,0.985189488
29794,171,646,3,3,0.000147059,873472,0.985192872
27591,56,85,3,3,0.000147059,873475,0.985196255
29796,202,535,3,3,0.000147059,873478,0.985199639
21993,514,204,3,3,0.000147059,873481,0.985203023
19248,11,708,3,3,0.000147059,873484,0.985206406
21997,105,138,3,3,0.000147059,873487,0.98520979
21962,95,482,3,3,0.000147059,873490,0.985213174
19292,367,140,3,3,0.000147059,873493,0.985216558
21917,586,30,3,3,0.000147059,873496,0.985219941
19305,397,507,3,3,0.000147059,873499,0.985223325
29722,427,646,3,3,0.000147059,873502,0.985226709
21925,508,20,3,3,0.000147059,873505,0.985230092
27652,446,145,3,3,0.000147059,873508,0.985233476
19314,683,141,3,3,0.000147059,873511,0.98523686
29743,170,34,3,3,0.000147059,873514,0.985240244
21931,593,4,3,3,0.000147059,873517,0.985243627
21955,195,48,3,3,0.000147059,873520,0.985247011
19304,265,587,3,3,0.000147059,873523,0.985250395
29755,475,12,3,3,0.000147059,873526,0.985253778
19300,398,593,3,3,0.000147059,873529,0.985257162
19299,158,29,3,3,0.000147059,873532,0.985260546
19296,332,11,3,3,0.000147059,873535,0.98526393
19294,427,552,3,3,0.000147059,873538,0.985267313
21954,443,652,3,3,0.000147059,873541,0.985270697
29636,560,170,3,3,0.000147059,873544,0.985274081
19418,492,353,3,3,0.000147059,873547,0.985277464
29571,196,392,3,3,0.000147059,873550,0.985280848
21701,164,404,3,3,0.000147059,873553,0.985284232
21703,699,498,3,3,0.000147059,873556,0.985287616
21705,414,482,3,3,0.000147059,873559,0.985290999
21708,471,502,3,3,0.000147059,873562,0.985294383
27824,181,354,3,3,0.000147059,873565,0.985297767
19525,19,219,3,3,0.000147059,873568,0.98530115
19535,596,167,3,3,0.000147059,873571,0.985304534
21715,313,571,3,3,0.000147059,873574,0.985307918
21719,640,652,3,3,0.000147059,873577,0.985311302
19523,720,463,3,3,0.000147059,873580,0.985314685
27816,155,609,3,3,0.000147059,873583,0.985318069
19522,123,181,3,3,0.000147059,873586,0.985321453
21724,138,414,3,3,0.000147059,873589,0.985324836
19532,13,77,3,3,0.000147059,873592,0.98532822
19536,593,328,3,3,0.000147059,873595,0.985331604
21811,196,265,3,3,0.000147059,873598,0.985334988
19557,242,97,3,3,0.000147059,873601,0.985338371
27862,404,133,3,3,0.000147059,873604,0.985341755
19565,280,294,3,3,0.000147059,873607,0.985345139
21658,503,105,3,3,0.000147059,873610,0.985348522
27853,11,13,3,3,0.000147059,873613,0.985351906
21672,27,433,3,3,0.000147059,873616,0.98535529
21691,10,332,3,3,0.000147059,873619,0.985358674
21674,525,347,3,3,0.000147059,873622,0.985362057
21676,492,334,3,3,0.000147059,873625,0.985365441
27852,43,682,3,3,0.000147059,873628,0.985368825
27847,114,684,3,3,0.000147059,873631,0.985372208
29545,171,371,3,3,0.000147059,873634,0.985375592
21688,97,54,3,3,0.000147059,873637,0.985378976
19541,640,242,3,3,0.000147059,873640,0.98538236
21729,720,354,3,3,0.000147059,873643,0.985385743
27810,156,528,3,3,0.000147059,873646,0.985389127
19496,682,543,3,3,0.000147059,873649,0.985392511
19436,492,121,3,3,0.000147059,873652,0.985395894
27778,332,708,3,3,0.000147059,873655,0.985399278
27773,294,331,3,3,0.000147059,873658,0.985402662
27770,32,458,3,3,0.000147059,873661,0.985406046
19443,439,121,3,3,0.000147059,873664,0.985409429
21788,593,714,3,3,0.000147059,873667,0.985412813
27764,204,133,3,3,0.000147059,873670,0.985416197
21795,64,295,3,3,0.000147059,873673,0.98541958
19495,502,20,3,3,0.000147059,873676,0.985422964
19434,398,661,3,3,0.000147059,873679,0.985426348
21797,294,379,3,3,0.000147059,873682,0.985429732
21801,508,27,3,3,0.000147059,873685,0.985433115
19424,141,443,3,3,0.000147059,873688,0.985436499
21805,502,511,3,3,0.000147059,873691,0.985439883
19454,397,133,3,3,0.000147059,873694,0.985443266
27781,178,529,3,3,0.000147059,873697,0.98544665
19463,294,33,3,3,0.000147059,873700,0.985450034
19492,196,242,3,3,0.000147059,873703,0.985453418
21740,383,30,3,3,0.000147059,873706,0.985456801
19489,668,280,3,3,0.000147059,873709,0.985460185
21744,674,175,3,3,0.000147059,873712,0.985463569
29586,392,632,3,3,0.000147059,873715,0.985466952
19474,140,50,3,3,0.000147059,873718,0.985470336
21753,163,497,3,3,0.000147059,873721,0.98547372
21754,558,482,3,3,0.000147059,873724,0.985477104
21755,1,661,3,3,0.000147059,873727,0.985480487
21758,502,307,3,3,0.000147059,873730,0.985483871
21760,246,33,3,3,0.000147059,873733,0.985487255
19472,394,156,3,3,0.000147059,873736,0.985490638
27787,624,427,3,3,0.000147059,873739,0.985494022
21767,458,307,3,3,0.000147059,873742,0.985497406
21768,497,689,3,3,0.000147059,873745,0.98550079
19896,646,121,3,3,0.000147059,873748,0.985504173
28155,718,558,3,3,0.000147059,873751,0.985507557
22003,609,54,3,3,0.000147059,873754,0.985510941
20334,155,80,3,3,0.000147059,873757,0.985514324
28535,482,141,3,3,0.000147059,873760,0.985517708
20858,138,331,3,3,0.000147059,873763,0.985521092
20341,479,103,3,3,0.000147059,873766,0.985524476
28532,552,124,3,3,0.000147059,873769,0.985527859
10238,3,85,3,3,0.000147059,873772,0.985531243
28555,674,448,3,3,0.000147059,873775,0.985534627
20333,123,613,3,3,0.000147059,873778,0.98553801
20332,224,446,3,3,0.000147059,873781,0.985541394
20330,385,145,3,3,0.000147059,873784,0.985544778
20874,655,475,3,3,0.000147059,873787,0.985548162
28524,613,383,3,3,0.000147059,873790,0.985551545
20329,193,9,3,3,0.000147059,873793,0.985554929
20328,196,117,3,3,0.000147059,873796,0.985558313
20374,302,12,3,3,0.000147059,873799,0.985561696
28845,145,684,3,3,0.000147059,873802,0.98556508
20322,493,302,3,3,0.000147059,873805,0.985568464
28576,409,347,3,3,0.000147059,873808,0.985571848
28582,342,95,3,3,0.000147059,873811,0.985575231
20417,77,569,3,3,0.000147059,873814,0.985578615
20805,332,164,3,3,0.000147059,873817,0.985581999
20409,525,219,3,3,0.000147059,873820,0.985585382
20811,175,204,3,3,0.000147059,873823,0.985588766
28575,367,494,3,3,0.000147059,873826,0.98559215
20380,719,479,3,3,0.000147059,873829,0.985595533
28574,568,219,3,3,0.000147059,873832,0.985598917
9756,708,158,3,3,0.000147059,873835,0.985602301
20399,347,13,3,3,0.000147059,873838,0.985605685
28571,439,646,3,3,0.000147059,873841,0.985609068
20831,682,640,3,3,0.000147059,873844,0.985612452
20880,525,97,3,3,0.000147059,873847,0.985615836
20282,586,560,3,3,0.000147059,873850,0.985619219
28474,64,181,3,3,0.000147059,873853,0.985622603
28928,723,77,3,3,0.000147059,873856,0.985625987
20935,525,6,3,3,0.000147059,873859,0.985629371
20277,638,404,3,3,0.000147059,873862,0.985632754
28466,23,714,3,3,0.000147059,873865,0.985636138
20943,22,307,3,3,0.000147059,873868,0.985639522
20267,174,511,3,3,0.000147059,873871,0.985642905
20958,409,114,3,3,0.000147059,873874,0.985646289
28451,502,294,3,3,0.000147059,873877,0.985649673
28447,54,207,3,3,0.000147059,873880,0.985653057
28446,626,517,3,3,0.000147059,873883,0.98565644
20249,155,497,3,3,0.000147059,873886,0.985659824
20930,586,392,3,3,0.000147059,873889,0.985663208
20288,529,640,3,3,0.000147059,873892,0.985666591
28872,13,4,3,3,0.000147059,873895,0.985669975
28513,158,458,3,3,0.000147059,873898,0.985673359
20884,414,20,3,3,0.000147059,873901,0.985676743
20885,140,274,3,3,0.000147059,873904,0.985680126
28517,50,13,3,3,0.000147059,873907,0.98568351
20889,558,392,3,3,0.000147059,873910,0.985686894
20893,471,140,3,3,0.000147059,873913,0.985690277
20894,193,202,3,3,0.000147059,873916,0.985693661
20315,398,543,3,3,0.000147059,873919,0.985697045
20309,632,661,3,3,0.000147059,873922,0.985700429
20917,409,535,3,3,0.000147059,873925,0.985703812
20304,699,243,3,3,0.000147059,873928,0.985707196
28881,427,701,3,3,0.000147059,873931,0.98571058
20298,242,328,3,3,0.000147059,873934,0.985713963
20916,398,528,3,3,0.000147059,873937,0.985717347
20422,195,588,3,3,0.000147059,873940,0.985720731
20423,29,3,3,3,0.000147059,873943,0.985724115
28666,22,385,3,3,0.000147059,873946,0.985727498
28673,5,175,3,3,0.000147059,873949,0.985730882
20676,380,701,3,3,0.000147059,873952,0.985734266
20542,123,12,3,3,0.000147059,873955,0.985737649
20682,624,334,3,3,0.000147059,873958,0.985741033
20684,246,107,3,3,0.000147059,873961,0.985744417
20686,397,587,3,3,0.000147059,873964,0.985747801
20532,404,34,3,3,0.000147059,873967,0.985751184
20668,1,507,3,3,0.000147059,873970,0.985754568
20526,12,517,3,3,0.000147059,873973,0.985757952
20694,123,446,3,3,0.000147059,873976,0.985761335
20521,163,714,3,3,0.000147059,873979,0.985764719
20700,19,236,3,3,0.000147059,873982,0.985768103
20519,264,302,3,3,0.000147059,873985,0.985771487
20703,683,33,3,3,0.000147059,873988,0.98577487
20665,25,708,3,3,0.000147059,873991,0.985778254
20622,25,295,3,3,0.000147059,873994,0.985781638
20627,11,140,3,3,0.000147059,873997,0.985785021
20603,529,155,3,3,0.000147059,874000,0.985788405
20631,475,507,3,3,0.000147059,874003,0.985791789
20596,19,689,3,3,0.000147059,874006,0.985795173
28685,718,175,3,3,0.000147059,874009,0.985798556
20642,48,569,3,3,0.000147059,874012,0.98580194
20586,448,663,3,3,0.000147059,874015,0.985805324
20585,383,22,3,3,0.000147059,874018,0.985808707
20582,543,1,3,3,0.000147059,874021,0.985812091
20657,22,163,3,3,0.000147059,874024,0.985815475
20570,224,569,3,3,0.000147059,874027,0.985818859
20567,624,632,3,3,0.000147059,874030,0.985822242
20518,638,274,3,3,0.000147059,874033,0.985825626
20707,48,701,3,3,0.000147059,874036,0.98582901
20708,117,502,3,3,0.000147059,874039,0.985832393
28825,178,443,3,3,0.000147059,874042,0.985835777
20459,701,380,3,3,0.000147059,874045,0.985839161
20764,12,137,3,3,0.000147059,874048,0.985842545
20455,29,367,3,3,0.000147059,874051,0.985845928
28814,43,140,3,3,0.000147059,874054,0.985849312
20768,242,20,3,3,0.000147059,874057,0.985852696
28592,332,632,3,3,0.000147059,874060,0.985856079
20710,242,31,3,3,0.000147059,874063,0.985859463
28589,171,13,3,3,0.000147059,874066,0.985862847
20437,26,652,3,3,0.000147059,874069,0.985866231
20434,596,207,3,3,0.000147059,874072,0.985869614
20433,446,498,3,3,0.000147059,874075,0.985872998
20785,522,124,3,3,0.000147059,874078,0.985876382
28588,85,230,3,3,0.000147059,874081,0.985879765
20429,243,30,3,3,0.000147059,874084,0.985883149
28617,593,708,3,3,0.000147059,874087,0.985886533
20467,663,392,3,3,0.000147059,874090,0.985889917
20468,328,507,3,3,0.000147059,874093,0.9858933
28804,560,311,3,3,0.000147059,874096,0.985896684
28653,5,502,3,3,0.000147059,874099,0.985900068
28770,242,673,3,3,0.000147059,874102,0.985903451
20716,507,508,3,3,0.000147059,874105,0.985906835
20717,133,22,3,3,0.000147059,874108,0.985910219
20718,618,164,3,3,0.000147059,874111,0.985913603
20505,23,443,3,3,0.000147059,874114,0.985916986
20729,394,20,3,3,0.000147059,874117,0.98592037
20499,392,56,3,3,0.000147059,874120,0.985923754
28787,544,163,3,3,0.000147059,874123,0.985927137
20493,543,175,3,3,0.000147059,874126,0.985930521
20485,332,397,3,3,0.000147059,874129,0.985933905
20746,708,614,3,3,0.000147059,874132,0.985937289
20473,156,121,3,3,0.000147059,874135,0.985940672
20752,332,502,3,3,0.000147059,874138,0.985944056
20967,314,684,3,3,0.000147059,874141,0.98594744
20235,12,34,3,3,0.000147059,874144,0.985950823
21303,14,544,3,3,0.000147059,874147,0.985954207
21185,16,294,3,3,0.000147059,874150,0.985957591
20033,95,624,3,3,0.000147059,874153,0.985960975
20032,482,9,3,3,0.000147059,874156,0.985964358
20031,29,558,3,3,0.000147059,874159,0.985967742
20027,593,646,3,3,0.000147059,874162,0.985971126
20023,494,48,3,3,0.000147059,874165,0.985974509
20022,501,392,3,3,0.000147059,874168,0.985977893
21199,174,280,3,3,0.000147059,874171,0.985981277
21203,689,529,3,3,0.000147059,874174,0.985984661
21205,29,498,3,3,0.000147059,874177,0.985988044
20009,562,117,3,3,0.000147059,874180,0.985991428
21215,11,2,3,3,0.000147059,874183,0.985994812
29172,514,30,3,3,0.000147059,874186,0.985998195
28230,543,493,3,3,0.000147059,874189,0.986001579
21218,290,347,3,3,0.000147059,874192,0.986004963
29138,626,511,3,3,0.000147059,874195,0.986008346
28266,699,517,3,3,0.000147059,874198,0.98601173
19996,448,335,3,3,0.000147059,874201,0.986015114
20065,507,385,3,3,0.000147059,874204,0.986018498
21149,250,683,3,3,0.000147059,874207,0.986021881
20068,494,230,3,3,0.000147059,874210,0.986025265
21155,353,409,3,3,0.000147059,874213,0.986028649
28276,528,319,3,3,0.000147059,874216,0.986032032
21173,371,414,3,3,0.000147059,874219,0.986035416
21162,719,95,3,3,0.000147059,874222,0.9860388
21165,609,552,3,3,0.000147059,874225,0.986042184
21167,503,264,3,3,0.000147059,874228,0.986045567
21168,514,479,3,3,0.000147059,874231,0.986048951
21169,242,605,3,3,0.000147059,874234,0.986052335
28271,23,14,3,3,0.000147059,874237,0.986055718
28270,107,175,3,3,0.000147059,874240,0.986059102
21219,364,243,3,3,0.000147059,874243,0.986062486
21221,427,609,3,3,0.000147059,874246,0.98606587
11517,313,624,3,3,0.000147059,874249,0.986069253
19944,2,544,3,3,0.000147059,874252,0.986072637
19938,204,448,3,3,0.000147059,874255,0.986076021
21274,328,1,3,3,0.000147059,874258,0.986079404
19927,84,652,3,3,0.000147059,874261,0.986082788
19924,701,302,3,3,0.000147059,874264,0.986086172
28170,448,511,3,3,0.000147059,874267,0.986089556
21286,107,137,3,3,0.000147059,874270,0.986092939
19916,721,31,3,3,0.000147059,874273,0.986096323
21297,30,482,3,3,0.000147059,874276,0.986099707
21298,202,105,3,3,0.000147059,874279,0.98610309
28161,133,269,3,3,0.000147059,874282,0.986106474
19907,720,123,3,3,0.000147059,874285,0.986109858
21268,84,167,3,3,0.000147059,874288,0.986113242
21264,618,532,3,3,0.000147059,874291,0.986116625
21223,95,618,3,3,0.000147059,874294,0.986120009
21234,207,439,3,3,0.000147059,874297,0.986123393
21224,310,207,3,3,0.000147059,874300,0.986126776
28228,652,347,3,3,0.000147059,874303,0.98613016
29179,719,682,3,3,0.000147059,874306,0.986133544
19986,525,588,3,3,0.000147059,874309,0.986136928
21232,528,56,3,3,0.000147059,874312,0.986140311
29185,528,54,3,3,0.000147059,874315,0.986143695
29208,50,528,3,3,0.000147059,874318,0.986147079
19983,15,507,3,3,0.000147059,874321,0.986150462
11408,95,126,3,3,0.000147059,874324,0.986153846
21242,10,525,3,3,0.000147059,874327,0.98615723
29189,207,552,3,3,0.000147059,874330,0.986160614
19972,646,522,3,3,0.000147059,874333,0.986163997
19958,174,164,3,3,0.000147059,874336,0.986167381
21138,43,508,3,3,0.000147059,874339,0.986170765
20086,5,158,3,3,0.000147059,874342,0.986174148
20202,463,171,3,3,0.000147059,874345,0.986177532
20201,414,164,3,3,0.000147059,874348,0.986180916
28397,571,265,3,3,0.000147059,874351,0.9861843
20195,334,204,3,3,0.000147059,874354,0.986187683
21023,446,3,3,3,0.000147059,874357,0.986191067
28388,20,503,3,3,0.000147059,874360,0.986194451
20203,123,261,3,3,0.000147059,874363,0.986197834
21027,471,364,3,3,0.000147059,874366,0.986201218
21034,31,552,3,3,0.000147059,874369,0.986204602
20181,493,117,3,3,0.000147059,874372,0.986207986
20179,494,588,3,3,0.000147059,874375,0.986211369
28375,167,394,3,3,0.000147059,874378,0.986214753
20173,138,497,3,3,0.000147059,874381,0.986218137
20205,463,85,3,3,0.000147059,874384,0.98622152
20087,543,587,3,3,0.000147059,874387,0.986224904
20994,558,163,3,3,0.000147059,874390,0.986228288
20976,507,479,3,3,0.000147059,874393,0.986231672
20229,105,319,3,3,0.000147059,874396,0.986235055
20983,33,392,3,3,0.000147059,874399,0.986238439
28977,720,714,3,3,0.000147059,874402,0.986241823
20991,674,124,3,3,0.000147059,874405,0.986245206
28998,30,528,3,3,0.000147059,874408,0.98624859
28989,207,156,3,3,0.000147059,874411,0.986251974
20997,674,332,3,3,0.000147059,874414,0.986255358
28997,703,30,3,3,0.000147059,874417,0.986258741
21005,638,140,3,3,0.000147059,874420,0.986262125
21006,446,204,3,3,0.000147059,874423,0.986265509
29019,121,243,3,3,0.000147059,874426,0.986268892
20170,12,163,3,3,0.000147059,874429,0.986272276
21048,593,121,3,3,0.000147059,874432,0.98627566
20124,720,131,3,3,0.000147059,874435,0.986279044
21090,525,131,3,3,0.000147059,874438,0.986282427
21092,133,307,3,3,0.000147059,874441,0.986285811
20129,471,29,3,3,0.000147059,874444,0.986289195
21099,588,269,3,3,0.000147059,874447,0.986292578
21101,6,646,3,3,0.000147059,874450,0.986295962
21107,661,131,3,3,0.000147059,874453,0.986299346
20117,230,193,3,3,0.000147059,874456,0.98630273
20104,25,544,3,3,0.000147059,874459,0.986306113
21123,193,588,3,3,0.000147059,874462,0.986309497
28309,195,56,3,3,0.000147059,874465,0.986312881
29093,398,494,3,3,0.000147059,874468,0.986316264
20139,175,31,3,3,0.000147059,874471,0.986319648
21088,532,103,3,3,0.000147059,874474,0.986323032
21086,332,250,3,3,0.000147059,874477,0.986326416
20141,11,156,3,3,0.000147059,874480,0.986329799
21056,684,9,3,3,0.000147059,874483,0.986333183
29040,334,167,3,3,0.000147059,874486,0.986336567
21060,243,482,3,3,0.000147059,874489,0.98633995
29056,64,517,3,3,0.000147059,874492,0.986343334
21069,398,30,3,3,0.000147059,874495,0.986346718
21071,140,502,3,3,0.000147059,874498,0.986350102
21074,167,243,3,3,0.000147059,874501,0.986353485
21076,242,404,3,3,0.000147059,874504,0.986356869
20150,383,196,3,3,0.000147059,874507,0.986360253
21079,632,56,3,3,0.000147059,874510,0.986363636
21083,31,242,3,3,0.000147059,874513,0.98636702
29063,207,529,3,3,0.000147059,874516,0.986370404
21998,439,543,3,3,0.000147059,874519,0.986373788
22451,409,50,3,3,0.000147059,874522,0.986377171
29886,347,605,3,3,0.000147059,874525,0.986380555
22314,409,10,3,3,0.000147059,874528,0.986383939
19160,497,638,3,3,0.000147059,874531,0.986387322
22353,511,30,3,3,0.000147059,874534,0.986390706
22455,646,313,3,3,0.000147059,874537,0.98639409
22401,167,126,3,3,0.000147059,874540,0.986397473
29985,624,178,3,3,0.000147059,874543,0.986400857
27447,174,264,3,3,0.000147059,874546,0.986404241
22127,195,618,3,3,0.000147059,874549,0.986407625
18822,364,236,3,3,0.000147059,874552,0.986411008
18819,613,107,3,3,0.000147059,874555,0.986414392
19060,269,314,3,3,0.000147059,874558,0.986417776
22452,684,586,3,3,0.000147059,874561,0.986421159
12155,482,80,3,3,0.000147059,874564,0.986424543
22124,261,605,3,3,0.000147059,874567,0.986427927
22349,264,479,3,3,0.000147059,874570,0.986431311
18686,269,593,3,3,0.000147059,874573,0.986434694
29848,181,1,3,3,0.000147059,874576,0.986438078
18817,131,613,3,3,0.000147059,874579,0.986441462
27235,439,170,3,3,0.000147059,874582,0.986444845
30054,121,207,3,3,0.000147059,874585,0.986448229
30087,64,404,3,3,0.000147059,874588,0.986451613
18747,720,3,3,3,0.000147059,874591,0.986454997
19068,543,385,3,3,0.000147059,874594,0.98645838
22443,10,133,3,3,0.000147059,874597,0.986461764
18814,682,463,3,3,0.000147059,874600,0.986465148
18749,347,274,3,3,0.000147059,874603,0.986468531
22239,404,30,3,3,0.000147059,874606,0.986471915
27313,558,720,3,3,0.000147059,874609,0.986475299
19162,364,404,3,3,0.000147059,874612,0.986478683
27389,708,290,3,3,0.000147059,874615,0.986482066
27351,511,439,3,3,0.000147059,874618,0.98648545
19039,544,427,3,3,0.000147059,874621,0.986488834
27480,511,5,3,3,0.000147059,874624,0.986492217
27349,609,721,3,3,0.000147059,874627,0.986495601
22179,314,342,3,3,0.000147059,874630,0.986498985
22251,511,23,3,3,0.000147059,874633,0.986502369
27454,626,68,3,3,0.000147059,874636,0.986505752
22043,544,114,3,3,0.000147059,874639,0.986509136
27310,29,26,3,3,0.000147059,874642,0.98651252
22472,19,174,3,3,0.000147059,874645,0.986515903
19052,605,145,3,3,0.000147059,874648,0.986519287
19183,30,661,3,3,0.000147059,874651,0.986522671
18905,655,140,3,3,0.000147059,874654,0.986526055
22310,117,97,3,3,0.000147059,874657,0.986529438
27541,196,576,3,3,0.000147059,874660,0.986532822
18966,439,414,3,3,0.000147059,874663,0.986536206
22048,90,609,3,3,0.000147059,874666,0.986539589
27483,25,392,3,3,0.000147059,874669,0.986542973
27275,503,307,3,3,0.000147059,874672,0.986546357
22313,31,569,3,3,0.000147059,874675,0.986549741
22461,31,54,3,3,0.000147059,874678,0.986553124
29844,562,181,3,3,0.000147059,874681,0.986556508
18675,307,171,3,3,0.000147059,874684,0.986559892
18698,156,175,3,3,0.000147059,874687,0.986563275
18919,25,404,3,3,0.000147059,874690,0.986566659
27442,397,195,3,3,0.000147059,874693,0.986570043
22090,719,522,3,3,0.000147059,874696,0.986573427
22091,522,207,3,3,0.000147059,874699,0.98657681
22331,145,140,3,3,0.000147059,874702,0.986580194
27262,354,494,3,3,0.000147059,874705,0.986583578
27322,364,269,3,3,0.000147059,874708,0.986586961
27326,121,618,3,3,0.000147059,874711,0.986590345
30080,560,532,3,3,0.000147059,874714,0.986593729
19103,163,588,3,3,0.000147059,874717,0.986597113
18944,684,123,3,3,0.000147059,874720,0.986600496
29926,364,714,3,3,0.000147059,874723,0.98660388
19070,475,328,3,3,0.000147059,874726,0.986607264
22413,155,560,3,3,0.000147059,874729,0.986610647
18802,160,123,3,3,0.000147059,874732,0.986614031
22422,310,684,3,3,0.000147059,874735,0.986617415
18797,32,246,3,3,0.000147059,874738,0.986620799
22100,347,560,3,3,0.000147059,874741,0.986624182
27255,5,25,3,3,0.000147059,874744,0.986627566
19084,156,393,3,3,0.000147059,874747,0.98663095
22104,502,33,3,3,0.000147059,874750,0.986634333
18734,261,10,3,3,0.000147059,874753,0.986637717
27502,367,138,3,3,0.000147059,874756,0.986641101
22338,224,202,3,3,0.000147059,874759,0.986644485
22206,294,31,3,3,0.000147059,874762,0.986647868
19085,646,328,3,3,0.000147059,874765,0.986651252
22207,525,379,3,3,0.000147059,874768,0.986654636
27516,684,107,3,3,0.000147059,874771,0.986658019
22069,50,511,3,3,0.000147059,874774,0.986661403
18943,302,171,3,3,0.000147059,874777,0.986664787
22438,721,708,3,3,0.000147059,874780,0.986668171
27412,302,576,3,3,0.000147059,874783,0.986671554
18813,638,514,3,3,0.000147059,874786,0.986674938
19136,158,427,3,3,0.000147059,874789,0.986678322
18709,507,274,3,3,0.000147059,874792,0.986681705
19134,646,3,3,3,0.000147059,874795,0.986685089
19129,193,522,3,3,0.000147059,874798,0.986688473
19128,393,552,3,3,0.000147059,874801,0.986691857
22076,236,137,3,3,0.000147059,874804,0.98669524
18958,307,207,3,3,0.000147059,874807,0.986698624
30057,502,13,3,3,0.000147059,874810,0.986702008
22410,609,409,3,3,0.000147059,874813,0.986705391
18933,274,528,3,3,0.000147059,874816,0.986708775
22119,274,392,3,3,0.000147059,874819,0.986712159
18811,133,674,3,3,0.000147059,874822,0.986715543
22079,448,397,3,3,0.000147059,874825,0.986718926
27423,167,2,3,3,0.000147059,874828,0.98672231
19124,164,50,3,3,0.000147059,874831,0.986725694
18938,708,501,3,3,0.000147059,874834,0.986729077
22117,310,624,3,3,0.000147059,874837,0.986732461
22087,31,181,3,3,0.000147059,874840,0.986735845
22361,482,348,3,3,0.000147059,874843,0.986739229
22312,529,30,3,3,0.000147059,874846,0.986742612
19193,511,354,3,3,0.000147059,874849,0.986745996
27372,448,385,3,3,0.000147059,874852,0.98674938
19015,3,261,3,3,0.000147059,874855,0.986752763
18626,618,511,3,3,0.000147059,874858,0.986756147
27570,269,404,3,3,0.000147059,874861,0.986759531
19211,605,95,3,3,0.000147059,874864,0.986762915
18628,668,508,3,3,0.000147059,874867,0.986766298
18844,446,522,3,3,0.000147059,874870,0.986769682
22173,97,614,3,3,0.000147059,874873,0.986773066
22385,618,393,3,3,0.000147059,874876,0.986776449
22023,242,721,3,3,0.000147059,874879,0.986779833
27458,562,269,3,3,0.000147059,874882,0.986783217
18896,720,174,3,3,0.000147059,874885,0.9867866
27376,145,290,3,3,0.000147059,874888,0.986789984
22268,717,558,3,3,0.000147059,874891,0.986793368
18634,593,261,3,3,0.000147059,874894,0.986796752
22026,367,618,3,3,0.000147059,874897,0.986800135
12276,701,80,3,3,0.000147059,874900,0.986803519
27304,392,12,3,3,0.000147059,874903,0.986806903
27471,640,446,3,3,0.000147059,874906,0.986810286
22367,682,23,3,3,0.000147059,874909,0.98681367
19019,367,661,3,3,0.000147059,874912,0.986817054
22366,1,140,3,3,0.000147059,874915,0.986820438
22493,593,170,3,3,0.000147059,874918,0.986823821
27285,126,640,3,3,0.000147059,874921,0.986827205
22295,507,427,3,3,0.000147059,874924,0.986830589
22296,719,174,3,3,0.000147059,874927,0.986833972
22275,682,475,3,3,0.000147059,874930,0.986837356
18862,582,269,3,3,0.000147059,874933,0.98684074
18622,43,121,3,3,0.000147059,874936,0.986844124
18853,133,532,3,3,0.000147059,874939,0.986847507
22284,290,588,3,3,0.000147059,874942,0.986850891
18856,310,195,3,3,0.000147059,874945,0.986854275
22161,482,6,3,3,0.000147059,874948,0.986857658
19224,493,77,3,3,0.000147059,874951,0.986861042
27465,586,13,3,3,0.000147059,874954,0.986864426
22157,614,5,3,3,0.000147059,874957,0.98686781
27575,167,155,3,3,0.000147059,874960,0.986871193
22516,196,682,3,3,0.000147059,874963,0.986874577
18846,393,170,3,3,0.000147059,874966,0.986877961
22515,131,409,3,3,0.000147059,874969,0.986881344
18987,514,160,3,3,0.000147059,874972,0.986884728
22374,56,661,3,3,0.000147059,874975,0.986888112
22019,383,708,3,3,0.000147059,874978,0.986891496
22513,655,261,3,3,0.000147059,874981,0.986894879
27469,124,280,3,3,0.000147059,874984,0.986898263
18999,2,4,3,3,0.000147059,874987,0.986901647
19217,552,404,3,3,0.000147059,874990,0.98690503
27187,371,311,3,3,0.000147059,874993,0.986908414
29900,371,84,3,3,0.000147059,874996,0.986911798
18772,264,609,3,3,0.000147059,874999,0.986915182
19004,497,560,3,3,0.000147059,875002,0.986918565
27189,473,342,3,3,0.000147059,875005,0.986921949
30041,126,348,3,3,0.000147059,875008,0.986925333
19212,404,479,3,3,0.000147059,875011,0.986928716
18858,586,689,3,3,0.000147059,875014,0.9869321
18760,242,588,3,3,0.000147059,875017,0.986935484
18842,502,543,3,3,0.000147059,875020,0.986938868
27500,54,497,3,3,0.000147059,875023,0.986942251
27205,632,23,3,3,0.000147059,875026,0.986945635
30113,85,27,3,3,0.000147059,875029,0.986949019
22478,141,230,3,3,0.000147059,875032,0.986952402
27479,158,103,3,3,0.000147059,875035,0.986955786
27283,290,30,3,3,0.000147059,875038,0.98695917
18663,593,145,3,3,0.000147059,875041,0.986962554
18882,497,632,3,3,0.000147059,875044,0.986965937
22392,140,463,3,3,0.000147059,875047,0.986969321
27555,54,398,3,3,0.000147059,875050,0.986972705
27553,207,498,3,3,0.000147059,875053,0.986976088
27354,22,2,3,3,0.000147059,875056,0.986979472
18641,404,145,3,3,0.000147059,875059,0.986982856
19026,364,379,3,3,0.000147059,875062,0.98698624
22145,655,593,3,3,0.000147059,875065,0.986989623
22489,204,43,3,3,0.000147059,875068,0.986993007
29956,114,126,3,3,0.000147059,875071,0.986996391
22363,334,482,3,3,0.000147059,875074,0.986999774
27387,195,107,3,3,0.000147059,875077,0.987003158
27208,699,596,3,3,0.000147059,875080,0.987006542
18893,514,170,3,3,0.000147059,875083,0.987009926
22394,207,1,3,3,0.000147059,875086,0.987013309
18776,332,379,3,3,0.000147059,875089,0.987016693
22421,668,328,8,2,0.000392157,875097,0.987025716
20217,54,439,6,2,0.000294118,875103,0.987032484
18727,164,15,6,2,0.000294118,875109,0.987039251
19272,605,638,6,2,0.000294118,875115,0.987046018
20566,207,26,6,2,0.000294118,875121,0.987052786
20400,501,618,6,2,0.000294118,875127,0.987059553
23134,364,663,6,2,0.000294118,875133,0.987066321
23252,492,502,6,2,0.000294118,875139,0.987073088
21978,207,443,5,2,0.000245098,875144,0.987078728
26574,328,720,5,2,0.000245098,875149,0.987084367
26704,181,5,5,2,0.000245098,875154,0.987090007
25691,503,347,5,2,0.000245098,875159,0.987095646
15841,569,473,5,2,0.000245098,875164,0.987101286
25658,714,15,5,2,0.000245098,875169,0.987106925
22976,684,638,5,2,0.000245098,875174,0.987112565
25486,163,392,5,2,0.000245098,875179,0.987118204
23281,107,160,5,2,0.000245098,875184,0.987123844
28060,569,14,4,2,0.000196078,875188,0.987128356
20920,56,167,4,2,0.000196078,875192,0.987132867
21073,170,501,4,2,0.000196078,875196,0.987137379
28344,13,626,4,2,0.000196078,875200,0.98714189
21240,141,164,4,2,0.000196078,875204,0.987146402
27881,302,699,4,2,0.000196078,875208,0.987150914
28316,31,12,4,2,0.000196078,875212,0.987155425
25051,103,19,4,2,0.000196078,875216,0.987159937
25029,535,290,4,2,0.000196078,875220,0.987164448
23317,117,164,4,2,0.000196078,875224,0.98716896
25017,121,392,4,2,0.000196078,875228,0.987173472
22928,97,482,4,2,0.000196078,875232,0.987177983
25522,334,90,4,2,0.000196078,875236,0.987182495
22898,3,569,4,2,0.000196078,875240,0.987187007
23034,493,32,4,2,0.000196078,875244,0.987191518
24360,138,404,4,2,0.000196078,875248,0.98719603
24338,328,544,4,2,0.000196078,875252,0.987200541
24008,699,354,4,2,0.000196078,875256,0.987205053
23498,155,632,4,2,0.000196078,875260,0.987209565
23507,652,473,4,2,0.000196078,875264,0.987214076
26683,219,290,4,2,0.000196078,875268,0.987218588
21581,624,294,4,2,0.000196078,875272,0.987223099
26139,717,618,4,2,0.000196078,875276,0.987227611
25708,175,30,4,2,0.000196078,875280,0.987232123
25735,224,494,4,2,0.000196078,875284,0.987236634
22448,721,3,4,2,0.000196078,875288,0.987241146
22774,68,613,4,2,0.000196078,875292,0.987245658
25667,10,124,4,2,0.000196078,875296,0.987250169
25647,379,13,4,2,0.000196078,875300,0.987254681
22129,95,714,4,2,0.000196078,875304,0.987259192
25963,236,13,4,2,0.000196078,875308,0.987263704
22334,394,319,4,2,0.000196078,875312,0.987268216
19171,684,295,4,2,0.000196078,875316,0.987272727
20064,379,618,4,2,0.000196078,875320,0.987277239
20132,618,529,4,2,0.000196078,875324,0.987281751
18115,43,2,4,2,0.000196078,875328,0.987286262
19326,624,219,4,2,0.000196078,875332,0.987290774
17113,443,409,4,2,0.000196078,875336,0.987295285
20386,261,295,4,2,0.000196078,875340,0.987299797
20261,517,605,4,2,0.000196078,875344,0.987304309
18577,54,295,4,2,0.000196078,875348,0.98730882
12928,138,243,4,2,0.000196078,875352,0.987313332
17850,507,501,3,2,0.000147059,875355,0.987316716
26564,720,26,3,2,0.000147059,875358,0.987320099
22836,130,138,3,2,0.000147059,875361,0.987323483
26811,699,347,3,2,0.000147059,875364,0.987326867
17840,529,683,3,2,0.000147059,875367,0.98733025
22596,347,181,3,2,0.000147059,875370,0.987333634
26534,511,618,3,2,0.000147059,875373,0.987337018
27135,160,6,3,2,0.000147059,875376,0.987340402
22597,673,1,3,2,0.000147059,875379,0.987343785
30159,117,156,3,2,0.000147059,875382,0.987347169
17778,140,25,3,2,0.000147059,875385,0.987350553
22944,332,155,3,2,0.000147059,875388,0.987353936
26917,394,207,3,2,0.000147059,875391,0.98735732
23418,171,50,3,2,0.000147059,875394,0.987360704
23417,471,181,3,2,0.000147059,875397,0.987364088
18221,458,167,3,2,0.000147059,875400,0.987367471
26357,562,332,3,2,0.000147059,875403,0.987370855
22538,613,141,3,2,0.000147059,875406,0.987374239
22541,443,13,3,2,0.000147059,875409,0.987377622
12478,614,683,3,2,0.000147059,875412,0.987381006
18591,544,514,3,2,0.000147059,875415,0.98738439
30134,84,43,3,2,0.000147059,875418,0.987387774
23447,714,347,3,2,0.000147059,875421,0.987391157
26855,23,609,3,2,0.000147059,875424,0.987394541
17577,331,133,3,2,0.000147059,875427,0.987397925
26435,492,68,3,2,0.000147059,875430,0.987401308
22564,446,16,3,2,0.000147059,875433,0.987404692
26442,163,427,3,2,0.000147059,875436,0.987408076
22904,196,528,3,2,0.000147059,875439,0.98741146
26376,50,155,3,2,0.000147059,875442,0.987414843
22857,529,571,3,2,0.000147059,875445,0.987418227
26380,290,544,3,2,0.000147059,875448,0.987421611
27165,475,502,3,2,0.000147059,875451,0.987424994
12975,529,313,3,2,0.000147059,875454,0.987428378
27163,10,433,3,2,0.000147059,875457,0.987431762
26404,138,503,3,2,0.000147059,875460,0.987435145
22558,448,3,3,2,0.000147059,875463,0.987438529
23000,720,708,3,2,0.000147059,875466,0.987441913
18413,107,23,3,2,0.000147059,875469,0.987445297
23098,562,2,3,2,0.000147059,875472,0.98744868
26672,178,723,3,2,0.000147059,875475,0.987452064
18409,458,471,3,2,0.000147059,875478,0.987455448
23115,290,95,3,2,0.000147059,875481,0.987458831
26948,56,138,3,2,0.000147059,875484,0.987462215
18320,97,529,3,2,0.000147059,875487,0.987465599
23107,43,328,3,2,0.000147059,875490,0.987468983
23104,124,609,3,2,0.000147059,875493,0.987472366
26752,5,207,3,2,0.000147059,875496,0.98747575
26706,364,632,3,2,0.000147059,875499,0.987479134
26970,15,364,3,2,0.000147059,875502,0.987482517
23076,394,163,3,2,0.000147059,875505,0.987485901
26734,708,609,3,2,0.000147059,875508,0.987489285
22744,492,347,3,2,0.000147059,875511,0.987492669
23070,195,708,3,2,0.000147059,875514,0.987496052
17899,4,517,3,2,0.000147059,875517,0.987499436
22960,20,117,3,2,0.000147059,875520,0.98750282
27097,261,274,3,2,0.000147059,875523,0.987506203
26613,332,560,3,2,0.000147059,875526,0.987509587
23177,64,674,3,2,0.000147059,875529,0.987512971
18489,130,246,3,2,0.000147059,875532,0.987516355
22965,160,397,3,2,0.000147059,875535,0.987519738
18486,605,471,3,2,0.000147059,875538,0.987523122
12919,307,280,3,2,0.000147059,875541,0.987526506
23207,22,34,3,2,0.000147059,875544,0.987529889
22958,448,145,3,2,0.000147059,875547,0.987533273
26780,174,56,3,2,0.000147059,875550,0.987536657
22803,332,393,3,2,0.000147059,875553,0.987540041
17556,280,1,3,2,0.000147059,875556,0.987543424
23126,475,683,3,2,0.000147059,875559,0.987546808
22682,264,145,3,2,0.000147059,875562,0.987550192
27092,124,10,3,2,0.000147059,875565,0.987553575
22674,683,393,3,2,0.000147059,875568,0.987556959
22974,493,6,3,2,0.000147059,875571,0.987560343
25491,335,342,3,2,0.000147059,875574,0.987563727
24449,605,54,3,2,0.000147059,875577,0.98756711
25449,32,409,3,2,0.000147059,875580,0.987570494
24480,243,126,3,2,0.000147059,875583,0.987573878
25476,414,1,3,2,0.000147059,875586,0.987577261
24404,525,204,3,2,0.000147059,875589,0.987580645
24409,26,494,3,2,0.000147059,875592,0.987584029
25479,385,164,3,2,0.000147059,875595,0.987587413
25471,492,95,3,2,0.000147059,875598,0.987590796
15398,193,175,3,2,0.000147059,875601,0.98759418
16207,332,236,3,2,0.000147059,875604,0.987597564
24572,202,30,3,2,0.000147059,875607,0.987600947
25362,64,158,3,2,0.000147059,875610,0.987604331
15388,475,195,3,2,0.000147059,875613,0.987607715
15362,502,334,3,2,0.000147059,875616,0.987611099
25395,34,458,3,2,0.000147059,875619,0.987614482
24396,23,84,3,2,0.000147059,875622,0.987617866
24282,126,32,3,2,0.000147059,875625,0.98762125
25586,721,482,3,2,0.000147059,875628,0.987624633
24293,13,193,3,2,0.000147059,875631,0.987628017
16698,720,582,3,2,0.000147059,875634,0.987631401
25625,204,719,3,2,0.000147059,875637,0.987634785
16665,605,313,3,2,0.000147059,875640,0.987638168
25631,145,482,3,2,0.000147059,875643,0.987641552
24248,107,446,3,2,0.000147059,875646,0.987644936
25560,683,614,3,2,0.000147059,875649,0.987648319
24364,117,673,3,2,0.000147059,875652,0.987651703
24366,475,124,3,2,0.000147059,875655,0.987655087
25524,90,328,3,2,0.000147059,875658,0.987658471
15198,624,638,3,2,0.000147059,875661,0.987661854
24355,265,661,3,2,0.000147059,875664,0.987665238
25554,174,596,3,2,0.000147059,875667,0.987668622
24354,265,552,3,2,0.000147059,875670,0.987672005
25531,124,11,3,2,0.000147059,875673,0.987675389
24596,624,2,3,2,0.000147059,875676,0.987678773
15646,242,503,3,2,0.000147059,875679,0.987682157
24869,624,535,3,2,0.000147059,875682,0.98768554
25081,383,479,3,2,0.000147059,875685,0.987688924
24823,290,219,3,2,0.000147059,875688,0.987692308
25091,587,219,3,2,0.000147059,875691,0.987695691
24839,140,562,3,2,0.000147059,875694,0.987699075
24847,618,661,3,2,0.000147059,875697,0.987702459
24939,236,525,3,2,0.000147059,875700,0.987705843
24942,614,652,3,2,0.000147059,875703,0.987709226
24995,448,632,3,2,0.000147059,875706,0.98771261
15856,2,114,3,2,0.000147059,875709,0.987715994
15797,517,85,3,2,0.000147059,875712,0.987719377
24908,274,1,3,2,0.000147059,875715,0.987722761
24901,167,230,3,2,0.000147059,875718,0.987726145
24913,479,493,3,2,0.000147059,875721,0.987729529
24815,32,668,3,2,0.000147059,875724,0.987732912
24690,171,439,3,2,0.000147059,875727,0.987736296
25251,492,32,3,2,0.000147059,875730,0.98773968
24621,261,34,3,2,0.000147059,875733,0.987743063
16160,307,708,3,2,0.000147059,875736,0.987746447
25296,586,160,3,2,0.000147059,875739,0.987749831
24628,613,558,3,2,0.000147059,875742,0.987753215
24635,95,207,3,2,0.000147059,875745,0.987756598
25279,380,571,3,2,0.000147059,875748,0.987759982
25132,609,64,3,2,0.000147059,875751,0.987763366
24799,195,354,3,2,0.000147059,875754,0.987766749
25119,2,682,3,2,0.000147059,875757,0.987770133
25114,19,243,3,2,0.000147059,875760,0.987773517
25110,264,560,3,2,0.000147059,875763,0.987776901
24719,19,393,3,2,0.000147059,875766,0.987780284
16042,364,394,3,2,0.000147059,875769,0.987783668
16039,439,586,3,2,0.000147059,875772,0.987787052
24761,178,174,3,2,0.000147059,875775,0.987790435
25176,178,618,3,2,0.000147059,875778,0.987793819
24208,552,175,3,2,0.000147059,875781,0.987797203
23681,439,126,3,2,0.000147059,875784,0.987800587
17291,673,54,3,2,0.000147059,875787,0.98780397
26097,701,663,3,2,0.000147059,875790,0.987807354
17347,26,174,3,2,0.000147059,875793,0.987810738
17391,133,33,3,2,0.000147059,875796,0.987814121
17385,618,77,3,2,0.000147059,875799,0.987817505
23630,383,167,3,2,0.000147059,875802,0.987820889
23633,156,138,3,2,0.000147059,875805,0.987824273
17366,721,77,3,2,0.000147059,875808,0.987827656
26032,138,463,3,2,0.000147059,875811,0.98783104
14228,246,280,3,2,0.000147059,875814,0.987834424
23731,117,54,3,2,0.000147059,875817,0.987837807
23733,141,3,3,2,0.000147059,875820,0.987841191
30131,471,493,3,2,0.000147059,875823,0.987844575
23743,5,385,3,2,0.000147059,875826,0.987847958
26287,195,394,3,2,0.000147059,875829,0.987851342
26313,22,121,3,2,0.000147059,875832,0.987854726
23480,482,307,3,2,0.000147059,875835,0.98785811
26186,90,131,3,2,0.000147059,875838,0.987861493
23613,560,131,3,2,0.000147059,875841,0.987864877
23543,605,646,3,2,0.000147059,875844,0.987868261
13796,646,393,3,2,0.000147059,875847,0.987871644
24090,674,646,3,2,0.000147059,875850,0.987875028
25768,5,117,3,2,0.000147059,875853,0.987878412
25803,117,364,3,2,0.000147059,875856,0.987881796
24051,164,552,3,2,0.000147059,875859,0.987885179
24047,443,525,3,2,0.000147059,875862,0.987888563
16965,22,77,3,2,0.000147059,875865,0.987891947
24168,202,158,3,2,0.000147059,875868,0.98789533
24170,22,195,3,2,0.000147059,875871,0.987898714
24178,494,10,3,2,0.000147059,875874,0.987902098
14950,207,95,3,2,0.000147059,875877,0.987905482
16791,56,562,3,2,0.000147059,875880,0.987908865
25712,274,195,3,2,0.000147059,875883,0.987912249
17085,123,503,3,2,0.000147059,875886,0.987915633
23834,64,353,3,2,0.000147059,875889,0.987919016
25970,514,1,3,2,0.000147059,875892,0.9879224
23944,482,170,3,2,0.000147059,875895,0.987925784
23948,196,569,3,2,0.000147059,875898,0.987929168
23958,133,479,3,2,0.000147059,875901,0.987932551
17024,158,439,3,2,0.000147059,875904,0.987935935
25876,19,448,3,2,0.000147059,875907,0.987939319
23928,638,181,3,2,0.000147059,875910,0.987942702
23909,332,31,3,2,0.000147059,875913,0.987946086
23921,19,508,3,2,0.000147059,875916,0.98794947
23922,34,613,3,2,0.000147059,875919,0.987952854
21527,640,103,3,2,0.000147059,875922,0.987956237
19683,32,392,3,2,0.000147059,875925,0.987959621
21546,25,160,3,2,0.000147059,875928,0.987963005
21476,522,525,3,2,0.000147059,875931,0.987966388
19738,646,264,3,2,0.000147059,875934,0.987969772
19728,446,380,3,2,0.000147059,875937,0.987973156
27899,502,439,3,2,0.000147059,875940,0.98797654
29521,141,560,3,2,0.000147059,875943,0.987979923
27923,618,571,3,2,0.000147059,875946,0.987983307
28112,170,95,3,2,0.000147059,875949,0.987986691
21350,334,501,3,2,0.000147059,875952,0.987990074
29286,626,313,3,2,0.000147059,875955,0.987993458
19831,138,164,3,2,0.000147059,875958,0.987996842
21341,1,624,3,2,0.000147059,875961,0.988000226
19871,502,479,3,2,0.000147059,875964,0.988003609
21433,674,246,3,2,0.000147059,875967,0.988006993
21437,280,661,3,2,0.000147059,875970,0.988010377
21447,54,56,3,2,0.000147059,875973,0.98801376
21449,588,571,3,2,0.000147059,875976,0.988017144
19772,596,90,3,2,0.000147059,875979,0.988020528
28062,479,90,3,2,0.000147059,875982,0.988023912
21425,458,588,3,2,0.000147059,875985,0.988027295
28082,331,124,3,2,0.000147059,875988,0.988030679
21400,721,463,3,2,0.000147059,875991,0.988034063
28075,646,170,3,2,0.000147059,875994,0.988037446
19354,193,311,3,2,0.000147059,875997,0.98804083
29709,77,576,3,2,0.000147059,876000,0.988044214
27672,19,2,3,2,0.000147059,876003,0.988047598
29719,371,250,3,2,0.000147059,876006,0.988050981
27755,167,427,3,2,0.000147059,876009,0.988054365
27754,503,250,3,2,0.000147059,876012,0.988057749
27749,23,274,3,2,0.000147059,876015,0.988061132
19407,525,3,3,2,0.000147059,876018,0.988064516
21839,158,54,3,2,0.000147059,876021,0.9880679
21967,618,448,3,2,0.000147059,876024,0.988071284
19279,624,1,3,2,0.000147059,876027,0.988074667
27619,121,689,3,2,0.000147059,876030,0.988078051
21991,163,307,3,2,0.000147059,876033,0.988081435
29728,673,571,3,2,0.000147059,876036,0.988084818
21937,138,586,3,2,0.000147059,876039,0.988088202
21816,123,163,3,2,0.000147059,876042,0.988091586
21704,613,3,3,2,0.000147059,876045,0.98809497
29569,528,342,3,2,0.000147059,876048,0.988098353
21728,97,328,3,2,0.000147059,876051,0.988101737
21662,682,514,3,2,0.000147059,876054,0.988105121
27856,525,383,3,2,0.000147059,876057,0.988108504
21667,133,114,3,2,0.000147059,876060,0.988111888
19442,97,26,3,2,0.000147059,876063,0.988115272
21806,178,689,3,2,0.000147059,876066,0.988118656
21769,720,471,3,2,0.000147059,876069,0.988122039
20854,448,522,3,2,0.000147059,876072,0.988125423
20346,717,723,3,2,0.000147059,876075,0.988128807
20420,394,511,3,2,0.000147059,876078,0.98813219
20802,274,2,3,2,0.000147059,876081,0.988135574
28568,605,5,3,2,0.000147059,876084,0.988138958
28560,626,131,3,2,0.000147059,876087,0.988142342
20327,2,195,3,2,0.000147059,876090,0.988145725
28433,202,689,3,2,0.000147059,876093,0.988149109
28462,719,126,3,2,0.000147059,876096,0.988152493
28479,479,160,3,2,0.000147059,876099,0.988155876
20251,383,15,3,2,0.000147059,876102,0.98815926
20963,156,56,3,2,0.000147059,876105,0.988162644
20902,497,507,3,2,0.000147059,876108,0.988166028
20301,558,448,3,2,0.000147059,876111,0.988169411
20912,137,27,3,2,0.000147059,876114,0.988172795
20424,501,2,3,2,0.000147059,876117,0.988176179
20546,525,145,3,2,0.000147059,876120,0.988179562
20696,525,334,3,2,0.000147059,876123,0.988182946
20555,640,569,3,2,0.000147059,876126,0.98818633
20794,717,64,3,2,0.000147059,876129,0.988189714
28699,458,501,3,2,0.000147059,876132,0.988193097
20604,167,562,3,2,0.000147059,876135,0.988196481
20634,708,56,3,2,0.000147059,876138,0.988199865
28738,626,544,3,2,0.000147059,876141,0.988203248
20767,12,723,3,2,0.000147059,876144,0.988206632
20451,155,503,3,2,0.000147059,876147,0.988210016
28803,503,97,3,2,0.000147059,876150,0.9882134
21197,50,544,3,2,0.000147059,876153,0.988216783
29131,652,314,3,2,0.000147059,876156,0.988220167
28286,507,160,3,2,0.000147059,876159,0.988223551
20076,668,517,3,2,0.000147059,876162,0.988226934
28279,294,34,3,2,0.000147059,876165,0.988230318
20069,133,204,3,2,0.000147059,876168,0.988233702
28432,19,22,3,2,0.000147059,876171,0.988237085
29215,626,5,3,2,0.000147059,876174,0.988240469
28164,138,155,3,2,0.000147059,876177,0.988243853
29243,43,12,3,2,0.000147059,876180,0.988247237
28223,145,269,3,2,0.000147059,876183,0.98825062
21235,242,313,3,2,0.000147059,876186,0.988254004
28289,170,723,3,2,0.000147059,876189,0.988257388
20188,684,236,3,2,0.000147059,876192,0.988260771
28389,328,492,3,2,0.000147059,876195,0.988264155
20190,6,202,3,2,0.000147059,876198,0.988267539
21036,383,587,3,2,0.000147059,876201,0.988270923
28398,446,683,3,2,0.000147059,876204,0.988274306
28415,528,23,3,2,0.000147059,876207,0.98827769
20219,701,64,3,2,0.000147059,876210,0.988281074
20998,717,33,3,2,0.000147059,876213,0.988284457
28996,175,236,3,2,0.000147059,876216,0.988287841
28336,618,181,3,2,0.000147059,876219,0.988291225
21096,2,414,3,2,0.000147059,876222,0.988294609
28329,131,19,3,2,0.000147059,876225,0.988297992
29029,117,171,3,2,0.000147059,876228,0.988301376
28364,498,701,3,2,0.000147059,876231,0.98830476
28346,167,202,3,2,0.000147059,876234,0.988308143
15810,409,77,3,2,0.000147059,876237,0.988311527
19127,586,552,3,2,0.000147059,876240,0.988314911
22187,246,243,3,2,0.000147059,876243,0.988318295
18897,103,311,3,2,0.000147059,876246,0.988321678
22234,593,392,3,2,0.000147059,876249,0.988325062
22067,155,674,3,2,0.000147059,876252,0.988328446
30107,379,626,3,2,0.000147059,876255,0.988331829
27224,230,684,3,2,0.000147059,876258,0.988335213
22184,5,280,3,2,0.000147059,876261,0.988338597
18669,4,347,3,2,0.000147059,876264,0.988341981
27226,158,160,3,2,0.000147059,876267,0.988345364
22342,397,618,3,2,0.000147059,876270,0.988348748
18723,699,311,3,2,0.000147059,876273,0.988352132
18806,261,414,3,2,0.000147059,876276,0.988355515
22096,5,560,3,2,0.000147059,876279,0.988358899
19097,332,32,3,2,0.000147059,876282,0.988362283
18713,582,137,3,2,0.000147059,876285,0.988365667
30084,646,23,3,2,0.000147059,876288,0.98836905
18928,90,84,3,2,0.000147059,876291,0.988372434
22429,342,335,3,2,0.000147059,876294,0.988375818
18936,123,174,3,2,0.000147059,876297,0.988379201
22328,522,290,3,2,0.000147059,876300,0.988382585
29857,446,562,3,2,0.000147059,876303,0.988385969
22176,290,479,3,2,0.000147059,876306,0.988389353
22382,528,64,3,2,0.000147059,876309,0.988392736
27287,124,156,3,2,0.000147059,876312,0.98839612
27359,404,613,3,2,0.000147059,876315,0.988399504
22170,5,290,3,2,0.000147059,876318,0.988402887
22517,20,587,3,2,0.000147059,876321,0.988406271
22379,68,576,3,2,0.000147059,876324,0.988409655
22140,138,543,3,2,0.000147059,876327,0.988413039
12385,721,141,3,2,0.000147059,876330,0.988416422
22300,164,689,3,2,0.000147059,876333,0.988419806
18890,398,204,3,2,0.000147059,876336,0.98842319
22302,522,613,3,2,0.000147059,876339,0.988426573
22031,54,348,3,2,0.000147059,876342,0.988429957
31713,124,167,2,2,9.80E-05,876344,0.988432213
27022,167,674,2,2,9.80E-05,876346,0.988434469
29059,250,571,2,2,9.80E-05,876348,0.988436725
25505,250,156,2,2,9.80E-05,876350,0.98843898
25506,195,655,2,2,9.80E-05,876352,0.988441236
25455,398,552,2,2,9.80E-05,876354,0.988443492
28342,717,311,2,2,9.80E-05,876356,0.988445748
27025,392,33,2,2,9.80E-05,876358,0.988448004
28992,560,105,2,2,9.80E-05,876360,0.988450259
25431,156,439,2,2,9.80E-05,876362,0.988452515
31739,117,446,2,2,9.80E-05,876364,0.988454771
27024,721,56,2,2,9.80E-05,876366,0.988457027
28341,121,114,2,2,9.80E-05,876368,0.988459283
25503,124,107,2,2,9.80E-05,876370,0.988461538
28339,507,673,2,2,9.80E-05,876372,0.988463794
28386,124,479,2,2,9.80E-05,876374,0.98846605
31747,699,307,2,2,9.80E-05,876376,0.988468306
28993,295,133,2,2,9.80E-05,876378,0.988470562
25467,156,117,2,2,9.80E-05,876380,0.988472818
27299,124,682,2,2,9.80E-05,876382,0.988475073
27021,9,626,2,2,9.80E-05,876384,0.988477329
30260,568,204,2,2,9.80E-05,876386,0.988479585
25430,661,130,2,2,9.80E-05,876388,0.988481841
27045,723,16,2,2,9.80E-05,876390,0.988484097
30266,568,131,2,2,9.80E-05,876392,0.988486352
25459,714,558,2,2,9.80E-05,876394,0.988488608
30002,274,5,2,2,9.80E-05,876396,0.988490864
28409,517,701,2,2,9.80E-05,876398,0.98849312
25521,302,458,2,2,9.80E-05,876400,0.988495376
27048,497,482,2,2,9.80E-05,876402,0.988497631
28393,571,16,2,2,9.80E-05,876404,0.988499887
15257,311,261,2,2,9.80E-05,876406,0.988502143
30030,294,84,2,2,9.80E-05,876408,0.988504399
31779,145,43,2,2,9.80E-05,876410,0.988506655
27330,535,43,2,2,9.80E-05,876412,0.98850891
15151,392,123,2,2,9.80E-05,876414,0.988511166
25424,131,448,2,2,9.80E-05,876416,0.988513422
30263,34,409,2,2,9.80E-05,876418,0.988515678
28337,508,16,2,2,9.80E-05,876420,0.988517934
30213,155,614,2,2,9.80E-05,876422,0.988520189
25518,543,448,2,2,9.80E-05,876424,0.988522445
27327,138,163,2,2,9.80E-05,876426,0.988524701
27067,163,517,2,2,9.80E-05,876428,0.988526957
31740,673,202,2,2,9.80E-05,876430,0.988529213
28395,717,95,2,2,9.80E-05,876432,0.988531469
29001,141,170,2,2,9.80E-05,876434,0.988533724
12674,4,264,2,2,9.80E-05,876436,0.98853598
27308,682,207,2,2,9.80E-05,876438,0.988538236
25513,2,482,2,2,9.80E-05,876440,0.988540492
30220,507,328,2,2,9.80E-05,876442,0.988542748
30019,446,54,2,2,9.80E-05,876444,0.988545003
28385,34,246,2,2,9.80E-05,876446,0.988547259
30017,723,131,2,2,9.80E-05,876448,0.988549515
25454,494,313,2,2,9.80E-05,876450,0.988551771
29037,178,353,2,2,9.80E-05,876452,0.988554027
25437,640,528,2,2,9.80E-05,876454,0.988556282
27301,202,646,2,2,9.80E-05,876456,0.988558538
31737,193,364,2,2,9.80E-05,876458,0.988560794
27030,463,12,2,2,9.80E-05,876460,0.98856305
29043,427,23,2,2,9.80E-05,876462,0.988565306
30013,439,508,2,2,9.80E-05,876464,0.988567561
31761,414,133,2,2,9.80E-05,876466,0.988569817
25439,674,207,2,2,9.80E-05,876468,0.988572073
27314,668,56,2,2,9.80E-05,876470,0.988574329
28362,313,684,2,2,9.80E-05,876472,0.988576585
31751,673,133,2,2,9.80E-05,876474,0.988578841
25485,458,77,2,2,9.80E-05,876476,0.988581096
27031,511,64,2,2,9.80E-05,876478,0.988583352
31730,699,674,2,2,9.80E-05,876480,0.988585608
27033,155,714,2,2,9.80E-05,876482,0.988587864
27027,614,207,2,2,9.80E-05,876484,0.98859012
25481,314,138,2,2,9.80E-05,876486,0.988592375
29035,29,652,2,2,9.80E-05,876488,0.988594631
28999,178,427,2,2,9.80E-05,876490,0.988596887
31734,85,618,2,2,9.80E-05,876492,0.988599143
29033,393,492,2,2,9.80E-05,876494,0.988601399
30250,175,97,2,2,9.80E-05,876496,0.988603654
25443,385,14,2,2,9.80E-05,876498,0.98860591
25475,689,571,2,2,9.80E-05,876500,0.988608166
25448,124,48,2,2,9.80E-05,876502,0.988610422
25474,562,646,2,2,9.80E-05,876504,0.988612678
27035,493,307,2,2,9.80E-05,876506,0.988614933
15240,721,107,2,2,9.80E-05,876508,0.988617189
28378,195,19,2,2,9.80E-05,876510,0.988619445
29045,34,626,2,2,9.80E-05,876512,0.988621701
27321,661,514,2,2,9.80E-05,876514,0.988623957
25499,124,174,2,2,9.80E-05,876516,0.988626212
30024,392,482,2,2,9.80E-05,876518,0.988628468
28384,171,117,2,2,9.80E-05,876520,0.988630724
27311,269,6,2,2,9.80E-05,876522,0.98863298
25432,5,532,2,2,9.80E-05,876524,0.988635236
31714,332,646,2,2,9.80E-05,876526,0.988637492
28349,347,507,2,2,9.80E-05,876528,0.988639747
15234,163,393,2,2,9.80E-05,876530,0.988642003
28383,121,682,2,2,9.80E-05,876532,0.988644259
27312,207,497,2,2,9.80E-05,876534,0.988646515
25492,64,77,2,2,9.80E-05,876536,0.988648771
29057,85,394,2,2,9.80E-05,876538,0.988651026
31726,85,243,2,2,9.80E-05,876540,0.988653282
31749,2,492,2,2,9.80E-05,876542,0.988655538
30011,178,588,2,2,9.80E-05,876544,0.988657794
25489,492,141,2,2,9.80E-05,876546,0.98866005
29011,433,314,2,2,9.80E-05,876548,0.988662305
29067,32,433,2,2,9.80E-05,876550,0.988664561
27044,31,571,2,2,9.80E-05,876552,0.988666817
27300,414,618,2,2,9.80E-05,876554,0.988669073
25435,493,392,2,2,9.80E-05,876556,0.988671329
29053,50,140,2,2,9.80E-05,876558,0.988673584
25436,170,164,2,2,9.80E-05,876560,0.98867584
28348,493,64,2,2,9.80E-05,876562,0.988678096
29807,164,646,2,2,9.80E-05,876564,0.988680352
27012,342,614,2,2,9.80E-05,876566,0.988682608
29169,632,701,2,2,9.80E-05,876568,0.988684864
25651,311,202,2,2,9.80E-05,876570,0.988687119
31614,560,11,2,2,9.80E-05,876572,0.988689375
27353,64,394,2,2,9.80E-05,876574,0.988691631
28243,332,593,2,2,9.80E-05,876576,0.988693887
25653,632,482,2,2,9.80E-05,876578,0.988696143
29154,371,347,2,2,9.80E-05,876580,0.988698398
29165,141,31,2,2,9.80E-05,876582,0.988700654
29166,175,302,2,2,9.80E-05,876584,0.98870291
29168,25,5,2,2,9.80E-05,876586,0.988705166
28234,242,160,2,2,9.80E-05,876588,0.988707422
26947,632,433,2,2,9.80E-05,876590,0.988709677
25660,207,532,2,2,9.80E-05,876592,0.988711933
14952,196,535,2,2,9.80E-05,876594,0.988714189
26944,493,250,2,2,9.80E-05,876596,0.988716445
26943,353,290,2,2,9.80E-05,876598,0.988718701
27356,160,475,2,2,9.80E-05,876600,0.988720956
25666,719,674,2,2,9.80E-05,876602,0.988723212
27357,167,77,2,2,9.80E-05,876604,0.988725468
29175,243,138,2,2,9.80E-05,876606,0.988727724
26950,10,699,2,2,9.80E-05,876608,0.98872998
28246,560,15,2,2,9.80E-05,876610,0.988732236
28248,171,332,2,2,9.80E-05,876612,0.988734491
25648,334,85,2,2,9.80E-05,876614,0.988736747
28263,11,448,2,2,9.80E-05,876616,0.988739003
26961,243,569,2,2,9.80E-05,876618,0.988741259
26960,12,195,2,2,9.80E-05,876620,0.988743515
29139,703,97,2,2,9.80E-05,876622,0.98874577
26958,689,514,2,2,9.80E-05,876624,0.988748026
25636,121,307,2,2,9.80E-05,876626,0.988750282
25637,167,164,2,2,9.80E-05,876628,0.988752538
26957,33,458,2,2,9.80E-05,876630,0.988754794
29140,90,385,2,2,9.80E-05,876632,0.988757049
25638,511,482,2,2,9.80E-05,876634,0.988759305
25639,494,274,2,2,9.80E-05,876636,0.988761561
25640,385,34,2,2,9.80E-05,876638,0.988763817
27348,714,674,2,2,9.80E-05,876640,0.988766073
25642,131,133,2,2,9.80E-05,876642,0.988768328
25643,439,195,2,2,9.80E-05,876644,0.988770584
26954,560,230,2,2,9.80E-05,876646,0.98877284
29148,103,661,2,2,9.80E-05,876648,0.988775096
28250,404,171,2,2,9.80E-05,876650,0.988777352
26951,250,138,2,2,9.80E-05,876652,0.988779607
29149,50,195,2,2,9.80E-05,876654,0.988781863
26935,723,582,2,2,9.80E-05,876656,0.988784119
25672,394,12,2,2,9.80E-05,876658,0.988786375
25673,507,514,2,2,9.80E-05,876660,0.988788631
26927,269,473,2,2,9.80E-05,876662,0.988790887
31566,133,64,2,2,9.80E-05,876664,0.988793142
31560,723,250,2,2,9.80E-05,876666,0.988795398
28205,543,383,2,2,9.80E-05,876668,0.988797654
25707,140,552,2,2,9.80E-05,876670,0.98879991
28203,427,22,2,2,9.80E-05,876672,0.988802166
28202,219,684,2,2,9.80E-05,876674,0.988804421
28199,613,439,2,2,9.80E-05,876676,0.988806677
28198,699,54,2,2,9.80E-05,876678,0.988808933
27365,427,25,2,2,9.80E-05,876680,0.988811189
28197,682,29,2,2,9.80E-05,876682,0.988813445
25715,668,26,2,2,9.80E-05,876684,0.9888157
25717,528,392,2,2,9.80E-05,876686,0.988817956
31556,130,124,2,2,9.80E-05,876688,0.988820212
25719,307,23,2,2,9.80E-05,876690,0.988822468
30350,236,701,2,2,9.80E-05,876692,0.988824724
31555,332,133,2,2,9.80E-05,876694,0.988826979
29213,23,167,2,2,9.80E-05,876696,0.988829235
14834,689,174,2,2,9.80E-05,876698,0.988831491
27366,501,160,2,2,9.80E-05,876700,0.988833747
26921,50,446,2,2,9.80E-05,876702,0.988836003
25703,12,661,2,2,9.80E-05,876704,0.988838259
28207,11,29,2,2,9.80E-05,876706,0.988840514
30342,393,721,2,2,9.80E-05,876708,0.98884277
25674,80,174,2,2,9.80E-05,876710,0.988845026
29183,90,517,2,2,9.80E-05,876712,0.988847282
26933,131,137,2,2,9.80E-05,876714,0.988849538
29978,15,576,2,2,9.80E-05,876716,0.988851793
25679,385,544,2,2,9.80E-05,876718,0.988854049
29977,383,155,2,2,9.80E-05,876720,0.988856305
25682,701,689,2,2,9.80E-05,876722,0.988858561
28219,121,502,2,2,9.80E-05,876724,0.988860817
28218,295,493,2,2,9.80E-05,876726,0.988863072
31585,562,446,2,2,9.80E-05,876728,0.988865328
25686,535,13,2,2,9.80E-05,876730,0.988867584
30343,587,385,2,2,9.80E-05,876732,0.98886984
25688,605,29,2,2,9.80E-05,876734,0.988872096
31581,493,543,2,2,9.80E-05,876736,0.988874351
25690,290,501,2,2,9.80E-05,876738,0.988876607
27363,90,535,2,2,9.80E-05,876740,0.988878863
25699,646,48,2,2,9.80E-05,876742,0.988881119
25700,20,383,2,2,9.80E-05,876744,0.988883375
28264,77,720,2,2,9.80E-05,876746,0.98888563
25630,609,723,2,2,9.80E-05,876748,0.988887886
27347,552,137,2,2,9.80E-05,876750,0.988890142
29082,22,5,2,2,9.80E-05,876752,0.988892398
28311,50,409,2,2,9.80E-05,876754,0.988894654
25549,586,2,2,2,9.80E-05,876756,0.98889691
25550,193,367,2,2,9.80E-05,876758,0.988899165
30288,331,342,2,2,9.80E-05,876760,0.988901421
25553,587,463,2,2,9.80E-05,876762,0.988903677
27334,699,30,2,2,9.80E-05,876764,0.988905933
29998,54,130,2,2,9.80E-05,876766,0.988908189
28304,95,569,2,2,9.80E-05,876768,0.988910444
29097,448,587,2,2,9.80E-05,876770,0.9889127
31688,655,319,2,2,9.80E-05,876772,0.988914956
29996,138,328,2,2,9.80E-05,876774,0.988917212
27294,9,19,2,2,9.80E-05,876776,0.988919468
28301,334,126,2,2,9.80E-05,876778,0.988921723
28298,517,668,2,2,9.80E-05,876780,0.988923979
31683,85,26,2,2,9.80E-05,876782,0.988926235
29101,20,328,2,2,9.80E-05,876784,0.988928491
25565,313,269,2,2,9.80E-05,876786,0.988930747
25567,22,605,2,2,9.80E-05,876788,0.988933002
29084,501,138,2,2,9.80E-05,876790,0.988935258
31692,613,392,2,2,9.80E-05,876792,0.988937514
28294,175,171,2,2,9.80E-05,876794,0.98893977
25546,661,145,2,2,9.80E-05,876796,0.988942026
28331,103,587,2,2,9.80E-05,876798,0.988944282
30270,264,1,2,2,9.80E-05,876800,0.988946537
25528,175,170,2,2,9.80E-05,876802,0.988948793
31703,397,684,2,2,9.80E-05,876804,0.988951049
30271,394,624,2,2,9.80E-05,876806,0.988953305
31700,193,117,2,2,9.80E-05,876808,0.988955561
25533,19,443,2,2,9.80E-05,876810,0.988957816
25535,295,720,2,2,9.80E-05,876812,0.988960072
15113,543,501,2,2,9.80E-05,876814,0.988962328
30285,167,593,2,2,9.80E-05,876816,0.988964584
28327,543,261,2,2,9.80E-05,876818,0.98896684
29076,646,562,2,2,9.80E-05,876820,0.988969095
31695,121,605,2,2,9.80E-05,876822,0.988971351
28325,494,398,2,2,9.80E-05,876824,0.988973607
28320,43,392,2,2,9.80E-05,876826,0.988975863
25545,23,3,2,2,9.80E-05,876828,0.988978119
31677,626,632,2,2,9.80E-05,876830,0.988980374
29993,613,723,2,2,9.80E-05,876832,0.98898263
29128,121,242,2,2,9.80E-05,876834,0.988984886
25594,446,121,2,2,9.80E-05,876836,0.988987142
31656,626,250,2,2,9.80E-05,876838,0.988989398
26976,195,517,2,2,9.80E-05,876840,0.988991654
29121,64,398,2,2,9.80E-05,876842,0.988993909
26974,720,294,2,2,9.80E-05,876844,0.988996165
25599,43,646,2,2,9.80E-05,876846,0.988998421
31650,22,90,2,2,9.80E-05,876848,0.989000677
28274,562,12,2,2,9.80E-05,876850,0.989002933
25609,613,663,2,2,9.80E-05,876852,0.989005188
31637,171,133,2,2,9.80E-05,876854,0.989007444
25612,473,576,2,2,9.80E-05,876856,0.9890097
25616,532,124,2,2,9.80E-05,876858,0.989011956
31632,458,124,2,2,9.80E-05,876860,0.989014212
31631,328,181,2,2,9.80E-05,876862,0.989016467
25622,383,195,2,2,9.80E-05,876864,0.989018723
25623,95,605,2,2,9.80E-05,876866,0.989020979
26969,632,414,2,2,9.80E-05,876868,0.989023235
28269,525,471,2,2,9.80E-05,876870,0.989025491
25626,471,560,2,2,9.80E-05,876872,0.989027746
31657,502,701,2,2,9.80E-05,876874,0.989030002
28278,661,121,2,2,9.80E-05,876876,0.989032258
29104,26,138,2,2,9.80E-05,876878,0.989034514
31658,121,508,2,2,9.80E-05,876880,0.98903677
29105,14,23,2,2,9.80E-05,876882,0.989039025
28291,124,294,2,2,9.80E-05,876884,0.989041281
25575,130,160,2,2,9.80E-05,876886,0.989043537
31672,246,544,2,2,9.80E-05,876888,0.989045793
25577,655,202,2,2,9.80E-05,876890,0.989048049
29112,717,126,2,2,9.80E-05,876892,0.989050305
15046,246,9,2,2,9.80E-05,876894,0.98905256
25581,646,97,2,2,9.80E-05,876896,0.989054816
29992,265,54,2,2,9.80E-05,876898,0.989057072
26986,699,34,2,2,9.80E-05,876900,0.989059328
29115,204,371,2,2,9.80E-05,876902,0.989061584
27342,409,522,2,2,9.80E-05,876904,0.989063839
26984,562,448,2,2,9.80E-05,876906,0.989066095
27345,202,313,2,2,9.80E-05,876908,0.989068351
25589,394,494,2,2,9.80E-05,876910,0.989070607
31659,492,170,2,2,9.80E-05,876912,0.989072863
26980,269,32,2,2,9.80E-05,876914,0.989075118
25421,364,532,2,2,9.80E-05,876916,0.989077374
31846,114,175,2,2,9.80E-05,876918,0.98907963
25416,427,482,2,2,9.80E-05,876920,0.989081886
28603,19,427,2,2,9.80E-05,876922,0.989084142
28607,446,181,2,2,9.80E-05,876924,0.989086397
25100,155,307,2,2,9.80E-05,876926,0.989088653
25102,354,571,2,2,9.80E-05,876928,0.989090909
32072,571,170,2,2,9.80E-05,876930,0.989093165
25104,614,1,2,2,9.80E-05,876932,0.989095421
30157,170,126,2,2,9.80E-05,876934,0.989097677
25109,178,475,2,2,9.80E-05,876936,0.989099932
27229,103,107,2,2,9.80E-05,876938,0.989102188
27141,503,117,2,2,9.80E-05,876940,0.989104444
28810,265,20,2,2,9.80E-05,876942,0.9891067
28820,14,117,2,2,9.80E-05,876944,0.989108956
28824,5,514,2,2,9.80E-05,876946,0.989111211
25118,684,130,2,2,9.80E-05,876948,0.989113467
28594,56,19,2,2,9.80E-05,876950,0.989115723
28593,593,13,2,2,9.80E-05,876952,0.989117979
25120,160,50,2,2,9.80E-05,876954,0.989120235
25125,544,571,2,2,9.80E-05,876956,0.98912249
32074,31,673,2,2,9.80E-05,876958,0.989124746
25096,502,661,2,2,9.80E-05,876960,0.989127002
25127,439,392,2,2,9.80E-05,876962,0.989129258
28625,501,13,2,2,9.80E-05,876964,0.989131514
30104,529,294,2,2,9.80E-05,876966,0.989133769
27153,236,133,2,2,9.80E-05,876968,0.989136025
28634,34,482,2,2,9.80E-05,876970,0.989138281
28794,719,385,2,2,9.80E-05,876972,0.989140537
27217,5,274,2,2,9.80E-05,876974,0.989142793
25084,605,409,2,2,9.80E-05,876976,0.989145048
28629,364,167,2,2,9.80E-05,876978,0.989147304
30101,626,33,2,2,9.80E-05,876980,0.98914956
25085,571,313,2,2,9.80E-05,876982,0.989151816
28628,609,193,2,2,9.80E-05,876984,0.989154072
25087,156,404,2,2,9.80E-05,876986,0.989156328
28611,23,313,2,2,9.80E-05,876988,0.989158583
32076,133,85,2,2,9.80E-05,876990,0.989160839
15614,394,560,2,2,9.80E-05,876992,0.989163095
27220,264,20,2,2,9.80E-05,876994,0.989165351
28622,310,576,2,2,9.80E-05,876996,0.989167607
30100,717,171,2,2,9.80E-05,876998,0.989169862
30099,624,571,2,2,9.80E-05,877000,0.989172118
27148,404,2,2,2,9.80E-05,877002,0.989174374
30098,126,397,2,2,9.80E-05,877004,0.98917663
28616,11,571,2,2,9.80E-05,877006,0.989178886
28590,54,14,2,2,9.80E-05,877008,0.989181141
32048,202,193,2,2,9.80E-05,877010,0.989183397
30168,661,655,2,2,9.80E-05,877012,0.989185653
25165,552,178,2,2,9.80E-05,877014,0.989187909
30085,535,138,2,2,9.80E-05,877016,0.989190165
28831,178,243,2,2,9.80E-05,877018,0.98919242
28578,568,708,2,2,9.80E-05,877020,0.989194676
27242,181,348,2,2,9.80E-05,877022,0.989196932
27244,307,13,2,2,9.80E-05,877024,0.989199188
25177,404,493,2,2,9.80E-05,877026,0.989201444
25179,632,448,2,2,9.80E-05,877028,0.9892037
25180,609,508,2,2,9.80E-05,877030,0.989205955
27245,328,668,2,2,9.80E-05,877032,0.989208211
27240,23,265,2,2,9.80E-05,877034,0.989210467
30170,202,26,2,2,9.80E-05,877036,0.989212723
28570,543,569,2,2,9.80E-05,877038,0.989214979
25185,80,720,2,2,9.80E-05,877040,0.989217234
27126,207,587,2,2,9.80E-05,877042,0.98921949
28835,353,207,2,2,9.80E-05,877044,0.989221746
28837,32,576,2,2,9.80E-05,877046,0.989224002
28565,202,219,2,2,9.80E-05,877048,0.989226258
32006,43,613,2,2,9.80E-05,877050,0.989228513
25189,684,367,2,2,9.80E-05,877052,0.989230769
28839,114,193,2,2,9.80E-05,877054,0.989233025
32025,117,23,2,2,9.80E-05,877056,0.989235281
30086,294,497,2,2,9.80E-05,877058,0.989237537
15575,4,614,2,2,9.80E-05,877060,0.989239792
30160,264,171,2,2,9.80E-05,877062,0.989242048
32046,335,721,2,2,9.80E-05,877064,0.989244304
25133,717,663,2,2,9.80E-05,877066,0.98924656
25135,392,683,2,2,9.80E-05,877068,0.989248816
25136,265,196,2,2,9.80E-05,877070,0.989251072
27230,646,479,2,2,9.80E-05,877072,0.989253327
15567,30,164,2,2,9.80E-05,877074,0.989255583
30094,708,269,2,2,9.80E-05,877076,0.989257839
27138,131,261,2,2,9.80E-05,877078,0.989260095
28587,717,522,2,2,9.80E-05,877080,0.989262351
28827,501,178,2,2,9.80E-05,877082,0.989264606
28828,6,138,2,2,9.80E-05,877084,0.989266862
28583,68,137,2,2,9.80E-05,877086,0.989269118
32041,568,30,2,2,9.80E-05,877088,0.989271374
25144,517,164,2,2,9.80E-05,877090,0.98927363
32040,22,117,2,2,9.80E-05,877092,0.989275885
25147,23,131,2,2,9.80E-05,877094,0.989278141
25153,269,9,2,2,9.80E-05,877096,0.989280397
25156,130,613,2,2,9.80E-05,877098,0.989282653
28829,261,13,2,2,9.80E-05,877100,0.989284909
25158,494,3,2,2,9.80E-05,877102,0.989287164
28636,202,25,2,2,9.80E-05,877104,0.98928942
28639,202,121,2,2,9.80E-05,877106,0.989291676
27293,85,609,2,2,9.80E-05,877108,0.989293932
30117,652,334,2,2,9.80E-05,877110,0.989296188
25002,15,181,2,2,9.80E-05,877112,0.989298443
25004,503,280,2,2,9.80E-05,877114,0.989300699
28689,23,517,2,2,9.80E-05,877116,0.989302955
28688,497,43,2,2,9.80E-05,877118,0.989305211
25008,661,68,2,2,9.80E-05,877120,0.989307467
28744,164,682,2,2,9.80E-05,877122,0.989309723
28686,674,133,2,2,9.80E-05,877124,0.989311978
15761,392,77,2,2,9.80E-05,877126,0.989314234
30120,409,34,2,2,9.80E-05,877128,0.98931649
25014,19,335,2,2,9.80E-05,877130,0.989318746
25018,525,12,2,2,9.80E-05,877132,0.989321002
28690,85,398,2,2,9.80E-05,877134,0.989323257
28683,699,398,2,2,9.80E-05,877136,0.989325513
27194,29,501,2,2,9.80E-05,877138,0.989327769
28680,103,155,2,2,9.80E-05,877140,0.989330025
27168,10,719,2,2,9.80E-05,877142,0.989332281
28750,170,141,2,2,9.80E-05,877144,0.989334536
15753,638,682,2,2,9.80E-05,877146,0.989336792
27167,121,544,2,2,9.80E-05,877148,0.989339048
28677,84,193,2,2,9.80E-05,877150,0.989341304
25023,613,26,2,2,9.80E-05,877152,0.98934356
27195,138,156,2,2,9.80E-05,877154,0.989345815
30124,294,202,2,2,9.80E-05,877156,0.989348071
28739,414,103,2,2,9.80E-05,877158,0.989350327
28671,497,701,2,2,9.80E-05,877160,0.989352583
24988,246,121,2,2,9.80E-05,877162,0.989354839
27184,668,501,2,2,9.80E-05,877164,0.989357095
28723,32,319,2,2,9.80E-05,877166,0.98935935
24980,20,385,2,2,9.80E-05,877168,0.989361606
28710,124,264,2,2,9.80E-05,877170,0.989363862
24983,448,20,2,2,9.80E-05,877172,0.989366118
24985,587,310,2,2,9.80E-05,877174,0.989368374
28724,141,471,2,2,9.80E-05,877176,0.989370629
27178,353,624,2,2,9.80E-05,877178,0.989372885
24987,494,242,2,2,9.80E-05,877180,0.989375141
27177,30,409,2,2,9.80E-05,877182,0.989377397
30125,307,494,2,2,9.80E-05,877184,0.989379653
28706,19,655,2,2,9.80E-05,877186,0.989381908
32146,334,207,2,2,9.80E-05,877188,0.989384164
28700,170,302,2,2,9.80E-05,877190,0.98938642
24997,141,313,2,2,9.80E-05,877192,0.989388676
28697,50,181,2,2,9.80E-05,877194,0.989390932
30128,29,202,2,2,9.80E-05,877196,0.989393187
24999,624,155,2,2,9.80E-05,877198,0.989395443
25000,342,334,2,2,9.80E-05,877200,0.989397699
27196,514,560,2,2,9.80E-05,877202,0.989399955
32128,141,11,2,2,9.80E-05,877204,0.989402211
27214,117,2,2,2,9.80E-05,877206,0.989404467
32094,117,684,2,2,9.80E-05,877208,0.989406722
28766,492,163,2,2,9.80E-05,877210,0.989408978
28769,175,193,2,2,9.80E-05,877212,0.989411234
27207,141,528,2,2,9.80E-05,877214,0.98941349
32102,121,503,2,2,9.80E-05,877216,0.989415746
25058,163,126,2,2,9.80E-05,877218,0.989418001
25059,409,427,2,2,9.80E-05,877220,0.989420257
27209,397,181,2,2,9.80E-05,877222,0.989422513
32092,155,19,2,2,9.80E-05,877224,0.989424769
32104,160,124,2,2,9.80E-05,877226,0.989427025
28649,158,181,2,2,9.80E-05,877228,0.98942928
25068,528,25,2,2,9.80E-05,877230,0.989431536
27155,178,77,2,2,9.80E-05,877232,0.989433792
28781,5,569,2,2,9.80E-05,877234,0.989436048
32085,141,117,2,2,9.80E-05,877236,0.989438304
28782,560,394,2,2,9.80E-05,877238,0.989440559
28640,156,571,2,2,9.80E-05,877240,0.989442815
32082,525,178,2,2,9.80E-05,877242,0.989445071
30140,107,492,2,2,9.80E-05,877244,0.989447327
27197,562,493,2,2,9.80E-05,877246,0.989449583
27202,383,514,2,2,9.80E-05,877248,0.989451838
28669,265,652,2,2,9.80E-05,877250,0.989454094
25033,463,569,2,2,9.80E-05,877252,0.98945635
25034,43,178,2,2,9.80E-05,877254,0.989458606
27198,50,618,2,2,9.80E-05,877256,0.989460862
25036,640,673,2,2,9.80E-05,877258,0.989463118
28757,699,2,2,2,9.80E-05,877260,0.989465373
27199,145,4,2,2,9.80E-05,877262,0.989467629
27201,243,618,2,2,9.80E-05,877264,0.989469885
25039,224,137,2,2,9.80E-05,877266,0.989472141
28664,332,48,2,2,9.80E-05,877268,0.989474397
28660,458,398,2,2,9.80E-05,877270,0.989476652
28759,719,242,2,2,9.80E-05,877272,0.989478908
27203,103,508,2,2,9.80E-05,877274,0.989481164
25043,31,683,2,2,9.80E-05,877276,0.98948342
25044,475,514,2,2,9.80E-05,877278,0.989485676
25045,684,394,2,2,9.80E-05,877280,0.989487931
25046,353,494,2,2,9.80E-05,877282,0.989490187
27204,632,720,2,2,9.80E-05,877284,0.989492443
27164,535,207,2,2,9.80E-05,877286,0.989494699
28761,543,482,2,2,9.80E-05,877288,0.989496955
28561,33,160,2,2,9.80E-05,877290,0.98949921
25191,264,3,2,2,9.80E-05,877292,0.989501466
25192,482,236,2,2,9.80E-05,877294,0.989503722
28464,613,25,2,2,9.80E-05,877296,0.989505978
27082,84,571,2,2,9.80E-05,877298,0.989508234
25320,446,307,2,2,9.80E-05,877300,0.98951049
28468,22,269,2,2,9.80E-05,877302,0.989512745
25324,12,708,2,2,9.80E-05,877304,0.989515001
28465,202,529,2,2,9.80E-05,877306,0.989517257
25333,1,482,2,2,9.80E-05,877308,0.989519513
25334,242,246,2,2,9.80E-05,877310,0.989521769
25336,167,479,2,2,9.80E-05,877312,0.989524024
28469,588,492,2,2,9.80E-05,877314,0.98952628
25339,178,1,2,2,9.80E-05,877316,0.989528536
31858,140,207,2,2,9.80E-05,877318,0.989530792
30048,280,569,2,2,9.80E-05,877320,0.989533048
25344,50,543,2,2,9.80E-05,877322,0.989535303
25345,618,609,2,2,9.80E-05,877324,0.989537559
28457,140,23,2,2,9.80E-05,877326,0.989539815
28939,493,25,2,2,9.80E-05,877328,0.989542071
25317,398,632,2,2,9.80E-05,877330,0.989544327
27086,562,124,2,2,9.80E-05,877332,0.989546582
28453,123,525,2,2,9.80E-05,877334,0.989548838
28912,596,720,2,2,9.80E-05,877336,0.989551094
28896,587,558,2,2,9.80E-05,877338,0.98955335
25299,163,15,2,2,9.80E-05,877340,0.989555606
31904,33,19,2,2,9.80E-05,877342,0.989557861
28899,397,652,2,2,9.80E-05,877344,0.989560117
25303,367,332,2,2,9.80E-05,877346,0.989562373
28900,682,587,2,2,9.80E-05,877348,0.989564629
27273,689,684,2,2,9.80E-05,877350,0.989566885
28909,714,250,2,2,9.80E-05,877352,0.989569141
15408,414,141,2,2,9.80E-05,877354,0.989571396
25307,618,193,2,2,9.80E-05,877356,0.989573652
25308,719,107,2,2,9.80E-05,877358,0.989575908
25310,204,4,2,2,9.80E-05,877360,0.989578164
30195,568,655,2,2,9.80E-05,877362,0.98958042
31900,364,23,2,2,9.80E-05,877364,0.989582675
28921,568,498,2,2,9.80E-05,877366,0.989584931
25313,652,582,2,2,9.80E-05,877368,0.989587187
28476,193,54,2,2,9.80E-05,877370,0.989589443
27089,121,5,2,2,9.80E-05,877372,0.989591699
28475,130,19,2,2,9.80E-05,877374,0.989593954
28940,371,114,2,2,9.80E-05,877376,0.98959621
27125,126,230,2,2,9.80E-05,877378,0.989598466
25404,582,202,2,2,9.80E-05,877380,0.989600722
27076,313,371,2,2,9.80E-05,877382,0.989602978
25391,170,393,2,2,9.80E-05,877384,0.989605233
28431,414,508,2,2,9.80E-05,877386,0.989607489
28426,394,448,2,2,9.80E-05,877388,0.989609745
28971,202,95,2,2,9.80E-05,877390,0.989612001
25396,371,27,2,2,9.80E-05,877392,0.989614257
25397,703,314,2,2,9.80E-05,877394,0.989616513
28423,544,181,2,2,9.80E-05,877396,0.989618768
31810,525,25,2,2,9.80E-05,877398,0.989621024
15347,9,193,2,2,9.80E-05,877400,0.98962328
28975,699,50,2,2,9.80E-05,877402,0.989625536
31826,593,202,2,2,9.80E-05,877404,0.989627792
25405,398,508,2,2,9.80E-05,877406,0.989630047
27075,576,16,2,2,9.80E-05,877408,0.989632303
28420,433,31,2,2,9.80E-05,877410,0.989634559
28419,138,347,2,2,9.80E-05,877412,0.989636815
25406,364,528,2,2,9.80E-05,877414,0.989639071
28416,393,571,2,2,9.80E-05,877416,0.989641326
31794,507,12,2,2,9.80E-05,877418,0.989643582
25410,156,163,2,2,9.80E-05,877420,0.989645838
31821,517,43,2,2,9.80E-05,877422,0.989648094
31831,493,4,2,2,9.80E-05,877424,0.98965035
25356,652,27,2,2,9.80E-05,877426,0.989652605
31842,568,80,2,2,9.80E-05,877428,0.989654861
25358,145,103,2,2,9.80E-05,877430,0.989657117
28944,137,522,2,2,9.80E-05,877432,0.989659373
28187,1,673,2,2,9.80E-05,877434,0.989661629
25361,558,593,2,2,9.80E-05,877436,0.989663885
30047,703,80,2,2,9.80E-05,877438,0.98966614
27078,448,11,2,2,9.80E-05,877440,0.989668396
25363,204,269,2,2,9.80E-05,877442,0.989670652
28951,141,204,2,2,9.80E-05,877444,0.989672908
25368,479,319,2,2,9.80E-05,877446,0.989675164
25379,117,482,2,2,9.80E-05,877448,0.989677419
28956,562,261,2,2,9.80E-05,877450,0.989679675
25371,97,404,2,2,9.80E-05,877452,0.989681931
25372,131,124,2,2,9.80E-05,877454,0.989684187
28962,23,383,2,2,9.80E-05,877456,0.989686443
25373,552,193,2,2,9.80E-05,877458,0.989688698
28436,661,50,2,2,9.80E-05,877460,0.989690954
25375,155,1,2,2,9.80E-05,877462,0.98969321
31833,718,479,2,2,9.80E-05,877464,0.989695466
28435,124,26,2,2,9.80E-05,877466,0.989697722
28498,502,126,2,2,9.80E-05,877468,0.989699977
28499,367,458,2,2,9.80E-05,877470,0.989702233
27093,193,250,2,2,9.80E-05,877472,0.989704489
25230,80,668,2,2,9.80E-05,877474,0.989706745
25217,427,246,2,2,9.80E-05,877476,0.989709001
31979,626,2,2,2,9.80E-05,877478,0.989711256
28533,605,652,2,2,9.80E-05,877480,0.989713512
25222,178,295,2,2,9.80E-05,877482,0.989715768
25223,178,5,2,2,9.80E-05,877484,0.989718024
25226,482,114,2,2,9.80E-05,877486,0.98972028
27116,638,493,2,2,9.80E-05,877488,0.989722536
25229,145,294,2,2,9.80E-05,877490,0.989724791
27114,507,294,2,2,9.80E-05,877492,0.989727047
30079,497,137,2,2,9.80E-05,877494,0.989729303
31980,12,290,2,2,9.80E-05,877496,0.989731559
25234,5,141,2,2,9.80E-05,877498,0.989733815
30075,64,385,2,2,9.80E-05,877500,0.98973607
25235,605,511,2,2,9.80E-05,877502,0.989738326
27258,265,167,2,2,9.80E-05,877504,0.989740582
25236,11,525,2,2,9.80E-05,877506,0.989742838
28528,103,246,2,2,9.80E-05,877508,0.989745094
25238,719,307,2,2,9.80E-05,877510,0.989747349
28869,124,84,2,2,9.80E-05,877512,0.989749605
25243,250,90,2,2,9.80E-05,877514,0.989751861
27252,492,348,2,2,9.80E-05,877516,0.989754117
27250,427,4,2,2,9.80E-05,877518,0.989756373
32001,528,652,2,2,9.80E-05,877520,0.989758628
28844,167,398,2,2,9.80E-05,877522,0.989760884
27124,170,638,2,2,9.80E-05,877524,0.98976314
32004,124,22,2,2,9.80E-05,877526,0.989765396
28558,661,364,2,2,9.80E-05,877528,0.989767652
30176,121,497,2,2,9.80E-05,877530,0.989769908
25196,588,494,2,2,9.80E-05,877532,0.989772163
28556,493,640,2,2,9.80E-05,877534,0.989774419
27119,398,195,2,2,9.80E-05,877536,0.989776675
25200,507,64,2,2,9.80E-05,877538,0.989778931
25203,502,409,2,2,9.80E-05,877540,0.989781187
28854,473,160,2,2,9.80E-05,877542,0.989783442
25204,23,614,2,2,9.80E-05,877544,0.989785698
25205,163,528,2,2,9.80E-05,877546,0.989787954
31997,155,507,2,2,9.80E-05,877548,0.98979021
25212,117,196,2,2,9.80E-05,877550,0.989792466
28539,170,204,2,2,9.80E-05,877552,0.989794721
28538,64,443,2,2,9.80E-05,877554,0.989796977
28865,155,23,2,2,9.80E-05,877556,0.989799233
27113,493,33,2,2,9.80E-05,877558,0.989801489
30067,560,250,2,2,9.80E-05,877560,0.989803745
31949,141,332,2,2,9.80E-05,877562,0.989806
25286,31,448,2,2,9.80E-05,877564,0.989808256
25273,250,195,2,2,9.80E-05,877566,0.989810512
25274,439,29,2,2,9.80E-05,877568,0.989812768
27100,328,618,2,2,9.80E-05,877570,0.989815024
25278,493,269,2,2,9.80E-05,877572,0.989817279
27099,525,30,2,2,9.80E-05,877574,0.989819535
31924,367,137,2,2,9.80E-05,877576,0.989821791
30063,64,171,2,2,9.80E-05,877578,0.989824047
25281,294,302,2,2,9.80E-05,877580,0.989826303
25282,302,571,2,2,9.80E-05,877582,0.989828559
28878,126,48,2,2,9.80E-05,877584,0.989830814
31948,703,335,2,2,9.80E-05,877586,0.98983307
30061,269,674,2,2,9.80E-05,877588,0.989835326
25291,95,103,2,2,9.80E-05,877590,0.989837582
25292,16,160,2,2,9.80E-05,877592,0.989839838
28507,446,250,2,2,9.80E-05,877594,0.989842093
25295,394,23,2,2,9.80E-05,877596,0.989844349
28506,502,171,2,2,9.80E-05,877598,0.989846605
28885,558,446,2,2,9.80E-05,877600,0.989848861
27096,117,511,2,2,9.80E-05,877602,0.989851117
28886,328,178,2,2,9.80E-05,877604,0.989853372
25272,392,15,2,2,9.80E-05,877606,0.989855628
25270,609,20,2,2,9.80E-05,877608,0.989857884
27101,498,624,2,2,9.80E-05,877610,0.98986014
25269,15,446,2,2,9.80E-05,877612,0.989862396
27111,717,141,2,2,9.80E-05,877614,0.989864651
30183,568,347,2,2,9.80E-05,877616,0.989866907
31945,19,614,2,2,9.80E-05,877618,0.989869163
27109,371,427,2,2,9.80E-05,877620,0.989871419
30066,269,493,2,2,9.80E-05,877622,0.989873675
31939,174,19,2,2,9.80E-05,877624,0.989875931
27106,264,439,2,2,9.80E-05,877626,0.989878186
25256,560,380,2,2,9.80E-05,877628,0.989880442
31936,701,171,2,2,9.80E-05,877630,0.989882698
27105,175,379,2,2,9.80E-05,877632,0.989884954
28520,27,568,2,2,9.80E-05,877634,0.98988721
28877,503,471,2,2,9.80E-05,877636,0.989889465
27104,560,9,2,2,9.80E-05,877638,0.989891721
12538,605,158,2,2,9.80E-05,877640,0.989893977
31932,126,571,2,2,9.80E-05,877642,0.989896233
25263,673,493,2,2,9.80E-05,877644,0.989898489
28515,181,80,2,2,9.80E-05,877646,0.989900744
25266,158,207,2,2,9.80E-05,877648,0.989903
28514,334,493,2,2,9.80E-05,877650,0.989905256
25728,560,158,2,2,9.80E-05,877652,0.989907512
29975,605,383,2,2,9.80E-05,877654,0.989909768
26305,107,193,2,2,9.80E-05,877656,0.989912023
26283,397,155,2,2,9.80E-05,877658,0.989914279
31025,471,23,2,2,9.80E-05,877660,0.989916535
26286,379,133,2,2,9.80E-05,877662,0.989918791
27511,392,493,2,2,9.80E-05,877664,0.989921047
26699,684,48,2,2,9.80E-05,877666,0.989923303
29610,261,714,2,2,9.80E-05,877668,0.989925558
26698,332,204,2,2,9.80E-05,877670,0.989927814
31023,463,290,2,2,9.80E-05,877672,0.98993007
29614,175,689,2,2,9.80E-05,877674,0.989932326
26291,20,404,2,2,9.80E-05,877676,0.989934582
26292,14,661,2,2,9.80E-05,877678,0.989936837
27771,446,655,2,2,9.80E-05,877680,0.989939093
26294,174,398,2,2,9.80E-05,877682,0.989941349
29618,167,393,2,2,9.80E-05,877684,0.989943605
26696,385,661,2,2,9.80E-05,877686,0.989945861
31014,50,569,2,2,9.80E-05,877688,0.989948116
29625,84,448,2,2,9.80E-05,877690,0.989950372
26694,12,652,2,2,9.80E-05,877692,0.989952628
26301,193,207,2,2,9.80E-05,877694,0.989954884
26304,80,319,2,2,9.80E-05,877696,0.98995714
26282,174,25,2,2,9.80E-05,877698,0.989959395
31028,614,137,2,2,9.80E-05,877700,0.989961651
27783,97,155,2,2,9.80E-05,877702,0.989963907
29593,427,684,2,2,9.80E-05,877704,0.989966163
30594,646,34,2,2,9.80E-05,877706,0.989968419
30595,29,178,2,2,9.80E-05,877708,0.989970674
27804,107,178,2,2,9.80E-05,877710,0.98997293
31036,613,1,2,2,9.80E-05,877712,0.989975186
27803,311,458,2,2,9.80E-05,877714,0.989977442
30596,124,544,2,2,9.80E-05,877716,0.989979698
27800,471,193,2,2,9.80E-05,877718,0.989981954
31035,562,207,2,2,9.80E-05,877720,0.989984209
26270,528,689,2,2,9.80E-05,877722,0.989986465
31032,498,43,2,2,9.80E-05,877724,0.989988721
30598,568,543,2,2,9.80E-05,877726,0.989990977
27499,335,178,2,2,9.80E-05,877728,0.989993233
30599,15,494,2,2,9.80E-05,877730,0.989995488
29596,54,655,2,2,9.80E-05,877732,0.989997744
27791,195,385,2,2,9.80E-05,877734,0.99
27788,562,624,2,2,9.80E-05,877736,0.990002256
26275,427,1,2,2,9.80E-05,877738,0.990004512
26276,30,328,2,2,9.80E-05,877740,0.990006767
26277,473,19,2,2,9.80E-05,877742,0.990009023
26278,103,236,2,2,9.80E-05,877744,0.990011279
26280,77,433,2,2,9.80E-05,877746,0.990013535
27515,529,618,2,2,9.80E-05,877748,0.990015791
30627,230,202,2,2,9.80E-05,877750,0.990018046
31002,494,31,2,2,9.80E-05,877752,0.990020302
26341,502,30,2,2,9.80E-05,877754,0.990022558
27745,261,463,2,2,9.80E-05,877756,0.990024814
26345,140,511,2,2,9.80E-05,877758,0.99002707
26346,13,569,2,2,9.80E-05,877760,0.990029326
26351,246,502,2,2,9.80E-05,877762,0.990031581
26354,140,246,2,2,9.80E-05,877764,0.990033837
26355,265,503,2,2,9.80E-05,877766,0.990036093
27741,196,207,2,2,9.80E-05,877768,0.990038349
27740,264,269,2,2,9.80E-05,877770,0.990040605
29660,699,552,2,2,9.80E-05,877772,0.99004286
26364,593,171,2,2,9.80E-05,877774,0.990045116
30949,348,576,2,2,9.80E-05,877776,0.990047372
27524,632,178,2,2,9.80E-05,877778,0.990049628
13646,479,571,2,2,9.80E-05,877780,0.990051884
26369,443,1,2,2,9.80E-05,877782,0.990054139
26370,503,609,2,2,9.80E-05,877784,0.990056395
29661,433,219,2,2,9.80E-05,877786,0.990058651
29663,77,19,2,2,9.80E-05,877788,0.990060907
27731,571,314,2,2,9.80E-05,877790,0.990063163
27730,202,511,2,2,9.80E-05,877792,0.990065418
27728,522,342,2,2,9.80E-05,877794,0.990067674
26340,718,196,2,2,9.80E-05,877796,0.99006993
30975,463,371,2,2,9.80E-05,877798,0.990072186
30988,502,124,2,2,9.80E-05,877800,0.990074442
29633,342,16,2,2,9.80E-05,877802,0.990076697
26687,682,1,2,2,9.80E-05,877804,0.990078953
30997,328,371,2,2,9.80E-05,877806,0.990081209
27517,626,347,2,2,9.80E-05,877808,0.990083465
27519,683,295,2,2,9.80E-05,877810,0.990085721
27521,482,30,2,2,9.80E-05,877812,0.990087977
26320,158,684,2,2,9.80E-05,877814,0.990090232
30639,230,124,2,2,9.80E-05,877816,0.990092488
30989,354,668,2,2,9.80E-05,877818,0.990094744
27759,626,473,2,2,9.80E-05,877820,0.990097
27522,264,511,2,2,9.80E-05,877822,0.990099256
29637,131,493,2,2,9.80E-05,877824,0.990101511
26681,126,9,2,2,9.80E-05,877826,0.990103767
29639,427,613,2,2,9.80E-05,877828,0.990106023
26328,674,160,2,2,9.80E-05,877830,0.990108279
27523,54,280,2,2,9.80E-05,877832,0.990110535
26336,294,532,2,2,9.80E-05,877834,0.99011279
13700,4,158,2,2,9.80E-05,877836,0.990115046
26338,719,164,2,2,9.80E-05,877838,0.990117302
30652,398,371,2,2,9.80E-05,877840,0.990119558
29877,507,195,2,2,9.80E-05,877842,0.990121814
26264,334,661,2,2,9.80E-05,877844,0.990124069
27725,124,529,2,2,9.80E-05,877846,0.990126325
27845,334,652,2,2,9.80E-05,877848,0.990128581
31085,511,446,2,2,9.80E-05,877850,0.990130837
26188,242,364,2,2,9.80E-05,877852,0.990133093
26737,482,107,2,2,9.80E-05,877854,0.990135349
27843,492,265,2,2,9.80E-05,877856,0.990137604
31084,23,439,2,2,9.80E-05,877858,0.99013986
27840,439,34,2,2,9.80E-05,877860,0.990142116
31082,717,586,2,2,9.80E-05,877862,0.990144372
26194,236,178,2,2,9.80E-05,877864,0.990146628
26195,529,689,2,2,9.80E-05,877866,0.990148883
31081,269,347,2,2,9.80E-05,877868,0.990151139
30558,427,269,2,2,9.80E-05,877870,0.990153395
27838,290,427,2,2,9.80E-05,877872,0.990155651
27485,160,250,2,2,9.80E-05,877874,0.990157907
29555,181,97,2,2,9.80E-05,877876,0.990160162
29560,195,43,2,2,9.80E-05,877878,0.990162418
29563,29,502,2,2,9.80E-05,877880,0.990164674
26201,332,56,2,2,9.80E-05,877882,0.99016693
29566,463,294,2,2,9.80E-05,877884,0.990169186
27487,371,380,2,2,9.80E-05,877886,0.990171441
27489,202,588,2,2,9.80E-05,877888,0.990173697
27491,224,160,2,2,9.80E-05,877890,0.990175953
27846,90,397,2,2,9.80E-05,877892,0.990178209
29542,385,492,2,2,9.80E-05,877894,0.990180465
31086,683,15,2,2,9.80E-05,877896,0.990182721
27855,393,155,2,2,9.80E-05,877898,0.990184976
26160,717,471,2,2,9.80E-05,877900,0.990187232
27863,646,164,2,2,9.80E-05,877902,0.990189488
31113,107,699,2,2,9.80E-05,877904,0.990191744
30541,3,668,2,2,9.80E-05,877906,0.990194
31112,493,164,2,2,9.80E-05,877908,0.990196255
27861,107,319,2,2,9.80E-05,877910,0.990198511
26164,529,5,2,2,9.80E-05,877912,0.990200767
29537,409,502,2,2,9.80E-05,877914,0.990203023
27857,80,160,2,2,9.80E-05,877916,0.990205279
31111,202,544,2,2,9.80E-05,877918,0.990207534
26747,348,269,2,2,9.80E-05,877920,0.99020979
27851,497,90,2,2,9.80E-05,877922,0.990212046
29887,103,171,2,2,9.80E-05,877924,0.990214302
27482,414,163,2,2,9.80E-05,877926,0.990216558
31109,482,274,2,2,9.80E-05,877928,0.990218813
26174,64,4,2,2,9.80E-05,877930,0.990221069
26745,721,475,2,2,9.80E-05,877932,0.990223325
26179,29,535,2,2,9.80E-05,877934,0.990225581
26740,19,141,2,2,9.80E-05,877936,0.990227837
26181,544,414,2,2,9.80E-05,877938,0.990230092
27829,568,558,2,2,9.80E-05,877940,0.990232348
26206,207,5,2,2,9.80E-05,877942,0.990234604
27805,347,207,2,2,9.80E-05,877944,0.99023686
26207,624,181,2,2,9.80E-05,877946,0.990239116
31053,409,663,2,2,9.80E-05,877948,0.990241372
31051,54,156,2,2,9.80E-05,877950,0.990243627
31049,525,618,2,2,9.80E-05,877952,0.990245883
31046,571,295,2,2,9.80E-05,877954,0.990248139
29878,175,26,2,2,9.80E-05,877956,0.990250395
31041,482,609,2,2,9.80E-05,877958,0.990252651
27815,498,684,2,2,9.80E-05,877960,0.990254906
27494,503,646,2,2,9.80E-05,877962,0.990257162
29579,145,160,2,2,9.80E-05,877964,0.990259418
26253,170,11,2,2,9.80E-05,877966,0.990261674
27813,439,167,2,2,9.80E-05,877968,0.99026393
26256,497,207,2,2,9.80E-05,877970,0.990266185
27495,646,15,2,2,9.80E-05,877972,0.990268441
26717,19,552,2,2,9.80E-05,877974,0.990270697
31039,207,569,2,2,9.80E-05,877976,0.990272953
29580,5,626,2,2,9.80E-05,877978,0.990275209
26259,528,427,2,2,9.80E-05,877980,0.990277464
27496,668,250,2,2,9.80E-05,877982,0.99027972
31037,721,160,2,2,9.80E-05,877984,0.990281976
27809,433,80,2,2,9.80E-05,877986,0.990284232
29582,458,117,2,2,9.80E-05,877988,0.990286488
27807,661,497,2,2,9.80E-05,877990,0.990288744
26242,473,43,2,2,9.80E-05,877992,0.990290999
29576,5,720,2,2,9.80E-05,877994,0.990293255
13203,609,264,2,2,9.80E-05,877996,0.990295511
26733,328,155,2,2,9.80E-05,877998,0.990297767
26209,593,167,2,2,9.80E-05,878000,0.990300023
26210,626,32,2,2,9.80E-05,878002,0.990302278
26211,723,32,2,2,9.80E-05,878004,0.990304534
27826,50,552,2,2,9.80E-05,878006,0.99030679
26215,493,141,2,2,9.80E-05,878008,0.990309046
26218,640,701,2,2,9.80E-05,878010,0.990311302
27825,219,448,2,2,9.80E-05,878012,0.990313557
30561,720,618,2,2,9.80E-05,878014,0.990315813
26236,439,503,2,2,9.80E-05,878016,0.990318069
29574,433,313,2,2,9.80E-05,878018,0.990320325
30563,13,385,2,2,9.80E-05,878020,0.990322581
26224,264,463,2,2,9.80E-05,878022,0.990324836
26226,167,5,2,2,9.80E-05,878024,0.990327092
26230,348,593,2,2,9.80E-05,878026,0.990329348
26231,720,15,2,2,9.80E-05,878028,0.990331604
30564,6,494,2,2,9.80E-05,878030,0.99033386
31064,30,719,2,2,9.80E-05,878032,0.990336115
31063,646,587,2,2,9.80E-05,878034,0.990338371
27821,163,196,2,2,9.80E-05,878036,0.990340627
27727,560,236,2,2,9.80E-05,878038,0.990342883
29855,64,511,2,2,9.80E-05,878040,0.990345139
28186,683,307,2,2,9.80E-05,878042,0.990347395
26572,593,246,2,2,9.80E-05,878044,0.99034965
30762,640,90,2,2,9.80E-05,878046,0.990351906
29823,560,498,2,2,9.80E-05,878048,0.990354162
29757,121,158,2,2,9.80E-05,878050,0.990356418
27633,5,501,2,2,9.80E-05,878052,0.990358674
27565,392,427,2,2,9.80E-05,878054,0.990360929
26548,34,569,2,2,9.80E-05,878056,0.990363185
26549,12,618,2,2,9.80E-05,878058,0.990365441
26551,202,640,2,2,9.80E-05,878060,0.990367697
30759,23,107,2,2,9.80E-05,878062,0.990369953
26554,23,335,2,2,9.80E-05,878064,0.990372208
26556,164,64,2,2,9.80E-05,878066,0.990374464
30757,243,103,2,2,9.80E-05,878068,0.99037672
29760,492,33,2,2,9.80E-05,878070,0.990378976
27631,448,674,2,2,9.80E-05,878072,0.990381232
30753,475,43,2,2,9.80E-05,878074,0.990383487
27568,393,103,2,2,9.80E-05,878076,0.990385743
29764,19,107,2,2,9.80E-05,878078,0.990387999
27626,528,409,2,2,9.80E-05,878080,0.990390255
30670,511,392,2,2,9.80E-05,878082,0.990392511
26565,170,14,2,2,9.80E-05,878084,0.990394767
26651,492,50,2,2,9.80E-05,878086,0.990397022
26569,15,714,2,2,9.80E-05,878088,0.990399278
27636,80,458,2,2,9.80E-05,878090,0.990401534
29740,2,23,2,2,9.80E-05,878092,0.99040379
30800,492,196,2,2,9.80E-05,878094,0.990406046
26513,242,133,2,2,9.80E-05,878096,0.990408301
30665,354,684,2,2,9.80E-05,878098,0.990410557
30667,207,364,2,2,9.80E-05,878100,0.990412813
30790,158,90,2,2,9.80E-05,878102,0.990415069
30788,560,596,2,2,9.80E-05,878104,0.990417325
26524,178,535,2,2,9.80E-05,878106,0.99041958
29738,3,90,2,2,9.80E-05,878108,0.990421836
29826,25,54,2,2,9.80E-05,878110,0.990424092
29825,43,13,2,2,9.80E-05,878112,0.990426348
30781,31,482,2,2,9.80E-05,878114,0.990428604
30669,364,171,2,2,9.80E-05,878116,0.990430859
27645,543,528,2,2,9.80E-05,878118,0.990433115
29744,121,90,2,2,9.80E-05,878120,0.990435371
27641,385,167,2,2,9.80E-05,878122,0.990437627
30773,219,133,2,2,9.80E-05,878124,0.990439883
27639,463,576,2,2,9.80E-05,878126,0.990442139
26537,280,721,2,2,9.80E-05,878128,0.990444394
26542,50,167,2,2,9.80E-05,878130,0.99044665
26544,20,23,2,2,9.80E-05,878132,0.990448906
30751,31,23,2,2,9.80E-05,878134,0.990451162
27625,409,414,2,2,9.80E-05,878136,0.990453418
29726,383,652,2,2,9.80E-05,878138,0.990455673
27622,25,618,2,2,9.80E-05,878140,0.990457929
27601,174,609,2,2,9.80E-05,878142,0.990460185
29785,364,126,2,2,9.80E-05,878144,0.990462441
27573,178,379,2,2,9.80E-05,878146,0.990464697
27596,56,23,2,2,9.80E-05,878148,0.990466952
27594,202,655,2,2,9.80E-05,878150,0.990469208
26635,141,385,2,2,9.80E-05,878152,0.990471464
30703,204,392,2,2,9.80E-05,878154,0.99047372
29813,347,493,2,2,9.80E-05,878156,0.990475976
30702,701,614,2,2,9.80E-05,878158,0.990478231
30686,703,224,2,2,9.80E-05,878160,0.990480487
26619,717,29,2,2,9.80E-05,878162,0.990482743
30698,236,720,2,2,9.80E-05,878164,0.990484999
26629,332,117,2,2,9.80E-05,878166,0.990487255
29801,609,138,2,2,9.80E-05,878168,0.99048951
29808,19,544,2,2,9.80E-05,878170,0.990491766
30696,475,684,2,2,9.80E-05,878172,0.990494022
26623,668,605,2,2,9.80E-05,878174,0.990496278
27579,514,552,2,2,9.80E-05,878176,0.990498534
27586,717,97,2,2,9.80E-05,878178,0.99050079
27585,508,314,2,2,9.80E-05,878180,0.990503045
29802,398,13,2,2,9.80E-05,878182,0.990505301
27582,718,27,2,2,9.80E-05,878184,0.990507557
27580,23,511,2,2,9.80E-05,878186,0.990509813
29784,587,167,2,2,9.80E-05,878188,0.990512069
26638,409,121,2,2,9.80E-05,878190,0.990514324
26607,562,569,2,2,9.80E-05,878192,0.99051658
27621,64,544,2,2,9.80E-05,878194,0.990518836
29771,13,19,2,2,9.80E-05,878196,0.990521092
30671,97,269,2,2,9.80E-05,878198,0.990523348
26644,458,264,2,2,9.80E-05,878200,0.990525603
26576,130,525,2,2,9.80E-05,878202,0.990527859
27618,155,48,2,2,9.80E-05,878204,0.990530115
26579,652,689,2,2,9.80E-05,878206,0.990532371
30746,290,618,2,2,9.80E-05,878208,0.990534627
27616,347,178,2,2,9.80E-05,878210,0.990536882
27571,204,576,2,2,9.80E-05,878212,0.990539138
27615,54,443,2,2,9.80E-05,878214,0.990541394
27604,141,307,2,2,9.80E-05,878216,0.99054365
27609,646,501,2,2,9.80E-05,878218,0.990545906
29780,23,250,2,2,9.80E-05,878220,0.990548162
26595,164,587,2,2,9.80E-05,878222,0.990550417
26598,446,29,2,2,9.80E-05,878224,0.990552673
26599,31,514,2,2,9.80E-05,878226,0.990554929
27607,558,133,2,2,9.80E-05,878228,0.990557185
26601,105,433,2,2,9.80E-05,878230,0.990559441
27606,458,11,2,2,9.80E-05,878232,0.990561696
27572,54,328,2,2,9.80E-05,878234,0.990563952
27655,158,482,2,2,9.80E-05,878236,0.990566208
29723,552,269,2,2,9.80E-05,878238,0.990568464
30947,178,193,2,2,9.80E-05,878240,0.99057072
29689,721,638,2,2,9.80E-05,878242,0.990572975
26409,543,571,2,2,9.80E-05,878244,0.990575231
26410,26,525,2,2,9.80E-05,878246,0.990577487
26411,265,409,2,2,9.80E-05,878248,0.990579743
26414,123,160,2,2,9.80E-05,878250,0.990581999
27710,409,32,2,2,9.80E-05,878252,0.990584254
30905,663,458,2,2,9.80E-05,878254,0.99058651
27709,364,121,2,2,9.80E-05,878256,0.990588766
26420,77,458,2,2,9.80E-05,878258,0.990591022
27708,458,475,2,2,9.80E-05,878260,0.990593278
26421,528,22,2,2,9.80E-05,878262,0.990595533
26425,14,175,2,2,9.80E-05,878264,0.990597789
27707,178,167,2,2,9.80E-05,878266,0.990600045
27703,204,528,2,2,9.80E-05,878268,0.990602301
13496,133,560,2,2,9.80E-05,878270,0.990604557
26433,371,236,2,2,9.80E-05,878272,0.990606813
29680,571,195,2,2,9.80E-05,878274,0.990609068
30881,126,508,2,2,9.80E-05,878276,0.990611324
29682,535,332,2,2,9.80E-05,878278,0.99061358
26439,525,640,2,2,9.80E-05,878280,0.990615836
13482,196,543,2,2,9.80E-05,878282,0.990618092
30655,364,193,2,2,9.80E-05,878284,0.990620347
26408,494,121,2,2,9.80E-05,878286,0.990622603
27536,380,433,2,2,9.80E-05,878288,0.990624859
27712,392,204,2,2,9.80E-05,878290,0.990627115
26390,196,202,2,2,9.80E-05,878292,0.990629371
27526,614,409,2,2,9.80E-05,878294,0.990631626
27721,15,392,2,2,9.80E-05,878296,0.990633882
26378,482,50,2,2,9.80E-05,878298,0.990636138
27720,624,130,2,2,9.80E-05,878300,0.990638394
27527,497,64,2,2,9.80E-05,878302,0.99064065
29678,535,178,2,2,9.80E-05,878304,0.990642905
26386,328,701,2,2,9.80E-05,878306,0.990645161
26671,703,348,2,2,9.80E-05,878308,0.990647417
13605,409,9,2,2,9.80E-05,878310,0.990649673
27715,717,107,2,2,9.80E-05,878312,0.990651929
26392,178,393,2,2,9.80E-05,878314,0.990654185
26393,90,525,2,2,9.80E-05,878316,0.99065644
29850,528,163,2,2,9.80E-05,878318,0.990658696
27714,661,689,2,2,9.80E-05,878320,0.990660952
26398,56,682,2,2,9.80E-05,878322,0.990663208
27533,414,661,2,2,9.80E-05,878324,0.990665464
26400,117,163,2,2,9.80E-05,878326,0.990667719
26405,492,364,2,2,9.80E-05,878328,0.990669975
26406,13,652,2,2,9.80E-05,878330,0.990672231
27697,661,280,2,2,9.80E-05,878332,0.990674487
29691,683,20,2,2,9.80E-05,878334,0.990676743
29833,97,342,2,2,9.80E-05,878336,0.990678998
27544,156,714,2,2,9.80E-05,878338,0.990681254
27668,207,246,2,2,9.80E-05,878340,0.99068351
27667,167,689,2,2,9.80E-05,878342,0.990685766
26659,295,701,2,2,9.80E-05,878344,0.990688022
29720,502,332,2,2,9.80E-05,878346,0.990690277
27664,164,414,2,2,9.80E-05,878348,0.990692533
27549,155,50,2,2,9.80E-05,878350,0.990694789
26484,140,22,2,2,9.80E-05,878352,0.990697045
26486,310,525,2,2,9.80E-05,878354,0.990699301
26487,158,593,2,2,9.80E-05,878356,0.990701557
29834,493,145,2,2,9.80E-05,878358,0.990703812
30824,34,720,2,2,9.80E-05,878360,0.990706068
26493,721,689,2,2,9.80E-05,878362,0.990708324
30821,328,571,2,2,9.80E-05,878364,0.99071058
30819,446,117,2,2,9.80E-05,878366,0.990712836
27662,497,160,2,2,9.80E-05,878368,0.990715091
30818,23,544,2,2,9.80E-05,878370,0.990717347
30814,243,720,2,2,9.80E-05,878372,0.990719603
30812,427,319,2,2,9.80E-05,878374,0.990721859
30811,261,511,2,2,9.80E-05,878376,0.990724115
26504,196,290,2,2,9.80E-05,878378,0.99072637
27673,155,84,2,2,9.80E-05,878380,0.990728626
26478,5,507,2,2,9.80E-05,878382,0.990730882
30831,2,290,2,2,9.80E-05,878384,0.990733138
26464,507,4,2,2,9.80E-05,878386,0.990735394
26449,448,204,2,2,9.80E-05,878388,0.990737649
26453,613,295,2,2,9.80E-05,878390,0.990739905
30857,11,342,2,2,9.80E-05,878392,0.990742161
26458,334,164,2,2,9.80E-05,878394,0.990744417
27693,398,383,2,2,9.80E-05,878396,0.990746673
26459,84,525,2,2,9.80E-05,878398,0.990748928
26460,720,353,2,2,9.80E-05,878400,0.990751184
29695,613,156,2,2,9.80E-05,878402,0.99075344
26462,164,195,2,2,9.80E-05,878404,0.990755696
26463,170,334,2,2,9.80E-05,878406,0.990757952
29700,20,719,2,2,9.80E-05,878408,0.990760208
27542,674,202,2,2,9.80E-05,878410,0.990762463
30851,167,529,2,2,9.80E-05,878412,0.990764719
29703,492,587,2,2,9.80E-05,878414,0.990766975
27682,587,498,2,2,9.80E-05,878416,0.990769231
26663,269,385,2,2,9.80E-05,878418,0.990771487
30848,568,640,2,2,9.80E-05,878420,0.990773742
30847,701,353,2,2,9.80E-05,878422,0.990775998
26471,588,433,2,2,9.80E-05,878424,0.990778254
26474,48,269,2,2,9.80E-05,878426,0.99078051
30833,175,307,2,2,9.80E-05,878428,0.990782766
27676,204,202,2,2,9.80E-05,878430,0.990785021
31116,31,124,2,2,9.80E-05,878432,0.990787277
29888,699,529,2,2,9.80E-05,878434,0.990789533
28085,720,34,2,2,9.80E-05,878436,0.990791789
25867,264,31,2,2,9.80E-05,878438,0.990794045
25869,31,714,2,2,9.80E-05,878440,0.9907963
28102,170,640,2,2,9.80E-05,878442,0.990798556
25875,507,502,2,2,9.80E-05,878444,0.990800812
26860,170,511,2,2,9.80E-05,878446,0.990803068
27406,492,6,2,2,9.80E-05,878448,0.990805324
31370,458,29,2,2,9.80E-05,878450,0.99080758
31368,2,269,2,2,9.80E-05,878452,0.990809835
20613,393,163,2,2,9.80E-05,878454,0.990812091
25880,661,15,2,2,9.80E-05,878456,0.990814347
26858,97,12,2,2,9.80E-05,878458,0.990816603
28099,50,274,2,2,9.80E-05,878460,0.990818859
29304,124,265,2,2,9.80E-05,878462,0.990821114
25883,613,475,2,2,9.80E-05,878464,0.99082337
29939,145,261,2,2,9.80E-05,878466,0.990825626
28090,310,720,2,2,9.80E-05,878468,0.990827882
28089,121,348,2,2,9.80E-05,878470,0.990830138
25890,202,443,2,2,9.80E-05,878472,0.990832393
28086,684,689,2,2,9.80E-05,878474,0.990834649
14560,586,246,2,2,9.80E-05,878476,0.990836905
25893,163,95,2,2,9.80E-05,878478,0.990839161
30437,5,12,2,2,9.80E-05,878480,0.990841417
27404,246,439,2,2,9.80E-05,878482,0.990843672
25854,175,9,2,2,9.80E-05,878484,0.990845928
25847,535,133,2,2,9.80E-05,878486,0.990848184
28119,310,133,2,2,9.80E-05,878488,0.99085044
28118,11,175,2,2,9.80E-05,878490,0.990852696
25849,90,443,2,2,9.80E-05,878492,0.990854952
31407,503,174,2,2,9.80E-05,878494,0.990857207
26873,250,661,2,2,9.80E-05,878496,0.990859463
29944,90,507,2,2,9.80E-05,878498,0.990861719
29287,640,593,2,2,9.80E-05,878500,0.990863975
29943,479,492,2,2,9.80E-05,878502,0.990866231
25853,482,158,2,2,9.80E-05,878504,0.990868486
28111,718,5,2,2,9.80E-05,878506,0.990870742
27403,131,43,2,2,9.80E-05,878508,0.990872998
28110,294,64,2,2,9.80E-05,878510,0.990875254
27401,121,397,2,2,9.80E-05,878512,0.99087751
25859,117,85,2,2,9.80E-05,878514,0.990879765
30420,155,264,2,2,9.80E-05,878516,0.990882021
29296,720,175,2,2,9.80E-05,878518,0.990884277
25860,48,409,2,2,9.80E-05,878520,0.990886533
25861,394,571,2,2,9.80E-05,878522,0.990888789
31400,587,448,2,2,9.80E-05,878524,0.990891044
31350,117,613,2,2,9.80E-05,878526,0.9908933
29319,117,43,2,2,9.80E-05,878528,0.990895556
25845,532,178,2,2,9.80E-05,878530,0.990897812
26835,280,103,2,2,9.80E-05,878532,0.990900068
31335,103,448,2,2,9.80E-05,878534,0.990902323
28059,560,463,2,2,9.80E-05,878536,0.990904579
31330,23,347,2,2,9.80E-05,878538,0.990906835
29928,195,497,2,2,9.80E-05,878540,0.990909091
30475,19,250,2,2,9.80E-05,878542,0.990911347
29927,54,204,2,2,9.80E-05,878544,0.990913603
28053,409,714,2,2,9.80E-05,878546,0.990915858
25929,383,2,2,2,9.80E-05,878548,0.990918114
28049,497,673,2,2,9.80E-05,878550,0.99092037
31323,587,313,2,2,9.80E-05,878552,0.990922626
26829,126,310,2,2,9.80E-05,878554,0.990924882
28048,178,331,2,2,9.80E-05,878556,0.990927137
11744,640,535,2,2,9.80E-05,878558,0.990929393
26828,394,138,2,2,9.80E-05,878560,0.990931649
26826,264,126,2,2,9.80E-05,878562,0.990933905
25938,171,181,2,2,9.80E-05,878564,0.990936161
30481,163,632,2,2,9.80E-05,878566,0.990938416
25942,170,508,2,2,9.80E-05,878568,0.990940672
30472,508,558,2,2,9.80E-05,878570,0.990942928
25917,348,202,2,2,9.80E-05,878572,0.990945184
25916,158,85,2,2,9.80E-05,878574,0.99094744
28071,16,494,2,2,9.80E-05,878576,0.990949695
28077,29,156,2,2,9.80E-05,878578,0.990951951
27409,294,624,2,2,9.80E-05,878580,0.990954207
30459,54,274,2,2,9.80E-05,878582,0.990956463
25899,105,720,2,2,9.80E-05,878584,0.990958719
25901,25,593,2,2,9.80E-05,878586,0.990960975
30460,342,414,2,2,9.80E-05,878588,0.99096323
25904,207,502,2,2,9.80E-05,878590,0.990965486
28073,614,701,2,2,9.80E-05,878592,0.990967742
27414,332,605,2,2,9.80E-05,878594,0.990969998
26838,661,207,2,2,9.80E-05,878596,0.990972254
27415,493,514,2,2,9.80E-05,878598,0.990974509
28068,525,274,2,2,9.80E-05,878600,0.990976765
27416,156,207,2,2,9.80E-05,878602,0.990979021
29932,178,130,2,2,9.80E-05,878604,0.990981277
29329,145,163,2,2,9.80E-05,878606,0.990983533
25915,23,170,2,2,9.80E-05,878608,0.990985788
27419,64,655,2,2,9.80E-05,878610,0.990988044
29931,95,342,2,2,9.80E-05,878612,0.9909903
28063,522,492,2,2,9.80E-05,878614,0.990992556
25846,720,97,2,2,9.80E-05,878616,0.990994812
29945,15,43,2,2,9.80E-05,878618,0.990997067
27476,646,30,2,2,9.80E-05,878620,0.990999323
26896,720,167,2,2,9.80E-05,878622,0.991001579
29971,103,141,2,2,9.80E-05,878624,0.991003835
25764,219,571,2,2,9.80E-05,878626,0.991006091
11538,493,314,2,2,9.80E-05,878628,0.991008346
28165,30,12,2,2,9.80E-05,878630,0.991010602
26911,593,543,2,2,9.80E-05,878632,0.991012858
25774,652,354,2,2,9.80E-05,878634,0.991015114
25775,507,544,2,2,9.80E-05,878636,0.99101737
31501,626,50,2,2,9.80E-05,878638,0.991019626
29242,140,295,2,2,9.80E-05,878640,0.991021881
29969,170,497,2,2,9.80E-05,878642,0.991024137
25778,68,138,2,2,9.80E-05,878644,0.991026393
26908,164,117,2,2,9.80E-05,878646,0.991028649
27375,264,30,2,2,9.80E-05,878648,0.991030905
25782,171,56,2,2,9.80E-05,878650,0.99103316
26901,54,64,2,2,9.80E-05,878652,0.991035416
29245,25,193,2,2,9.80E-05,878654,0.991037672
28157,219,181,2,2,9.80E-05,878656,0.991039928
29968,529,701,2,2,9.80E-05,878658,0.991042184
14648,4,25,2,2,9.80E-05,878660,0.991044439
27381,5,682,2,2,9.80E-05,878662,0.991046695
29237,224,719,2,2,9.80E-05,878664,0.991048951
31510,479,699,2,2,9.80E-05,878666,0.991051207
28179,514,207,2,2,9.80E-05,878668,0.991053463
31530,562,202,2,2,9.80E-05,878670,0.991055718
25737,522,684,2,2,9.80E-05,878672,0.991057974
29225,544,605,2,2,9.80E-05,878674,0.99106023
28181,328,133,2,2,9.80E-05,878676,0.991062486
25738,668,562,2,2,9.80E-05,878678,0.991064742
31525,1,593,2,2,9.80E-05,878680,0.991066998
28180,1,613,2,2,9.80E-05,878682,0.991069253
25742,174,448,2,2,9.80E-05,878684,0.991071509
25745,699,586,2,2,9.80E-05,878686,0.991073765
25747,717,479,2,2,9.80E-05,878688,0.991076021
27369,502,12,2,2,9.80E-05,878690,0.991078277
30354,719,117,2,2,9.80E-05,878692,0.991080532
25748,19,84,2,2,9.80E-05,878694,0.991082788
25749,23,471,2,2,9.80E-05,878696,0.991085044
31522,328,458,2,2,9.80E-05,878698,0.9910873
29232,167,471,2,2,9.80E-05,878700,0.991089556
31520,85,471,2,2,9.80E-05,878702,0.991091811
25754,80,624,2,2,9.80E-05,878704,0.991094067
31515,364,290,2,2,9.80E-05,878706,0.991096323
25756,463,492,2,2,9.80E-05,878708,0.991098579
28174,511,605,2,2,9.80E-05,878710,0.991100835
30695,54,250,2,2,9.80E-05,878712,0.99110309
25793,332,33,2,2,9.80E-05,878714,0.991105346
31416,155,4,2,2,9.80E-05,878716,0.991107602
29249,718,448,2,2,9.80E-05,878718,0.991109858
25820,10,319,2,2,9.80E-05,878720,0.991112114
28141,576,26,2,2,9.80E-05,878722,0.99111437
31443,684,20,2,2,9.80E-05,878724,0.991116625
27388,511,661,2,2,9.80E-05,878726,0.991118881
30406,717,609,2,2,9.80E-05,878728,0.991121137
29266,501,626,2,2,9.80E-05,878730,0.991123393
25825,587,517,2,2,9.80E-05,878732,0.991125649
12986,458,313,2,2,9.80E-05,878734,0.991127904
28130,682,332,2,2,9.80E-05,878736,0.99113016
31436,250,525,2,2,9.80E-05,878738,0.991132416
29271,427,392,2,2,9.80E-05,878740,0.991134672
25832,10,492,2,2,9.80E-05,878742,0.991136928
26879,156,427,2,2,9.80E-05,878744,0.991139183
31422,22,392,2,2,9.80E-05,878746,0.991141439
29951,517,181,2,2,9.80E-05,878748,0.991143695
27394,294,313,2,2,9.80E-05,878750,0.991145951
25840,22,587,2,2,9.80E-05,878752,0.991148207
30416,443,290,2,2,9.80E-05,878754,0.991150462
27397,708,140,2,2,9.80E-05,878756,0.991152718
28121,494,196,2,2,9.80E-05,878758,0.991154974
26885,528,593,2,2,9.80E-05,878760,0.99115723
29259,404,673,2,2,9.80E-05,878762,0.991159486
31476,124,4,2,2,9.80E-05,878764,0.991161741
28148,246,652,2,2,9.80E-05,878766,0.991163997
28147,471,720,2,2,9.80E-05,878768,0.991166253
25797,145,12,2,2,9.80E-05,878770,0.991168509
14636,646,243,2,2,9.80E-05,878772,0.991170765
28146,714,522,2,2,9.80E-05,878774,0.991173021
26893,397,193,2,2,9.80E-05,878776,0.991175276
29964,714,682,2,2,9.80E-05,878778,0.991177532
29257,502,174,2,2,9.80E-05,878780,0.991179788
30400,427,167,2,2,9.80E-05,878782,0.991182044
25801,699,663,2,2,9.80E-05,878784,0.9911843
28144,219,124,2,2,9.80E-05,878786,0.991186555
25816,246,347,2,2,9.80E-05,878788,0.991188811
30403,473,699,2,2,9.80E-05,878790,0.991191067
31475,348,525,2,2,9.80E-05,878792,0.991193323
25805,163,31,2,2,9.80E-05,878794,0.991195579
27385,443,181,2,2,9.80E-05,878796,0.991197834
31461,364,508,2,2,9.80E-05,878798,0.99120009
25810,721,328,2,2,9.80E-05,878800,0.991202346
31453,593,64,2,2,9.80E-05,878802,0.991204602
31450,517,720,2,2,9.80E-05,878804,0.991206858
28143,77,124,2,2,9.80E-05,878806,0.991209113
25814,1,246,2,2,9.80E-05,878808,0.991211369
29924,632,85,2,2,9.80E-05,878810,0.991213625
26817,274,290,2,2,9.80E-05,878812,0.991215881
27918,331,458,2,2,9.80E-05,878814,0.991218137
30530,50,503,2,2,9.80E-05,878816,0.991220393
27944,514,54,2,2,9.80E-05,878818,0.991222648
26068,593,20,2,2,9.80E-05,878820,0.991224904
26069,16,124,2,2,9.80E-05,878822,0.99122716
26772,124,25,2,2,9.80E-05,878824,0.991229416
26770,219,720,2,2,9.80E-05,878826,0.991231672
29461,32,160,2,2,9.80E-05,878828,0.991233927
14133,689,121,2,2,9.80E-05,878830,0.991236183
27461,503,514,2,2,9.80E-05,878832,0.991238439
31180,2,668,2,2,9.80E-05,878834,0.991240695
29462,544,482,2,2,9.80E-05,878836,0.991242951
27932,90,158,2,2,9.80E-05,878838,0.991245206
27928,257,250,2,2,9.80E-05,878840,0.991247462
27921,409,475,2,2,9.80E-05,878842,0.991249718
26078,307,571,2,2,9.80E-05,878844,0.991251974
26080,25,133,2,2,9.80E-05,878846,0.99125423
29899,508,532,2,2,9.80E-05,878848,0.991256485
29896,261,196,2,2,9.80E-05,878850,0.991258741
26767,202,195,2,2,9.80E-05,878852,0.991260997
26086,626,219,2,2,9.80E-05,878854,0.991263253
31190,167,334,2,2,9.80E-05,878856,0.991265509
26064,458,114,2,2,9.80E-05,878858,0.991267764
26063,525,501,2,2,9.80E-05,878860,0.99127002
27959,202,156,2,2,9.80E-05,878862,0.991272276
26038,571,479,2,2,9.80E-05,878864,0.991274532
27455,720,243,2,2,9.80E-05,878866,0.991276788
30526,609,290,2,2,9.80E-05,878868,0.991279044
27456,501,624,2,2,9.80E-05,878870,0.991281299
31208,494,543,2,2,9.80E-05,878872,0.991283555
26048,525,34,2,2,9.80E-05,878874,0.991285811
31202,717,328,2,2,9.80E-05,878876,0.991288067
27960,558,701,2,2,9.80E-05,878878,0.991290323
31200,605,673,2,2,9.80E-05,878880,0.991292578
27958,22,494,2,2,9.80E-05,878882,0.991294834
12071,246,80,2,2,9.80E-05,878884,0.99129709
26054,123,433,2,2,9.80E-05,878886,0.991299346
14163,446,80,2,2,9.80E-05,878888,0.991301602
27957,522,43,2,2,9.80E-05,878890,0.991303857
27181,311,684,2,2,9.80E-05,878892,0.991306113
27956,80,19,2,2,9.80E-05,878894,0.991308369
31192,22,202,2,2,9.80E-05,878896,0.991310625
27954,155,385,2,2,9.80E-05,878898,0.991312881
26774,14,503,2,2,9.80E-05,878900,0.991315136
26062,501,29,2,2,9.80E-05,878902,0.991317392
27464,439,1,2,2,9.80E-05,878904,0.991319648
28041,409,2,2,2,9.80E-05,878906,0.991321904
29481,663,342,2,2,9.80E-05,878908,0.99132416
26127,588,576,2,2,9.80E-05,878910,0.991326416
26128,682,54,2,2,9.80E-05,878912,0.991328671
30538,529,13,2,2,9.80E-05,878914,0.991330927
26130,334,155,2,2,9.80E-05,878916,0.991333183
27885,141,646,2,2,9.80E-05,878918,0.991335439
29520,117,261,2,2,9.80E-05,878920,0.991337695
14027,683,331,2,2,9.80E-05,878922,0.99133995
12085,4,141,2,2,9.80E-05,878924,0.991342206
27880,328,193,2,2,9.80E-05,878926,0.991344462
29523,155,587,2,2,9.80E-05,878928,0.991346718
31125,614,525,2,2,9.80E-05,878930,0.991348974
29890,236,319,2,2,9.80E-05,878932,0.991351229
26754,29,562,2,2,9.80E-05,878934,0.991353485
27475,155,398,2,2,9.80E-05,878936,0.991355741
27867,661,517,2,2,9.80E-05,878938,0.991357997
31122,718,380,2,2,9.80E-05,878940,0.991360253
26146,22,632,2,2,9.80E-05,878942,0.991362508
26148,124,560,2,2,9.80E-05,878944,0.991364764
26153,414,409,2,2,9.80E-05,878946,0.99136702
29534,661,605,2,2,9.80E-05,878948,0.991369276
26155,587,16,2,2,9.80E-05,878950,0.991371532
31139,23,618,2,2,9.80E-05,878952,0.991373788
31141,290,250,2,2,9.80E-05,878954,0.991376043
29510,11,174,2,2,9.80E-05,878956,0.991378299
27901,354,569,2,2,9.80E-05,878958,0.991380555
26765,525,155,2,2,9.80E-05,878960,0.991382811
26764,133,5,2,2,9.80E-05,878962,0.991385067
27467,393,5,2,2,9.80E-05,878964,0.991387322
29486,652,141,2,2,9.80E-05,878966,0.991389578
27910,84,701,2,2,9.80E-05,878968,0.991391834
26762,16,371,2,2,9.80E-05,878970,0.99139409
27904,503,605,2,2,9.80E-05,878972,0.991396346
31171,582,342,2,2,9.80E-05,878974,0.991398601
27468,571,302,2,2,9.80E-05,878976,0.991400857
29494,703,27,2,2,9.80E-05,878978,0.991403113
29499,56,178,2,2,9.80E-05,878980,0.991405369
29509,640,714,2,2,9.80E-05,878982,0.991407625
29504,80,684,2,2,9.80E-05,878984,0.99140988
27895,328,23,2,2,9.80E-05,878986,0.991412136
26106,167,34,2,2,9.80E-05,878988,0.991414392
26111,596,319,2,2,9.80E-05,878990,0.991416648
26112,458,26,2,2,9.80E-05,878992,0.991418904
29893,334,587,2,2,9.80E-05,878994,0.991421159
13160,609,475,2,2,9.80E-05,878996,0.991423415
29508,124,243,2,2,9.80E-05,878998,0.991425671
31145,14,12,2,2,9.80E-05,879000,0.991427927
26036,364,517,2,2,9.80E-05,879002,0.991430183
29433,13,178,2,2,9.80E-05,879004,0.991432439
29432,409,517,2,2,9.80E-05,879006,0.991434694
28028,646,632,2,2,9.80E-05,879008,0.99143695
29368,126,393,2,2,9.80E-05,879010,0.991439206
29370,334,193,2,2,9.80E-05,879012,0.991441462
29375,568,196,2,2,9.80E-05,879014,0.991443718
29919,525,22,2,2,9.80E-05,879016,0.991445973
27436,15,160,2,2,9.80E-05,879018,0.991448229
25967,160,48,2,2,9.80E-05,879020,0.991450485
26804,170,307,2,2,9.80E-05,879022,0.991452741
29387,43,383,2,2,9.80E-05,879024,0.991454997
28014,334,171,2,2,9.80E-05,879026,0.991457252
25973,721,34,2,2,9.80E-05,879028,0.991459508
28013,178,171,2,2,9.80E-05,879030,0.991461764
14333,332,230,2,2,9.80E-05,879032,0.99146402
29388,404,207,2,2,9.80E-05,879034,0.991466276
31282,463,699,2,2,9.80E-05,879036,0.991468531
29389,230,160,2,2,9.80E-05,879038,0.991470787
25978,77,202,2,2,9.80E-05,879040,0.991473043
31280,261,319,2,2,9.80E-05,879042,0.991475299
28009,26,446,2,2,9.80E-05,879044,0.991477555
27439,181,95,2,2,9.80E-05,879046,0.991479811
26795,528,20,2,2,9.80E-05,879048,0.991482066
27434,718,31,2,2,9.80E-05,879050,0.991484322
27433,202,126,2,2,9.80E-05,879052,0.991486578
26805,202,347,2,2,9.80E-05,879054,0.991488834
25951,562,328,2,2,9.80E-05,879056,0.99149109
25943,242,723,2,2,9.80E-05,879058,0.991493345
31313,141,121,2,2,9.80E-05,879060,0.991495601
29351,684,164,2,2,9.80E-05,879062,0.991497857
25945,503,131,2,2,9.80E-05,879064,0.991500113
13061,383,3,2,2,9.80E-05,879066,0.991502369
27429,163,348,2,2,9.80E-05,879068,0.991504624
27430,19,624,2,2,9.80E-05,879070,0.99150688
31309,1,371,2,2,9.80E-05,879072,0.991509136
14448,394,140,2,2,9.80E-05,879074,0.991511392
26809,311,19,2,2,9.80E-05,879076,0.991513648
29921,632,133,2,2,9.80E-05,879078,0.991515903
29359,683,552,2,2,9.80E-05,879080,0.991518159
29360,529,652,2,2,9.80E-05,879082,0.991520415
31297,34,701,2,2,9.80E-05,879084,0.991522671
26808,448,236,2,2,9.80E-05,879086,0.991524927
25960,674,446,2,2,9.80E-05,879088,0.991527182
25961,334,528,2,2,9.80E-05,879090,0.991529438
28032,503,367,2,2,9.80E-05,879092,0.991531694
26807,5,552,2,2,9.80E-05,879094,0.99153395
29922,668,195,2,2,9.80E-05,879096,0.991536206
26806,224,319,2,2,9.80E-05,879098,0.991538462
25981,34,624,2,2,9.80E-05,879100,0.991540717
28008,295,684,2,2,9.80E-05,879102,0.991542973
14238,95,20,2,2,9.80E-05,879104,0.991545229
26010,699,558,2,2,9.80E-05,879106,0.991547485
29415,26,569,2,2,9.80E-05,879108,0.991549741
31258,626,167,2,2,9.80E-05,879110,0.991551996
27978,674,19,2,2,9.80E-05,879112,0.991554252
26014,124,508,2,2,9.80E-05,879114,0.991556508
27977,48,175,2,2,9.80E-05,879116,0.991558764
27448,528,269,2,2,9.80E-05,879118,0.99156102
30523,517,448,2,2,9.80E-05,879120,0.991563275
26024,290,11,2,2,9.80E-05,879122,0.991565531
26004,492,385,2,2,9.80E-05,879124,0.991567787
31238,175,624,2,2,9.80E-05,879126,0.991570043
26027,682,508,2,2,9.80E-05,879128,0.991572299
27451,626,6,2,2,9.80E-05,879130,0.991574554
26030,385,2,2,2,9.80E-05,879132,0.99157681
27969,25,207,2,2,9.80E-05,879134,0.991579066
27453,155,427,2,2,9.80E-05,879136,0.991581322
26031,502,261,2,2,9.80E-05,879138,0.991583578
26005,334,156,2,2,9.80E-05,879140,0.991585834
31263,493,364,2,2,9.80E-05,879142,0.991588089
26794,398,319,2,2,9.80E-05,879144,0.991590345
30518,171,124,2,2,9.80E-05,879146,0.991592601
29391,243,193,2,2,9.80E-05,879148,0.991594857
30517,448,250,2,2,9.80E-05,879150,0.991597113
28004,683,507,2,2,9.80E-05,879152,0.991599368
28002,236,721,2,2,9.80E-05,879154,0.991601624
27441,682,167,2,2,9.80E-05,879156,0.99160388
27996,314,626,2,2,9.80E-05,879158,0.991606136
27992,528,207,2,2,9.80E-05,879160,0.991608392
29406,571,236,2,2,9.80E-05,879162,0.991610647
27988,342,353,2,2,9.80E-05,879164,0.991612903
25990,13,562,2,2,9.80E-05,879166,0.991615159
26002,652,31,2,2,9.80E-05,879168,0.991617415
25991,84,160,2,2,9.80E-05,879170,0.991619671
29410,243,494,2,2,9.80E-05,879172,0.991621926
25995,614,85,2,2,9.80E-05,879174,0.991624182
29412,250,701,2,2,9.80E-05,879176,0.991626438
31265,718,655,2,2,9.80E-05,879178,0.991628694
29911,446,156,2,2,9.80E-05,879180,0.99163095
25999,335,124,2,2,9.80E-05,879182,0.991633206
26058,385,593,2,2,9.80E-05,879184,0.991635461
20614,383,511,2,2,9.80E-05,879186,0.991637717
22477,514,145,2,2,9.80E-05,879188,0.991639973
23873,493,528,2,2,9.80E-05,879190,0.991642229
22952,439,587,2,2,9.80E-05,879192,0.991644485
19126,97,130,2,2,9.80E-05,879194,0.99164674
19793,31,701,2,2,9.80E-05,879196,0.991648996
19125,3,593,2,2,9.80E-05,879198,0.991651252
23869,471,265,2,2,9.80E-05,879200,0.991653508
23870,471,593,2,2,9.80E-05,879202,0.991655764
21394,311,175,2,2,9.80E-05,879204,0.991658019
17089,689,22,2,2,9.80E-05,879206,0.991660275
17080,295,605,2,2,9.80E-05,879208,0.991662531
21391,624,522,2,2,9.80E-05,879210,0.991664787
19118,586,261,2,2,9.80E-05,879212,0.991667043
18184,661,335,2,2,9.80E-05,879214,0.991669298
23881,699,302,2,2,9.80E-05,879216,0.991671554
21388,497,156,2,2,9.80E-05,879218,0.99167381
23887,364,204,2,2,9.80E-05,879220,0.991676066
23888,367,525,2,2,9.80E-05,879222,0.991678322
21386,68,246,2,2,9.80E-05,879224,0.991680577
19137,64,723,2,2,9.80E-05,879226,0.991682833
23866,347,569,2,2,9.80E-05,879228,0.991685089
23865,265,640,2,2,9.80E-05,879230,0.991687345
23831,219,13,2,2,9.80E-05,879232,0.991689601
21420,562,605,2,2,9.80E-05,879234,0.991691857
22064,471,529,2,2,9.80E-05,879236,0.991694112
19779,624,471,2,2,9.80E-05,879238,0.991696368
23842,473,668,2,2,9.80E-05,879240,0.991698624
21413,525,532,2,2,9.80E-05,879242,0.99170088
19145,265,295,2,2,9.80E-05,879244,0.991703136
19783,1,439,2,2,9.80E-05,879246,0.991705391
21408,2,155,2,2,9.80E-05,879248,0.991707647
22956,163,302,2,2,9.80E-05,879250,0.991709903
19786,207,121,2,2,9.80E-05,879252,0.991712159
23847,295,503,2,2,9.80E-05,879254,0.991714415
23848,562,4,2,2,9.80E-05,879256,0.99171667
22066,586,494,2,2,9.80E-05,879258,0.991718926
19790,720,302,2,2,9.80E-05,879260,0.991721182
21398,130,684,2,2,9.80E-05,879262,0.991723438
21397,22,708,2,2,9.80E-05,879264,0.991725694
22940,170,10,2,2,9.80E-05,879266,0.991727949
23895,314,717,2,2,9.80E-05,879268,0.991730205
22964,13,114,2,2,9.80E-05,879270,0.991732461
22916,243,29,2,2,9.80E-05,879272,0.991734717
23938,458,242,2,2,9.80E-05,879274,0.991736973
22105,243,507,2,2,9.80E-05,879276,0.991739229
23941,175,68,2,2,9.80E-05,879278,0.991741484
23945,502,508,2,2,9.80E-05,879280,0.99174374
21358,661,397,2,2,9.80E-05,879282,0.991745996
22107,12,552,2,2,9.80E-05,879284,0.991748252
21348,33,23,2,2,9.80E-05,879286,0.991750508
23956,354,174,2,2,9.80E-05,879288,0.991752763
19117,246,302,2,2,9.80E-05,879290,0.991755019
21345,446,5,2,2,9.80E-05,879292,0.991757275
22116,514,661,2,2,9.80E-05,879294,0.991759531
22915,5,439,2,2,9.80E-05,879296,0.991761787
23960,618,195,2,2,9.80E-05,879298,0.991764042
23963,331,446,2,2,9.80E-05,879300,0.991766298
17018,196,614,2,2,9.80E-05,879302,0.991768554
21342,167,354,2,2,9.80E-05,879304,0.99177081
23968,605,632,2,2,9.80E-05,879306,0.991773066
23937,668,393,2,2,9.80E-05,879308,0.991775321
23936,655,133,2,2,9.80E-05,879310,0.991777577
23933,404,164,2,2,9.80E-05,879312,0.991779833
22922,295,124,2,2,9.80E-05,879314,0.991782089
22094,719,141,2,2,9.80E-05,879316,0.991784345
21382,507,640,2,2,9.80E-05,879318,0.9917866
19096,609,246,2,2,9.80E-05,879320,0.991788856
17071,195,95,2,2,9.80E-05,879322,0.991791112
23910,624,243,2,2,9.80E-05,879324,0.991793368
23915,12,507,2,2,9.80E-05,879326,0.991795624
22927,655,195,2,2,9.80E-05,879328,0.99179788
17065,593,164,2,2,9.80E-05,879330,0.991800135
23924,543,514,2,2,9.80E-05,879332,0.991802391
18196,29,689,2,2,9.80E-05,879334,0.991804647
23925,528,5,2,2,9.80E-05,879336,0.991806903
19845,624,379,2,2,9.80E-05,879338,0.991809159
23930,507,632,2,2,9.80E-05,879340,0.991811414
23931,264,4,2,2,9.80E-05,879342,0.99181367
23932,475,140,2,2,9.80E-05,879344,0.991815926
19775,246,393,2,2,9.80E-05,879346,0.991818182
23829,193,661,2,2,9.80E-05,879348,0.991820438
19873,458,20,2,2,9.80E-05,879350,0.991822693
19185,473,163,2,2,9.80E-05,879352,0.991824949
18096,414,507,2,2,9.80E-05,879354,0.991827205
19187,307,274,2,2,9.80E-05,879356,0.991829461
21503,170,9,2,2,9.80E-05,879358,0.991831717
23749,54,243,2,2,9.80E-05,879360,0.991833972
21498,482,479,2,2,9.80E-05,879362,0.991836228
19727,294,123,2,2,9.80E-05,879364,0.991838484
21494,383,404,2,2,9.80E-05,879366,0.99184074
21490,701,174,2,2,9.80E-05,879368,0.991842996
23007,473,684,2,2,9.80E-05,879370,0.991845252
19741,295,652,2,2,9.80E-05,879372,0.991847507
23006,719,497,2,2,9.80E-05,879374,0.991849763
23005,593,383,2,2,9.80E-05,879376,0.991852019
22999,193,498,2,2,9.80E-05,879378,0.991854275
21484,334,242,2,2,9.80E-05,879380,0.991856531
21483,138,674,2,2,9.80E-05,879382,0.991858786
21482,156,1,2,2,9.80E-05,879384,0.991861042
19178,638,25,2,2,9.80E-05,879386,0.991863298
23742,170,84,2,2,9.80E-05,879388,0.991865554
18095,164,30,2,2,9.80E-05,879390,0.99186781
23017,714,32,2,2,9.80E-05,879392,0.991870065
23739,562,195,2,2,9.80E-05,879394,0.991872321
23706,448,219,2,2,9.80E-05,879396,0.991874577
23707,682,552,2,2,9.80E-05,879398,0.991876833
23032,12,511,2,2,9.80E-05,879400,0.991879089
23712,6,261,2,2,9.80E-05,879402,0.991881344
21518,195,334,2,2,9.80E-05,879404,0.9918836
21516,290,380,2,2,9.80E-05,879406,0.991885856
19208,25,543,2,2,9.80E-05,879408,0.991888112
23030,404,409,2,2,9.80E-05,879410,0.991890368
23718,392,26,2,2,9.80E-05,879412,0.991892624
23719,717,174,2,2,9.80E-05,879414,0.991894879
21515,535,618,2,2,9.80E-05,879416,0.991897135
23725,624,398,2,2,9.80E-05,879418,0.991899391
18091,141,158,2,2,9.80E-05,879420,0.991901647
23727,609,90,2,2,9.80E-05,879422,0.991903903
21512,32,19,2,2,9.80E-05,879424,0.991906158
23734,668,614,2,2,9.80E-05,879426,0.991908414
23736,204,646,2,2,9.80E-05,879428,0.99191067
17222,379,409,2,2,9.80E-05,879430,0.991912926
19742,409,353,2,2,9.80E-05,879432,0.991915182
21428,138,335,2,2,9.80E-05,879434,0.991917437
22970,4,507,2,2,9.80E-05,879436,0.991919693
21441,558,85,2,2,9.80E-05,879438,0.991921949
19766,138,236,2,2,9.80E-05,879440,0.991924205
17186,64,302,2,2,9.80E-05,879442,0.991926461
18149,498,261,2,2,9.80E-05,879444,0.991928716
17178,514,3,2,2,9.80E-05,879446,0.991930972
23804,1,652,2,2,9.80E-05,879448,0.991933228
19767,552,50,2,2,9.80E-05,879450,0.991935484
23771,721,663,2,2,9.80E-05,879452,0.99193774
22968,131,103,2,2,9.80E-05,879454,0.991939995
23812,525,26,2,2,9.80E-05,879456,0.991942251
23813,507,605,2,2,9.80E-05,879458,0.991944507
21431,398,544,2,2,9.80E-05,879460,0.991946763
23816,43,242,2,2,9.80E-05,879462,0.991949019
21430,174,522,2,2,9.80E-05,879464,0.991951275
21442,103,674,2,2,9.80E-05,879466,0.99195353
21443,414,196,2,2,9.80E-05,879468,0.991955786
18139,511,614,2,2,9.80E-05,879470,0.991958042
23798,514,261,2,2,9.80E-05,879472,0.991960298
17219,699,335,2,2,9.80E-05,879474,0.991962554
23777,202,331,2,2,9.80E-05,879476,0.991964809
23780,463,54,2,2,9.80E-05,879478,0.991967065
19163,29,77,2,2,9.80E-05,879480,0.991969321
23781,174,236,2,2,9.80E-05,879482,0.991971577
23782,193,394,2,2,9.80E-05,879484,0.991973833
23783,492,14,2,2,9.80E-05,879486,0.991976088
22992,264,544,2,2,9.80E-05,879488,0.991978344
23787,236,103,2,2,9.80E-05,879490,0.9919806
18131,529,543,2,2,9.80E-05,879492,0.991982856
21466,528,34,2,2,9.80E-05,879494,0.991985112
22057,50,170,2,2,9.80E-05,879496,0.991987367
19752,682,31,2,2,9.80E-05,879498,0.991989623
23791,178,114,2,2,9.80E-05,879500,0.991991879
22980,295,181,2,2,9.80E-05,879502,0.991994135
17190,29,638,2,2,9.80E-05,879504,0.991996391
21454,720,689,2,2,9.80E-05,879506,0.991998647
22913,448,77,2,2,9.80E-05,879508,0.992000902
23971,163,544,2,2,9.80E-05,879510,0.992003158
24193,383,133,2,2,9.80E-05,879512,0.992005414
24126,719,280,2,2,9.80E-05,879514,0.99200767
24117,701,367,2,2,9.80E-05,879516,0.992009926
22859,332,588,2,2,9.80E-05,879518,0.992012181
21243,64,708,2,2,9.80E-05,879520,0.992014437
24118,458,48,2,2,9.80E-05,879522,0.992016693
19980,514,20,2,2,9.80E-05,879524,0.992018949
19981,167,618,2,2,9.80E-05,879526,0.992021205
24124,170,335,2,2,9.80E-05,879528,0.99202346
22185,511,552,2,2,9.80E-05,879530,0.992025716
22853,699,544,2,2,9.80E-05,879532,0.992027972
24140,27,717,2,2,9.80E-05,879534,0.992030228
22188,43,404,2,2,9.80E-05,879536,0.992032484
21230,482,334,2,2,9.80E-05,879538,0.992034739
21227,280,482,2,2,9.80E-05,879540,0.992036995
22845,56,319,2,2,9.80E-05,879542,0.992039251
19988,12,383,2,2,9.80E-05,879544,0.992041507
21222,535,383,2,2,9.80E-05,879546,0.992043763
21217,295,682,2,2,9.80E-05,879548,0.992046018
24137,593,517,2,2,9.80E-05,879550,0.992048274
24115,668,596,2,2,9.80E-05,879552,0.99205053
19976,525,663,2,2,9.80E-05,879554,0.992052786
22181,618,155,2,2,9.80E-05,879556,0.992055042
16799,4,14,2,2,9.80E-05,879558,0.992057298
24091,414,511,2,2,9.80E-05,879560,0.992059553
21257,103,114,2,2,9.80E-05,879562,0.992061809
24094,204,54,2,2,9.80E-05,879564,0.992064065
21254,699,310,2,2,9.80E-05,879566,0.992066321
22175,446,632,2,2,9.80E-05,879568,0.992068577
24098,230,624,2,2,9.80E-05,879570,0.992070832
19966,684,443,2,2,9.80E-05,879572,0.992073088
22865,689,528,2,2,9.80E-05,879574,0.992075344
24102,224,19,2,2,9.80E-05,879576,0.9920776
24103,394,5,2,2,9.80E-05,879578,0.992079856
24104,379,332,2,2,9.80E-05,879580,0.992082111
21249,195,64,2,2,9.80E-05,879582,0.992084367
21886,714,9,2,2,9.80E-05,879584,0.992086623
16820,164,265,2,2,9.80E-05,879586,0.992088879
19973,133,723,2,2,9.80E-05,879588,0.992091135
22180,593,30,2,2,9.80E-05,879590,0.99209339
19997,331,181,2,2,9.80E-05,879592,0.992095646
24141,721,682,2,2,9.80E-05,879594,0.992097902
24088,290,97,2,2,9.80E-05,879596,0.992100158
18949,25,471,2,2,9.80E-05,879598,0.992102414
18955,640,54,2,2,9.80E-05,879600,0.99210467
18953,719,80,2,2,9.80E-05,879602,0.992106925
24169,246,261,2,2,9.80E-05,879604,0.992109181
24172,90,11,2,2,9.80E-05,879606,0.992111437
18950,605,56,2,2,9.80E-05,879608,0.992113693
24173,31,414,2,2,9.80E-05,879610,0.992115949
22835,646,471,2,2,9.80E-05,879612,0.992118204
24174,138,596,2,2,9.80E-05,879614,0.99212046
22834,4,22,2,2,9.80E-05,879616,0.992122716
24143,383,1,2,2,9.80E-05,879618,0.992124972
24181,11,23,2,2,9.80E-05,879620,0.992127228
20038,117,12,2,2,9.80E-05,879622,0.992129483
22833,29,397,2,2,9.80E-05,879624,0.992131739
16737,107,156,2,2,9.80E-05,879626,0.992133995
16719,138,80,2,2,9.80E-05,879628,0.992136251
21179,164,511,2,2,9.80E-05,879630,0.992138507
24166,160,114,2,2,9.80E-05,879632,0.992140762
24165,196,328,2,2,9.80E-05,879634,0.992143018
21196,443,29,2,2,9.80E-05,879636,0.992145274
21200,683,522,2,2,9.80E-05,879638,0.99214753
24144,683,97,2,2,9.80E-05,879640,0.992149786
24145,196,605,2,2,9.80E-05,879642,0.992152042
21212,280,193,2,2,9.80E-05,879644,0.992154297
24146,342,311,2,2,9.80E-05,879646,0.992156553
24147,503,354,2,2,9.80E-05,879648,0.992158809
24148,714,535,2,2,9.80E-05,879650,0.992161065
19999,699,379,2,2,9.80E-05,879652,0.992163321
22843,14,683,2,2,9.80E-05,879654,0.992165576
22196,117,295,2,2,9.80E-05,879656,0.992167832
18273,138,10,2,2,9.80E-05,879658,0.992170088
24155,22,97,2,2,9.80E-05,879660,0.992172344
24157,54,34,2,2,9.80E-05,879662,0.9921746
20003,265,117,2,2,9.80E-05,879664,0.992176855
21207,609,646,2,2,9.80E-05,879666,0.992179111
24159,552,19,2,2,9.80E-05,879668,0.992181367
22839,720,558,2,2,9.80E-05,879670,0.992183623
18957,379,684,2,2,9.80E-05,879672,0.992185879
24089,721,404,2,2,9.80E-05,879674,0.992188134
24087,683,31,2,2,9.80E-05,879676,0.99219039
22912,156,193,2,2,9.80E-05,879678,0.992192646
24013,265,97,2,2,9.80E-05,879680,0.992194902
22897,167,552,2,2,9.80E-05,879682,0.992197158
22130,54,77,2,2,9.80E-05,879684,0.992199413
24004,29,103,2,2,9.80E-05,879686,0.992201669
22132,202,80,2,2,9.80E-05,879688,0.992203925
19897,596,195,2,2,9.80E-05,879690,0.992206181
24009,385,511,2,2,9.80E-05,879692,0.992208437
19044,543,682,2,2,9.80E-05,879694,0.992210693
24015,219,409,2,2,9.80E-05,879696,0.992212948
19043,107,126,2,2,9.80E-05,879698,0.992215204
24016,535,202,2,2,9.80E-05,879700,0.99221746
16900,310,409,2,2,9.80E-05,879702,0.992219716
21304,163,167,2,2,9.80E-05,879704,0.992221972
18223,638,528,2,2,9.80E-05,879706,0.992224227
24020,334,385,2,2,9.80E-05,879708,0.992226483
24021,202,475,2,2,9.80E-05,879710,0.992228739
22887,479,155,2,2,9.80E-05,879712,0.992230995
16945,708,552,2,2,9.80E-05,879714,0.992233251
22128,313,160,2,2,9.80E-05,879716,0.992235506
18212,133,501,2,2,9.80E-05,879718,0.992237762
22126,160,562,2,2,9.80E-05,879720,0.992240018
18203,311,181,2,2,9.80E-05,879722,0.992242274
23972,448,29,2,2,9.80E-05,879724,0.99224453
22909,290,80,2,2,9.80E-05,879726,0.992246785
23973,164,482,2,2,9.80E-05,879728,0.992249041
21332,655,64,2,2,9.80E-05,879730,0.992251297
18205,458,6,2,2,9.80E-05,879732,0.992253553
23978,130,448,2,2,9.80E-05,879734,0.992255809
23979,482,394,2,2,9.80E-05,879736,0.992258065
21326,140,535,2,2,9.80E-05,879738,0.99226032
22123,398,708,2,2,9.80E-05,879740,0.992262576
22905,158,140,2,2,9.80E-05,879742,0.992264832
22901,503,274,2,2,9.80E-05,879744,0.992267088
23988,310,448,2,2,9.80E-05,879746,0.992269344
23990,84,137,2,2,9.80E-05,879748,0.992271599
23991,458,347,2,2,9.80E-05,879750,0.992273855
21294,50,242,2,2,9.80E-05,879752,0.992276111
24026,207,30,2,2,9.80E-05,879754,0.992278367
24086,586,508,2,2,9.80E-05,879756,0.992280623
16845,397,708,2,2,9.80E-05,879758,0.992282878
21273,20,517,2,2,9.80E-05,879760,0.992285134
24063,243,1,2,2,9.80E-05,879762,0.99228739
24065,497,385,2,2,9.80E-05,879764,0.992289646
24066,632,103,2,2,9.80E-05,879766,0.992291902
22158,32,446,2,2,9.80E-05,879768,0.992294157
24069,701,29,2,2,9.80E-05,879770,0.992296413
19939,543,85,2,2,9.80E-05,879772,0.992298669
19949,614,163,2,2,9.80E-05,879774,0.992300925
19954,34,528,2,2,9.80E-05,879776,0.992303181
19020,242,33,2,2,9.80E-05,879778,0.992305436
21261,494,123,2,2,9.80E-05,879780,0.992307692
24077,708,587,2,2,9.80E-05,879782,0.992309948
24078,393,661,2,2,9.80E-05,879784,0.992312204
19955,164,48,2,2,9.80E-05,879786,0.99231446
22875,448,398,2,2,9.80E-05,879788,0.992316716
24083,404,593,2,2,9.80E-05,879790,0.992318971
24084,682,34,2,2,9.80E-05,879792,0.992321227
21275,394,1,2,2,9.80E-05,879794,0.992323483
24061,5,652,2,2,9.80E-05,879796,0.992325739
19936,68,85,2,2,9.80E-05,879798,0.992327995
22878,393,525,2,2,9.80E-05,879800,0.99233025
21289,2,560,2,2,9.80E-05,879802,0.992332506
24033,674,261,2,2,9.80E-05,879804,0.992334762
21287,684,588,2,2,9.80E-05,879806,0.992337018
24037,19,307,2,2,9.80E-05,879808,0.992339274
24038,54,196,2,2,9.80E-05,879810,0.992341529
22147,242,295,2,2,9.80E-05,879812,0.992343785
19922,498,195,2,2,9.80E-05,879814,0.992346041
22885,294,723,2,2,9.80E-05,879816,0.992348297
16866,532,160,2,2,9.80E-05,879818,0.992350553
18236,138,582,2,2,9.80E-05,879820,0.992352808
19011,193,3,2,2,9.80E-05,879822,0.992355064
22879,107,207,2,2,9.80E-05,879824,0.99235732
22156,163,398,2,2,9.80E-05,879826,0.992359576
24053,668,114,2,2,9.80E-05,879828,0.992361832
24054,379,673,2,2,9.80E-05,879830,0.992364088
24059,393,632,2,2,9.80E-05,879832,0.992366343
19702,23,501,2,2,9.80E-05,879834,0.992368599
23033,140,723,2,2,9.80E-05,879836,0.992370855
22480,682,4,2,2,9.80E-05,879838,0.992373111
23394,342,9,2,2,9.80E-05,879840,0.992375367
21924,230,492,2,2,9.80E-05,879842,0.992377622
17884,558,1,2,2,9.80E-05,879844,0.992379878
21928,682,171,2,2,9.80E-05,879846,0.992382134
21750,193,280,2,2,9.80E-05,879848,0.99238439
23391,532,684,2,2,9.80E-05,879850,0.992386646
23200,640,448,2,2,9.80E-05,879852,0.992388901
23393,20,586,2,2,9.80E-05,879854,0.992391157
23395,103,295,2,2,9.80E-05,879856,0.992393413
23414,130,85,2,2,9.80E-05,879858,0.992395669
21930,605,164,2,2,9.80E-05,879860,0.992397925
23398,25,328,2,2,9.80E-05,879862,0.99240018
23405,543,124,2,2,9.80E-05,879864,0.992402436
23407,264,517,2,2,9.80E-05,879866,0.992404692
19481,43,414,2,2,9.80E-05,879868,0.992406948
23198,439,242,2,2,9.80E-05,879870,0.992409204
23411,682,646,2,2,9.80E-05,879872,0.99241146
23412,23,310,2,2,9.80E-05,879874,0.992413715
17653,25,723,2,2,9.80E-05,879876,0.992415971
19316,2,398,2,2,9.80E-05,879878,0.992418227
23381,11,207,2,2,9.80E-05,879880,0.992420483
23380,4,5,2,2,9.80E-05,879882,0.992422739
19449,170,171,2,2,9.80E-05,879884,0.992424994
23363,77,624,2,2,9.80E-05,879886,0.99242725
23364,663,175,2,2,9.80E-05,879888,0.992429506
23366,141,302,2,2,9.80E-05,879890,0.992431762
23211,624,544,2,2,9.80E-05,879892,0.992434018
19450,163,311,2,2,9.80E-05,879894,0.992436273
17686,117,242,2,2,9.80E-05,879896,0.992438529
23210,613,471,2,2,9.80E-05,879898,0.992440785
19451,107,294,2,2,9.80E-05,879900,0.992443041
17875,171,156,2,2,9.80E-05,879902,0.992445297
21920,514,392,2,2,9.80E-05,879904,0.992447552
17677,171,661,2,2,9.80E-05,879906,0.992449808
21774,719,379,2,2,9.80E-05,879908,0.992452064
23208,97,511,2,2,9.80E-05,879910,0.99245432
23376,383,562,2,2,9.80E-05,879912,0.992456576
21921,1,242,2,2,9.80E-05,879914,0.992458831
23377,138,48,2,2,9.80E-05,879916,0.992461087
17604,19,380,2,2,9.80E-05,879918,0.992463343
23191,202,353,2,2,9.80E-05,879920,0.992465599
21783,446,708,2,2,9.80E-05,879922,0.992467855
21702,332,354,2,2,9.80E-05,879924,0.992470111
23436,193,170,2,2,9.80E-05,879926,0.992472366
21710,141,331,2,2,9.80E-05,879928,0.992474622
23437,207,107,2,2,9.80E-05,879930,0.992476878
23180,501,525,2,2,9.80E-05,879932,0.992479134
23179,48,383,2,2,9.80E-05,879934,0.99248139
19302,439,22,2,2,9.80E-05,879936,0.992483645
21934,261,614,2,2,9.80E-05,879938,0.992485901
23449,655,528,2,2,9.80E-05,879940,0.992488157
19531,640,117,2,2,9.80E-05,879942,0.992490413
23455,12,90,2,2,9.80E-05,879944,0.992492669
23176,163,4,2,2,9.80E-05,879946,0.992494924
23457,588,319,2,2,9.80E-05,879948,0.99249718
21952,160,379,2,2,9.80E-05,879950,0.992499436
21711,250,508,2,2,9.80E-05,879952,0.992501692
21712,95,155,2,2,9.80E-05,879954,0.992503948
21713,443,133,2,2,9.80E-05,879956,0.992506203
23435,332,3,2,2,9.80E-05,879958,0.992508459
23420,294,335,2,2,9.80E-05,879960,0.992510715
19504,163,535,2,2,9.80E-05,879962,0.992512971
19505,170,588,2,2,9.80E-05,879964,0.992515227
23187,22,95,2,2,9.80E-05,879966,0.992517483
19507,479,195,2,2,9.80E-05,879968,0.992519738
19520,138,250,2,2,9.80E-05,879970,0.992521994
21722,532,652,2,2,9.80E-05,879972,0.99252425
23422,587,674,2,2,9.80E-05,879974,0.992526506
21721,458,532,2,2,9.80E-05,879976,0.992528762
23426,22,347,2,2,9.80E-05,879978,0.992531017
21718,646,280,2,2,9.80E-05,879980,0.992533273
19524,15,683,2,2,9.80E-05,879982,0.992535529
23428,494,117,2,2,9.80E-05,879984,0.992537785
23429,80,446,2,2,9.80E-05,879986,0.992540041
21940,243,517,2,2,9.80E-05,879988,0.992542296
23186,514,682,2,2,9.80E-05,879990,0.992544552
17874,498,383,2,2,9.80E-05,879992,0.992546808
23361,3,493,2,2,9.80E-05,879994,0.992549064
21525,19,64,2,2,9.80E-05,879996,0.99255132
21846,475,22,2,2,9.80E-05,879998,0.992553575
21852,409,236,2,2,9.80E-05,880000,0.992555831
21851,605,22,2,2,9.80E-05,880002,0.992558087
23292,33,261,2,2,9.80E-05,880004,0.992560343
17834,13,181,2,2,9.80E-05,880006,0.992562599
21848,655,632,2,2,9.80E-05,880008,0.992564855
23295,525,674,2,2,9.80E-05,880010,0.99256711
21898,97,682,2,2,9.80E-05,880012,0.992569366
23298,493,532,2,2,9.80E-05,880014,0.992571622
23302,655,56,2,2,9.80E-05,880016,0.992573878
21840,131,181,2,2,9.80E-05,880018,0.992576134
23304,632,364,2,2,9.80E-05,880020,0.992578389
23306,174,48,2,2,9.80E-05,880022,0.992580645
17760,314,525,2,2,9.80E-05,880024,0.992582901
23308,170,156,2,2,9.80E-05,880026,0.992585157
23313,219,174,2,2,9.80E-05,880028,0.992587413
21899,593,204,2,2,9.80E-05,880030,0.992589668
21901,2,364,2,2,9.80E-05,880032,0.992591924
23289,77,160,2,2,9.80E-05,880034,0.99259418
17822,103,313,2,2,9.80E-05,880036,0.992596436
23286,269,11,2,2,9.80E-05,880038,0.992598692
23255,646,56,2,2,9.80E-05,880040,0.992600947
19353,532,138,2,2,9.80E-05,880042,0.992603203
17796,638,661,2,2,9.80E-05,880044,0.992605459
17787,9,624,2,2,9.80E-05,880046,0.992607715
23259,174,121,2,2,9.80E-05,880048,0.992609971
19366,19,230,2,2,9.80E-05,880050,0.992612226
23273,493,50,2,2,9.80E-05,880052,0.992614482
19370,497,544,2,2,9.80E-05,880054,0.992616738
23276,448,311,2,2,9.80E-05,880056,0.992618994
19374,703,404,2,2,9.80E-05,880058,0.99262125
19375,458,354,2,2,9.80E-05,880060,0.992623506
19346,586,20,2,2,9.80E-05,880062,0.992625761
19379,699,230,2,2,9.80E-05,880064,0.992628017
21895,4,12,2,2,9.80E-05,880066,0.992630273
23283,398,511,2,2,9.80E-05,880068,0.992632529
23285,502,193,2,2,9.80E-05,880070,0.992634785
21842,701,20,2,2,9.80E-05,880072,0.99263704
17742,26,137,2,2,9.80E-05,880074,0.992639296
23360,614,482,2,2,9.80E-05,880076,0.992641552
23350,514,34,2,2,9.80E-05,880078,0.992643808
23231,48,446,2,2,9.80E-05,880080,0.992646064
17857,471,4,2,2,9.80E-05,880082,0.992648319
21821,250,560,2,2,9.80E-05,880084,0.992650575
21817,163,50,2,2,9.80E-05,880086,0.992652831
21815,43,26,2,2,9.80E-05,880088,0.992655087
21814,19,543,2,2,9.80E-05,880090,0.992657343
21813,123,193,2,2,9.80E-05,880092,0.992659598
23225,224,138,2,2,9.80E-05,880094,0.992661854
19403,174,394,2,2,9.80E-05,880096,0.99266411
19327,174,313,2,2,9.80E-05,880098,0.992666366
17860,29,334,2,2,9.80E-05,880100,0.992668622
23354,393,171,2,2,9.80E-05,880102,0.992670878
17861,15,250,2,2,9.80E-05,880104,0.992673133
21786,529,29,2,2,9.80E-05,880106,0.992675389
23356,30,398,2,2,9.80E-05,880108,0.992677645
21822,525,280,2,2,9.80E-05,880110,0.992679901
21823,497,85,2,2,9.80E-05,880112,0.992682157
21824,54,107,2,2,9.80E-05,880114,0.992684412
23339,30,587,2,2,9.80E-05,880116,0.992686668
17845,230,613,2,2,9.80E-05,880118,0.992688924
23321,195,34,2,2,9.80E-05,880120,0.99269118
17715,4,562,2,2,9.80E-05,880122,0.992693436
23325,385,246,2,2,9.80E-05,880124,0.992695691
17706,246,498,2,2,9.80E-05,880126,0.992697947
23328,290,313,2,2,9.80E-05,880128,0.992700203
21833,133,427,2,2,9.80E-05,880130,0.992702459
23330,140,501,2,2,9.80E-05,880132,0.992704715
23238,207,394,2,2,9.80E-05,880134,0.99270697
23237,84,13,2,2,9.80E-05,880136,0.992709226
19331,638,502,2,2,9.80E-05,880138,0.992711482
23333,492,614,2,2,9.80E-05,880140,0.992713738
23334,605,12,2,2,9.80E-05,880142,0.992715994
21826,242,543,2,2,9.80E-05,880144,0.992718249
23235,507,126,2,2,9.80E-05,880146,0.992720505
23335,446,463,2,2,9.80E-05,880148,0.992722761
21825,114,140,2,2,9.80E-05,880150,0.992725017
23160,167,508,2,2,9.80E-05,880152,0.992727273
17532,720,473,2,2,9.80E-05,880154,0.992729529
23464,19,158,2,2,9.80E-05,880156,0.992731784
22000,605,714,2,2,9.80E-05,880158,0.99273404
18008,307,29,2,2,9.80E-05,880160,0.992736296
18015,446,174,2,2,9.80E-05,880162,0.992738552
23075,269,311,2,2,9.80E-05,880164,0.992740808
23073,160,586,2,2,9.80E-05,880166,0.992743063
19640,392,529,2,2,9.80E-05,880168,0.992745319
21999,404,97,2,2,9.80E-05,880170,0.992747575
23635,684,501,2,2,9.80E-05,880172,0.992749831
23637,668,117,2,2,9.80E-05,880174,0.992752087
23655,5,156,2,2,9.80E-05,880176,0.992754342
23641,54,242,2,2,9.80E-05,880178,0.992756598
17374,689,511,2,2,9.80E-05,880180,0.992758854
22002,529,708,2,2,9.80E-05,880182,0.99276111
17370,164,398,2,2,9.80E-05,880184,0.992763366
21578,56,140,2,2,9.80E-05,880186,0.992765621
23651,123,668,2,2,9.80E-05,880188,0.992767877
19644,2,174,2,2,9.80E-05,880190,0.992770133
22008,54,114,2,2,9.80E-05,880192,0.992772389
21587,90,236,2,2,9.80E-05,880194,0.992774645
17396,379,155,2,2,9.80E-05,880196,0.992776901
23599,19,397,2,2,9.80E-05,880198,0.992779156
21603,107,525,2,2,9.80E-05,880200,0.992781412
19629,274,544,2,2,9.80E-05,880202,0.992783668
21599,458,569,2,2,9.80E-05,880204,0.992785924
21989,605,117,2,2,9.80E-05,880206,0.99278818
23605,103,393,2,2,9.80E-05,880208,0.992790435
23607,385,383,2,2,9.80E-05,880210,0.992792691
23609,133,54,2,2,9.80E-05,880212,0.992794947
23610,204,181,2,2,9.80E-05,880214,0.992797203
23611,404,54,2,2,9.80E-05,880216,0.992799459
21597,307,605,2,2,9.80E-05,880218,0.992801714
21596,114,117,2,2,9.80E-05,880220,0.99280397
23085,34,202,2,2,9.80E-05,880222,0.992806226
19251,586,97,2,2,9.80E-05,880224,0.992808482
21592,334,246,2,2,9.80E-05,880226,0.992810738
21588,458,121,2,2,9.80E-05,880228,0.992812993
23620,721,562,2,2,9.80E-05,880230,0.992815249
23064,398,503,2,2,9.80E-05,880232,0.992817505
22011,708,385,2,2,9.80E-05,880234,0.992819761
17527,586,544,2,2,9.80E-05,880236,0.992822017
23686,48,12,2,2,9.80E-05,880238,0.992824273
23678,2,385,2,2,9.80E-05,880240,0.992826528
22024,473,23,2,2,9.80E-05,880242,0.992828784
19680,683,250,2,2,9.80E-05,880244,0.99283104
19681,265,560,2,2,9.80E-05,880246,0.992833296
19210,689,609,2,2,9.80E-05,880248,0.992835552
18056,624,97,2,2,9.80E-05,880250,0.992837807
19684,443,668,2,2,9.80E-05,880252,0.992840063
21536,26,1,2,2,9.80E-05,880254,0.992842319
23035,133,682,2,2,9.80E-05,880256,0.992844575
19693,48,684,2,2,9.80E-05,880258,0.992846831
19694,219,246,2,2,9.80E-05,880260,0.992849086
23693,193,156,2,2,9.80E-05,880262,0.992851342
23695,302,23,2,2,9.80E-05,880264,0.992853598
22030,439,97,2,2,9.80E-05,880266,0.992855854
23697,605,528,2,2,9.80E-05,880268,0.99285811
21528,721,20,2,2,9.80E-05,880270,0.992860365
17270,264,471,2,2,9.80E-05,880272,0.992862621
21552,103,2,2,2,9.80E-05,880274,0.992864877
23048,19,498,2,2,9.80E-05,880276,0.992867133
19665,269,141,2,2,9.80E-05,880278,0.992869389
21560,178,123,2,2,9.80E-05,880280,0.992871644
17358,529,170,2,2,9.80E-05,880282,0.9928739
22013,699,84,2,2,9.80E-05,880284,0.992876156
22014,138,274,2,2,9.80E-05,880286,0.992878412
23058,97,552,2,2,9.80E-05,880288,0.992880668
23056,332,347,2,2,9.80E-05,880290,0.992882924
17334,392,224,2,2,9.80E-05,880292,0.992885179
21566,614,714,2,2,9.80E-05,880294,0.992887435
19213,525,84,2,2,9.80E-05,880296,0.992889691
21565,295,246,2,2,9.80E-05,880298,0.992891947
23052,141,219,2,2,9.80E-05,880300,0.992894203
23668,684,6,2,2,9.80E-05,880302,0.992896458
23669,269,582,2,2,9.80E-05,880304,0.992898714
23050,562,652,2,2,9.80E-05,880306,0.99290097
21562,525,475,2,2,9.80E-05,880308,0.992903226
17296,502,14,2,2,9.80E-05,880310,0.992905482
21988,261,638,2,2,9.80E-05,880312,0.992907737
21605,5,178,2,2,9.80E-05,880314,0.992909993
23597,448,193,2,2,9.80E-05,880316,0.992912249
23532,140,708,2,2,9.80E-05,880318,0.992914505
21966,414,587,2,2,9.80E-05,880320,0.992916761
23513,439,385,2,2,9.80E-05,880322,0.992919016
23514,683,609,2,2,9.80E-05,880324,0.992921272
23516,525,313,2,2,9.80E-05,880326,0.992923528
23142,290,33,2,2,9.80E-05,880328,0.992925784
23518,48,155,2,2,9.80E-05,880330,0.99292804
23520,290,632,2,2,9.80E-05,880332,0.992930296
21651,29,34,2,2,9.80E-05,880334,0.992932551
21646,264,313,2,2,9.80E-05,880336,0.992934807
23596,141,502,2,2,9.80E-05,880338,0.992937063
23534,19,723,2,2,9.80E-05,880340,0.992939319
23538,174,178,2,2,9.80E-05,880342,0.992941575
19282,640,507,2,2,9.80E-05,880344,0.99294383
21644,497,196,2,2,9.80E-05,880346,0.992946086
21971,19,446,2,2,9.80E-05,880348,0.992948342
23541,265,632,2,2,9.80E-05,880350,0.992950598
23544,364,4,2,2,9.80E-05,880352,0.992952854
23545,544,171,2,2,9.80E-05,880354,0.992955109
21661,535,446,2,2,9.80E-05,880356,0.992957365
23502,529,124,2,2,9.80E-05,880358,0.992959621
23149,529,126,2,2,9.80E-05,880360,0.992961877
23499,265,133,2,2,9.80E-05,880362,0.992964133
19542,32,332,2,2,9.80E-05,880364,0.992966388
21953,335,371,2,2,9.80E-05,880366,0.992968644
23467,103,158,2,2,9.80E-05,880368,0.9929709
23469,242,511,2,2,9.80E-05,880370,0.992973156
21678,158,193,2,2,9.80E-05,880372,0.992975412
17521,511,156,2,2,9.80E-05,880374,0.992977667
17519,204,117,2,2,9.80E-05,880376,0.992979923
23476,80,193,2,2,9.80E-05,880378,0.992982179
23477,2,264,2,2,9.80E-05,880380,0.992984435
19550,482,32,2,2,9.80E-05,880382,0.992986691
23479,22,107,2,2,9.80E-05,880384,0.992988947
23486,163,640,2,2,9.80E-05,880386,0.992991202
23487,719,50,2,2,9.80E-05,880388,0.992993458
23489,2,701,2,2,9.80E-05,880390,0.992995714
23497,613,609,2,2,9.80E-05,880392,0.99299797
17486,503,380,2,2,9.80E-05,880394,0.993000226
23140,532,13,2,2,9.80E-05,880396,0.993002481
23138,586,613,2,2,9.80E-05,880398,0.993004737
23567,624,511,2,2,9.80E-05,880400,0.993006993
19260,605,4,2,2,9.80E-05,880402,0.993009249
19612,624,380,2,2,9.80E-05,880404,0.993011505
19614,605,479,2,2,9.80E-05,880406,0.99301376
19259,29,121,2,2,9.80E-05,880408,0.993016016
21985,158,409,2,2,9.80E-05,880410,0.993018272
23101,230,525,2,2,9.80E-05,880412,0.993020528
23574,493,280,2,2,9.80E-05,880414,0.993022784
23577,156,364,2,2,9.80E-05,880416,0.993025039
21607,383,170,2,2,9.80E-05,880418,0.993027295
17979,261,246,2,2,9.80E-05,880420,0.993029551
17984,364,64,2,2,9.80E-05,880422,0.993031807
23088,646,364,2,2,9.80E-05,880424,0.993034063
23087,124,64,2,2,9.80E-05,880426,0.993036319
17421,140,6,2,2,9.80E-05,880428,0.993038574
23585,699,313,2,2,9.80E-05,880430,0.99304083
23588,19,471,2,2,9.80E-05,880432,0.993043086
23590,544,56,2,2,9.80E-05,880434,0.993045342
21623,682,383,2,2,9.80E-05,880436,0.993047598
23565,43,290,2,2,9.80E-05,880438,0.993049853
21624,502,167,2,2,9.80E-05,880440,0.993052109
19576,498,54,2,2,9.80E-05,880442,0.993054365
23551,682,593,2,2,9.80E-05,880444,0.993056621
23131,404,170,2,2,9.80E-05,880446,0.993058877
23552,394,332,2,2,9.80E-05,880448,0.993061132
17447,4,528,2,2,9.80E-05,880450,0.993063388
21634,383,723,2,2,9.80E-05,880452,0.993065644
21975,668,497,2,2,9.80E-05,880454,0.9930679
23125,544,364,2,2,9.80E-05,880456,0.993070156
23557,701,347,2,2,9.80E-05,880458,0.993072411
23559,439,528,2,2,9.80E-05,880460,0.993074667
21979,25,517,2,2,9.80E-05,880462,0.993076923
19595,230,13,2,2,9.80E-05,880464,0.993079179
23116,5,121,2,2,9.80E-05,880466,0.993081435
21626,48,167,2,2,9.80E-05,880468,0.993083691
21178,517,632,2,2,9.80E-05,880470,0.993085946
22177,492,26,2,2,9.80E-05,880472,0.993088202
24194,103,97,2,2,9.80E-05,880474,0.993090458
24676,498,175,2,2,9.80E-05,880476,0.993092714
20846,30,385,2,2,9.80E-05,880478,0.99309497
22651,723,145,2,2,9.80E-05,880480,0.993097225
16096,33,181,2,2,9.80E-05,880482,0.993099481
24670,684,708,2,2,9.80E-05,880484,0.993101737
20845,562,29,2,2,9.80E-05,880486,0.993103993
22649,163,385,2,2,9.80E-05,880488,0.993106249
22647,332,334,2,2,9.80E-05,880490,0.993108504
20882,409,588,2,2,9.80E-05,880492,0.99311076
24677,689,103,2,2,9.80E-05,880494,0.993113016
22390,393,503,2,2,9.80E-05,880496,0.993115272
20839,613,393,2,2,9.80E-05,880498,0.993117528
20376,14,242,2,2,9.80E-05,880500,0.993119783
24684,307,446,2,2,9.80E-05,880502,0.993122039
24685,155,588,2,2,9.80E-05,880504,0.993124295
22391,682,269,2,2,9.80E-05,880506,0.993126551
20830,613,95,2,2,9.80E-05,880508,0.993128807
22380,175,562,2,2,9.80E-05,880510,0.993131062
24662,448,97,2,2,9.80E-05,880512,0.993133318
32405,5,493,2,2,9.80E-05,880514,0.993135574
20848,138,614,2,2,9.80E-05,880516,0.99313783
20875,618,121,2,2,9.80E-05,880518,0.993140086
22667,708,294,2,2,9.80E-05,880520,0.993142342
20872,163,354,2,2,9.80E-05,880522,0.993144597
24641,34,181,2,2,9.80E-05,880524,0.993146853
18478,514,85,2,2,9.80E-05,880526,0.993149109
22662,114,661,2,2,9.80E-05,880528,0.993151365
20868,689,274,2,2,9.80E-05,880530,0.993153621
20339,133,30,2,2,9.80E-05,880532,0.993155876
20342,25,155,2,2,9.80E-05,880534,0.993158132
18484,682,121,2,2,9.80E-05,880536,0.993160388
22376,265,95,2,2,9.80E-05,880538,0.993162644
20355,138,379,2,2,9.80E-05,880540,0.9931649
22658,261,6,2,2,9.80E-05,880542,0.993167155
20357,25,48,2,2,9.80E-05,880544,0.993169411
22378,497,269,2,2,9.80E-05,880546,0.993171667
16103,332,107,2,2,9.80E-05,880548,0.993173923
20392,502,593,2,2,9.80E-05,880550,0.993176179
32376,682,290,2,2,9.80E-05,880552,0.993178434
22393,689,652,2,2,9.80E-05,880554,0.99318069
24715,274,126,2,2,9.80E-05,880556,0.993182946
20809,123,178,2,2,9.80E-05,880558,0.993185202
20410,274,29,2,2,9.80E-05,880560,0.993187458
22628,242,140,2,2,9.80E-05,880562,0.993189714
18546,379,29,2,2,9.80E-05,880564,0.993191969
24723,175,105,2,2,9.80E-05,880566,0.993194225
32338,448,614,2,2,9.80E-05,880568,0.993196481
24729,393,673,2,2,9.80E-05,880570,0.993198737
24730,250,29,2,2,9.80E-05,880572,0.993200993
20791,145,502,2,2,9.80E-05,880574,0.993203248
24733,587,15,2,2,9.80E-05,880576,0.993205504
24734,673,155,2,2,9.80E-05,880578,0.99320776
22403,9,494,2,2,9.80E-05,880580,0.993210016
20787,640,124,2,2,9.80E-05,880582,0.993212272
24739,23,164,2,2,9.80E-05,880584,0.993214527
22619,613,50,2,2,9.80E-05,880586,0.993216783
24742,714,354,2,2,9.80E-05,880588,0.993219039
24716,97,103,2,2,9.80E-05,880590,0.993221295
16050,97,13,2,2,9.80E-05,880592,0.993223551
16061,31,141,2,2,9.80E-05,880594,0.993225806
22638,482,219,2,2,9.80E-05,880596,0.993228062
20395,593,552,2,2,9.80E-05,880598,0.993230318
18750,163,130,2,2,9.80E-05,880600,0.993232574
20820,586,54,2,2,9.80E-05,880602,0.99323483
24696,393,133,2,2,9.80E-05,880604,0.993237085
20398,383,313,2,2,9.80E-05,880606,0.993239341
24698,295,446,2,2,9.80E-05,880608,0.993241597
20818,618,250,2,2,9.80E-05,880610,0.993243853
32350,64,507,2,2,9.80E-05,880612,0.993246109
22629,12,632,2,2,9.80E-05,880614,0.993248365
24707,123,701,2,2,9.80E-05,880616,0.99325062
32346,90,25,2,2,9.80E-05,880618,0.993252876
20814,103,535,2,2,9.80E-05,880620,0.993255132
20405,646,236,2,2,9.80E-05,880622,0.993257388
20407,133,414,2,2,9.80E-05,880624,0.993259644
22398,392,236,2,2,9.80E-05,880626,0.993261899
24637,683,265,2,2,9.80E-05,880628,0.993264155
24633,471,508,2,2,9.80E-05,880630,0.993266411
22721,463,661,2,2,9.80E-05,880632,0.993268667
22345,160,22,2,2,9.80E-05,880634,0.993270923
24554,517,414,2,2,9.80E-05,880636,0.993273178
24555,543,701,2,2,9.80E-05,880638,0.993275434
24557,385,54,2,2,9.80E-05,880640,0.99327769
24558,56,124,2,2,9.80E-05,880642,0.993279946
22708,689,290,2,2,9.80E-05,880644,0.993282202
20279,652,471,2,2,9.80E-05,880646,0.993284457
20281,514,328,2,2,9.80E-05,880648,0.993286713
22344,10,178,2,2,9.80E-05,880650,0.993288969
24563,532,448,2,2,9.80E-05,880652,0.993291225
24632,398,29,2,2,9.80E-05,880654,0.993293481
20928,97,181,2,2,9.80E-05,880656,0.993295737
24564,145,683,2,2,9.80E-05,880658,0.993297992
24565,684,334,2,2,9.80E-05,880660,0.993300248
24566,528,683,2,2,9.80E-05,880662,0.993302504
20927,138,398,2,2,9.80E-05,880664,0.99330476
18423,397,167,2,2,9.80E-05,880666,0.993307016
22703,160,68,2,2,9.80E-05,880668,0.993309271
24570,23,219,2,2,9.80E-05,880670,0.993311527
24553,640,404,2,2,9.80E-05,880672,0.993313783
20936,646,473,2,2,9.80E-05,880674,0.993316039
22712,701,30,2,2,9.80E-05,880676,0.993318295
22343,103,397,2,2,9.80E-05,880678,0.99332055
20255,507,475,2,2,9.80E-05,880680,0.993322806
22335,427,398,2,2,9.80E-05,880682,0.993325062
24525,332,64,2,2,9.80E-05,880684,0.993327318
20953,332,156,2,2,9.80E-05,880686,0.993329574
24526,661,25,2,2,9.80E-05,880688,0.993331829
20952,605,364,2,2,9.80E-05,880690,0.993334085
20951,141,6,2,2,9.80E-05,880692,0.993336341
20260,507,164,2,2,9.80E-05,880694,0.993338597
24531,502,56,2,2,9.80E-05,880696,0.993340853
16231,398,15,2,2,9.80E-05,880698,0.993343109
24533,280,175,2,2,9.80E-05,880700,0.993345364
24534,525,242,2,2,9.80E-05,880702,0.99334762
24535,475,624,2,2,9.80E-05,880704,0.993349876
20946,334,25,2,2,9.80E-05,880706,0.993352132
20944,562,613,2,2,9.80E-05,880708,0.993354388
24543,719,77,2,2,9.80E-05,880710,0.993356643
18788,655,552,2,2,9.80E-05,880712,0.993358899
22702,1,682,2,2,9.80E-05,880714,0.993361155
24571,43,552,2,2,9.80E-05,880716,0.993363411
20926,699,10,2,2,9.80E-05,880718,0.993365667
24598,593,163,2,2,9.80E-05,880720,0.993367922
24600,720,2,2,2,9.80E-05,880722,0.993370178
24602,130,493,2,2,9.80E-05,880724,0.993372434
22369,242,714,2,2,9.80E-05,880726,0.99337469
24609,689,502,2,2,9.80E-05,880728,0.993376946
20906,501,511,2,2,9.80E-05,880730,0.993379201
22687,311,720,2,2,9.80E-05,880732,0.993381457
20905,661,331,2,2,9.80E-05,880734,0.993383713
24620,332,398,2,2,9.80E-05,880736,0.993385969
22683,404,126,2,2,9.80E-05,880738,0.993388225
20313,689,507,2,2,9.80E-05,880740,0.99339048
24624,1,720,2,2,9.80E-05,880742,0.993392736
22672,25,682,2,2,9.80E-05,880744,0.993394992
22670,90,479,2,2,9.80E-05,880746,0.993397248
22370,295,514,2,2,9.80E-05,880748,0.993399504
20316,246,473,2,2,9.80E-05,880750,0.99340176
20887,624,145,2,2,9.80E-05,880752,0.993404015
22373,404,392,2,2,9.80E-05,880754,0.993406271
24599,202,335,2,2,9.80E-05,880756,0.993408527
18430,9,290,2,2,9.80E-05,880758,0.993410783
22358,64,34,2,2,9.80E-05,880760,0.993413039
24574,170,347,2,2,9.80E-05,880762,0.993415294
20287,246,443,2,2,9.80E-05,880764,0.99341755
24575,682,20,2,2,9.80E-05,880766,0.993419806
24576,124,497,2,2,9.80E-05,880768,0.993422062
22351,133,6,2,2,9.80E-05,880770,0.993424318
24577,661,64,2,2,9.80E-05,880772,0.993426573
16202,31,587,2,2,9.80E-05,880774,0.993428829
18439,3,207,2,2,9.80E-05,880776,0.993431085
22354,64,379,2,2,9.80E-05,880778,0.993433341
22356,9,525,2,2,9.80E-05,880780,0.993435597
20915,193,313,2,2,9.80E-05,880782,0.993437852
16189,638,29,2,2,9.80E-05,880784,0.993440108
21177,269,393,2,2,9.80E-05,880786,0.993442364
24584,493,131,2,2,9.80E-05,880788,0.99344462
24585,721,15,2,2,9.80E-05,880790,0.993446876
18777,458,302,2,2,9.80E-05,880792,0.993449132
18441,3,171,2,2,9.80E-05,880794,0.993451387
24743,307,181,2,2,9.80E-05,880796,0.993453643
22618,514,689,2,2,9.80E-05,880798,0.993455899
32328,175,529,2,2,9.80E-05,880800,0.993458155
32203,458,618,2,2,9.80E-05,880802,0.993460411
18614,502,6,2,2,9.80E-05,880804,0.993462666
22522,155,311,2,2,9.80E-05,880806,0.993464922
24894,605,439,2,2,9.80E-05,880808,0.993467178
24895,479,174,2,2,9.80E-05,880810,0.993469434
24897,158,332,2,2,9.80E-05,880812,0.99347169
32208,114,569,2,2,9.80E-05,880814,0.993473945
18616,174,10,2,2,9.80E-05,880816,0.993476201
32201,668,25,2,2,9.80E-05,880818,0.993478457
32327,479,124,2,2,9.80E-05,880820,0.993480713
22519,588,23,2,2,9.80E-05,880822,0.993482969
24909,195,311,2,2,9.80E-05,880824,0.993485224
22512,114,511,2,2,9.80E-05,880826,0.99348748
18681,50,246,2,2,9.80E-05,880828,0.993489736
20558,503,302,2,2,9.80E-05,880830,0.993491992
22509,16,175,2,2,9.80E-05,880832,0.993494248
24914,295,593,2,2,9.80E-05,880834,0.993496503
22456,164,121,2,2,9.80E-05,880836,0.993498759
22445,178,230,2,2,9.80E-05,880838,0.993501015
24883,502,689,2,2,9.80E-05,880840,0.993503271
24882,48,174,2,2,9.80E-05,880842,0.993505527
32216,342,11,2,2,9.80E-05,880844,0.993507783
32233,663,43,2,2,9.80E-05,880846,0.993510038
22439,353,5,2,2,9.80E-05,880848,0.993512294
22534,699,9,2,2,9.80E-05,880850,0.99351455
24862,511,126,2,2,9.80E-05,880852,0.993516806
20698,398,683,2,2,9.80E-05,880854,0.993519062
18611,30,614,2,2,9.80E-05,880856,0.993521317
24866,558,646,2,2,9.80E-05,880858,0.993523573
20691,364,535,2,2,9.80E-05,880860,0.993525829
20690,141,68,2,2,9.80E-05,880862,0.993528085
24868,535,155,2,2,9.80E-05,880864,0.993530341
32223,181,723,2,2,9.80E-05,880866,0.993532596
24873,409,117,2,2,9.80E-05,880868,0.993534852
24874,503,167,2,2,9.80E-05,880870,0.993537108
22528,126,131,2,2,9.80E-05,880872,0.993539364
24877,13,448,2,2,9.80E-05,880874,0.99354162
20537,392,558,2,2,9.80E-05,880876,0.993543875
20679,646,334,2,2,9.80E-05,880878,0.993546131
24916,64,307,2,2,9.80E-05,880880,0.993548387
22458,195,638,2,2,9.80E-05,880882,0.993550643
22507,19,463,2,2,9.80E-05,880884,0.993552899
24951,525,140,2,2,9.80E-05,880886,0.993555155
22491,43,517,2,2,9.80E-05,880888,0.99355741
32167,354,720,2,2,9.80E-05,880890,0.993559666
22471,562,54,2,2,9.80E-05,880892,0.993561922
18665,207,10,2,2,9.80E-05,880894,0.993564178
20598,264,32,2,2,9.80E-05,880896,0.993566434
20602,246,10,2,2,9.80E-05,880898,0.993568689
24957,156,661,2,2,9.80E-05,880900,0.993570945
24959,124,501,2,2,9.80E-05,880902,0.993573201
22487,246,117,2,2,9.80E-05,880904,0.993575457
24964,163,347,2,2,9.80E-05,880906,0.993577713
24965,683,528,2,2,9.80E-05,880908,0.993579968
22474,393,294,2,2,9.80E-05,880910,0.993582224
32155,34,90,2,2,9.80E-05,880912,0.99358448
22475,532,661,2,2,9.80E-05,880914,0.993586736
24970,684,14,2,2,9.80E-05,880916,0.993588992
22476,130,720,2,2,9.80E-05,880918,0.993591247
24974,439,618,2,2,9.80E-05,880920,0.993593503
22470,493,655,2,2,9.80E-05,880922,0.993595759
22465,141,558,2,2,9.80E-05,880924,0.993598015
20656,596,587,2,2,9.80E-05,880926,0.993600271
24945,14,605,2,2,9.80E-05,880928,0.993602527
18624,158,126,2,2,9.80E-05,880930,0.993604782
24921,439,682,2,2,9.80E-05,880932,0.993607038
24922,269,313,2,2,9.80E-05,880934,0.993609294
20572,156,140,2,2,9.80E-05,880936,0.99361155
20650,638,294,2,2,9.80E-05,880938,0.993613806
24929,280,85,2,2,9.80E-05,880940,0.993616061
22505,525,596,2,2,9.80E-05,880942,0.993618317
20644,673,618,2,2,9.80E-05,880944,0.993620573
20591,95,682,2,2,9.80E-05,880946,0.993622829
24936,334,140,2,2,9.80E-05,880948,0.993625085
20637,721,164,2,2,9.80E-05,880950,0.99362734
24938,167,522,2,2,9.80E-05,880952,0.993629596
22496,331,494,2,2,9.80E-05,880954,0.993631852
24940,310,668,2,2,9.80E-05,880956,0.993634108
24941,543,328,2,2,9.80E-05,880958,0.993636364
18606,207,64,2,2,9.80E-05,880960,0.993638619
32236,568,34,2,2,9.80E-05,880962,0.993640875
22433,12,587,2,2,9.80E-05,880964,0.993643131
20462,107,174,2,2,9.80E-05,880966,0.993645387
32304,571,155,2,2,9.80E-05,880968,0.993647643
24770,427,682,2,2,9.80E-05,880970,0.993649898
24773,552,528,2,2,9.80E-05,880972,0.993652154
24774,14,202,2,2,9.80E-05,880974,0.99365441
22588,624,141,2,2,9.80E-05,880976,0.993656666
20465,717,30,2,2,9.80E-05,880978,0.993658922
22417,632,682,2,2,9.80E-05,880980,0.993661178
24779,613,31,2,2,9.80E-05,880982,0.993663433
24780,246,141,2,2,9.80E-05,880984,0.993665689
32293,178,242,2,2,9.80E-05,880986,0.993667945
20469,661,219,2,2,9.80E-05,880988,0.993670201
24785,367,193,2,2,9.80E-05,880990,0.993672457
22585,174,397,2,2,9.80E-05,880992,0.993674712
32288,626,331,2,2,9.80E-05,880994,0.993676968
24789,29,560,2,2,9.80E-05,880996,0.993679224
20750,397,29,2,2,9.80E-05,880998,0.99368148
22419,618,596,2,2,9.80E-05,881000,0.993683736
18730,404,427,2,2,9.80E-05,881002,0.993685991
18565,22,84,2,2,9.80E-05,881004,0.993688247
24795,274,646,2,2,9.80E-05,881006,0.993690503
22599,13,543,2,2,9.80E-05,881008,0.993692759
20777,439,514,2,2,9.80E-05,881010,0.993695015
24749,302,409,2,2,9.80E-05,881012,0.99369727
20776,532,133,2,2,9.80E-05,881014,0.993699526
20442,701,560,2,2,9.80E-05,881016,0.993701782
22616,558,269,2,2,9.80E-05,881018,0.993704038
24754,23,380,2,2,9.80E-05,881020,0.993706294
24755,394,174,2,2,9.80E-05,881022,0.99370855
24758,43,22,2,2,9.80E-05,881024,0.993710805
22602,397,171,2,2,9.80E-05,881026,0.993713061
20448,30,414,2,2,9.80E-05,881028,0.993715317
22411,501,587,2,2,9.80E-05,881030,0.993717573
20454,243,511,2,2,9.80E-05,881032,0.993719829
20461,475,265,2,2,9.80E-05,881034,0.993722084
24766,525,479,2,2,9.80E-05,881036,0.99372434
20761,175,20,2,2,9.80E-05,881038,0.993726596
22412,503,473,2,2,9.80E-05,881040,0.993728852
22420,347,140,2,2,9.80E-05,881042,0.993731108
32275,97,684,2,2,9.80E-05,881044,0.993733363
24853,494,479,2,2,9.80E-05,881046,0.993735619
20510,29,84,2,2,9.80E-05,881048,0.993737875
24821,404,508,2,2,9.80E-05,881050,0.993740131
32252,626,302,2,2,9.80E-05,881052,0.993742387
18720,397,482,2,2,9.80E-05,881054,0.993744642
22557,97,364,2,2,9.80E-05,881056,0.993746898
24831,138,196,2,2,9.80E-05,881058,0.993749154
24832,12,64,2,2,9.80E-05,881060,0.99375141
22430,613,334,2,2,9.80E-05,881062,0.993753666
24838,295,23,2,2,9.80E-05,881064,0.993755921
24840,311,719,2,2,9.80E-05,881066,0.993758177
24844,492,3,2,2,9.80E-05,881068,0.993760433
20714,54,6,2,2,9.80E-05,881070,0.993762689
18716,673,708,2,2,9.80E-05,881072,0.993764945
20512,307,328,2,2,9.80E-05,881074,0.993767201
20514,544,535,2,2,9.80E-05,881076,0.993769456
20711,397,493,2,2,9.80E-05,881078,0.993771712
32254,64,543,2,2,9.80E-05,881080,0.993773968
22561,219,332,2,2,9.80E-05,881082,0.993776224
22425,646,463,2,2,9.80E-05,881084,0.99377848
20483,699,123,2,2,9.80E-05,881086,0.993780735
32274,568,31,2,2,9.80E-05,881088,0.993782991
20487,295,85,2,2,9.80E-05,881090,0.993785247
32271,446,26,2,2,9.80E-05,881092,0.993787503
15984,64,80,2,2,9.80E-05,881094,0.993789759
32267,25,492,2,2,9.80E-05,881096,0.993792014
22572,97,175,2,2,9.80E-05,881098,0.99379427
24806,4,171,2,2,9.80E-05,881100,0.993796526
22568,29,117,2,2,9.80E-05,881102,0.993798782
20501,448,48,2,2,9.80E-05,881104,0.993801038
22567,133,156,2,2,9.80E-05,881106,0.993803293
24813,68,525,2,2,9.80E-05,881108,0.993805549
20502,514,543,2,2,9.80E-05,881110,0.993807805
22562,250,618,2,2,9.80E-05,881112,0.993810061
20506,164,20,2,2,9.80E-05,881114,0.993812317
16243,90,582,2,2,9.80E-05,881116,0.993814573
23267,492,130,2,2,9.80E-05,881118,0.993816828
22722,196,274,2,2,9.80E-05,881120,0.993819084
22252,207,638,2,2,9.80E-05,881122,0.99382134
21072,708,586,2,2,9.80E-05,881124,0.993823596
24334,290,5,2,2,9.80E-05,881126,0.993825852
21070,439,130,2,2,9.80E-05,881128,0.993828107
20156,196,502,2,2,9.80E-05,881130,0.993830363
21067,164,145,2,2,9.80E-05,881132,0.993832619
24342,23,394,2,2,9.80E-05,881134,0.993834875
24348,196,448,2,2,9.80E-05,881136,0.993837131
20154,668,535,2,2,9.80E-05,881138,0.993839386
24350,12,14,2,2,9.80E-05,881140,0.993841642
24351,448,334,2,2,9.80E-05,881142,0.993843898
18387,605,723,2,2,9.80E-05,881144,0.993846154
24353,12,319,2,2,9.80E-05,881146,0.99384841
18889,4,30,2,2,9.80E-05,881148,0.993850665
22259,290,196,2,2,9.80E-05,881150,0.993852921
18335,701,97,2,2,9.80E-05,881152,0.993855177
24331,492,48,2,2,9.80E-05,881154,0.993857433
24330,684,2,2,2,9.80E-05,881156,0.993859689
21017,605,562,2,2,9.80E-05,881158,0.993861945
20125,367,90,2,2,9.80E-05,881160,0.9938642
20131,25,689,2,2,9.80E-05,881162,0.993866456
24306,195,367,2,2,9.80E-05,881164,0.993868712
24307,19,354,2,2,9.80E-05,881166,0.993870968
22243,3,193,2,2,9.80E-05,881168,0.993873224
18326,219,482,2,2,9.80E-05,881170,0.993875479
24310,178,471,2,2,9.80E-05,881172,0.993877735
24314,507,552,2,2,9.80E-05,881174,0.993879991
22248,397,126,2,2,9.80E-05,881176,0.993882247
20133,414,246,2,2,9.80E-05,881178,0.993884503
20134,264,48,2,2,9.80E-05,881180,0.993886758
22247,618,22,2,2,9.80E-05,881182,0.993889014
16600,242,502,2,2,9.80E-05,881184,0.99389127
16592,458,9,2,2,9.80E-05,881186,0.993893526
20146,11,673,2,2,9.80E-05,881188,0.993895782
24324,613,14,2,2,9.80E-05,881190,0.993898037
24357,294,689,2,2,9.80E-05,881192,0.993900293
24358,463,174,2,2,9.80E-05,881194,0.993902549
20165,522,246,2,2,9.80E-05,881196,0.993904805
24411,717,219,2,2,9.80E-05,881198,0.993907061
24399,347,4,2,2,9.80E-05,881200,0.993909316
22762,265,126,2,2,9.80E-05,881202,0.993911572
24402,502,560,2,2,9.80E-05,881204,0.993913828
24405,689,117,2,2,9.80E-05,881206,0.993916084
22278,290,463,2,2,9.80E-05,881208,0.99391834
20182,178,195,2,2,9.80E-05,881210,0.993920596
21033,54,236,2,2,9.80E-05,881212,0.993922851
24412,517,195,2,2,9.80E-05,881214,0.993925107
24362,141,723,2,2,9.80E-05,881216,0.993927363
24413,618,25,2,2,9.80E-05,881218,0.993929619
18857,290,9,2,2,9.80E-05,881220,0.993931875
22281,56,174,2,2,9.80E-05,881222,0.99393413
21021,511,609,2,2,9.80E-05,881224,0.993936386
24427,605,294,2,2,9.80E-05,881226,0.993938642
16417,158,560,2,2,9.80E-05,881228,0.993940898
20192,2,171,2,2,9.80E-05,881230,0.993943154
22274,392,479,2,2,9.80E-05,881232,0.993945409
16440,439,84,2,2,9.80E-05,881234,0.993947665
24395,552,195,2,2,9.80E-05,881236,0.993949921
24394,50,174,2,2,9.80E-05,881238,0.993952177
22775,314,133,2,2,9.80E-05,881240,0.993954433
24368,56,493,2,2,9.80E-05,881242,0.993956688
21058,404,22,2,2,9.80E-05,881244,0.993958944
21057,493,529,2,2,9.80E-05,881246,0.9939612
21054,624,543,2,2,9.80E-05,881248,0.993963456
21052,514,163,2,2,9.80E-05,881250,0.993965712
20168,624,313,2,2,9.80E-05,881252,0.993967968
21050,138,107,2,2,9.80E-05,881254,0.993970223
24378,4,163,2,2,9.80E-05,881256,0.993972479
22770,529,508,2,2,9.80E-05,881258,0.993974735
21045,543,140,2,2,9.80E-05,881260,0.993976991
18879,668,50,2,2,9.80E-05,881262,0.993979247
24390,332,473,2,2,9.80E-05,881264,0.993981502
18871,138,311,2,2,9.80E-05,881266,0.993983758
24304,138,588,2,2,9.80E-05,881268,0.993986014
20121,347,242,2,2,9.80E-05,881270,0.99398827
24302,586,29,2,2,9.80E-05,881272,0.993990526
18932,313,178,2,2,9.80E-05,881274,0.993992781
24235,250,493,2,2,9.80E-05,881276,0.993995037
24236,328,543,2,2,9.80E-05,881278,0.993997293
24238,68,43,2,2,9.80E-05,881280,0.993999549
22222,347,385,2,2,9.80E-05,881282,0.994001805
21150,714,105,2,2,9.80E-05,881284,0.99400406
22224,511,560,2,2,9.80E-05,881286,0.994006316
21147,167,543,2,2,9.80E-05,881288,0.994008572
20080,673,4,2,2,9.80E-05,881290,0.994010828
22808,15,514,2,2,9.80E-05,881292,0.994013084
21142,605,708,2,2,9.80E-05,881294,0.994015339
22227,207,427,2,2,9.80E-05,881296,0.994017595
18921,385,528,2,2,9.80E-05,881298,0.994019851
18298,494,334,2,2,9.80E-05,881300,0.994022107
24251,290,34,2,2,9.80E-05,881302,0.994024363
16651,655,587,2,2,9.80E-05,881304,0.994026619
20081,514,12,2,2,9.80E-05,881306,0.994028874
24230,668,674,2,2,9.80E-05,881308,0.99403113
21151,446,10,2,2,9.80E-05,881310,0.994033386
22821,674,569,2,2,9.80E-05,881312,0.994035642
24223,342,27,2,2,9.80E-05,881314,0.994037898
22212,290,123,2,2,9.80E-05,881316,0.994040153
24197,618,13,2,2,9.80E-05,881318,0.994042409
22828,482,230,2,2,9.80E-05,881320,0.994044665
21172,609,14,2,2,9.80E-05,881322,0.994046921
22827,193,174,2,2,9.80E-05,881324,0.994049177
24205,699,219,2,2,9.80E-05,881326,0.994051432
18945,9,181,2,2,9.80E-05,881328,0.994053688
24209,16,290,2,2,9.80E-05,881330,0.994055944
21166,130,207,2,2,9.80E-05,881332,0.9940582
16690,582,525,2,2,9.80E-05,881334,0.994060456
20055,195,522,2,2,9.80E-05,881336,0.994062711
24220,32,525,2,2,9.80E-05,881338,0.994064967
21161,242,130,2,2,9.80E-05,881340,0.994067223
24222,43,167,2,2,9.80E-05,881342,0.994069479
18305,383,145,2,2,9.80E-05,881344,0.994071735
24256,528,164,2,2,9.80E-05,881346,0.994073991
24301,525,529,2,2,9.80E-05,881348,0.994076246
24291,383,646,2,2,9.80E-05,881350,0.994078502
24279,446,295,2,2,9.80E-05,881352,0.994080758
24280,571,348,2,2,9.80E-05,881354,0.994083014
21115,689,328,2,2,9.80E-05,881356,0.99408527
22795,502,427,2,2,9.80E-05,881358,0.994087525
24289,674,613,2,2,9.80E-05,881360,0.994089781
20110,164,543,2,2,9.80E-05,881362,0.994092037
21112,56,126,2,2,9.80E-05,881364,0.994094293
22790,331,193,2,2,9.80E-05,881366,0.994096549
16641,638,265,2,2,9.80E-05,881368,0.994098804
22240,558,332,2,2,9.80E-05,881370,0.99410106
22789,230,720,2,2,9.80E-05,881372,0.994103316
21111,138,502,2,2,9.80E-05,881374,0.994105572
20111,158,683,2,2,9.80E-05,881376,0.994107828
22788,586,493,2,2,9.80E-05,881378,0.994110083
22241,27,576,2,2,9.80E-05,881380,0.994112339
24278,558,624,2,2,9.80E-05,881382,0.994114595
24273,661,204,2,2,9.80E-05,881384,0.994116851
22799,195,663,2,2,9.80E-05,881386,0.994119107
22807,409,280,2,2,9.80E-05,881388,0.994121363
24258,3,269,2,2,9.80E-05,881390,0.994123618
21136,196,385,2,2,9.80E-05,881392,0.994125874
24260,117,708,2,2,9.80E-05,881394,0.99412813
20083,473,525,2,2,9.80E-05,881396,0.994130386
18308,264,311,2,2,9.80E-05,881398,0.994132642
24262,170,532,2,2,9.80E-05,881400,0.994134897
22230,596,138,2,2,9.80E-05,881402,0.994137153
21134,97,385,2,2,9.80E-05,881404,0.994139409
20089,409,14,2,2,9.80E-05,881406,0.994141665
21127,443,482,2,2,9.80E-05,881408,0.994143921
22231,174,50,2,2,9.80E-05,881410,0.994146176
22233,64,29,2,2,9.80E-05,881412,0.994148432
21124,141,655,2,2,9.80E-05,881414,0.994150688
21018,332,22,2,2,9.80E-05,881416,0.994152944
24352,498,138,2,2,9.80E-05,881418,0.9941552
20198,543,609,2,2,9.80E-05,881420,0.994157455
20977,90,588,2,2,9.80E-05,881422,0.994159711
18833,193,310,2,2,9.80E-05,881424,0.994161967
22748,511,50,2,2,9.80E-05,881426,0.994164223
20975,655,137,2,2,9.80E-05,881428,0.994166479
18815,295,683,2,2,9.80E-05,881430,0.994168734
16359,582,720,2,2,9.80E-05,881432,0.99417099
22732,26,673,2,2,9.80E-05,881434,0.994173246
20236,25,511,2,2,9.80E-05,881436,0.994175502
16297,443,587,2,2,9.80E-05,881438,0.994177758
20984,471,511,2,2,9.80E-05,881440,0.994180014
24457,593,560,2,2,9.80E-05,881442,0.994182269
24501,571,158,2,2,9.80E-05,881444,0.994184525
22299,364,328,2,2,9.80E-05,881446,0.994186781
22324,250,20,2,2,9.80E-05,881448,0.994189037
24503,16,181,2,2,9.80E-05,881450,0.994191293
24504,178,219,2,2,9.80E-05,881452,0.994193548
18836,48,673,2,2,9.80E-05,881454,0.994195804
20247,20,121,2,2,9.80E-05,881456,0.99419806
16270,103,68,2,2,9.80E-05,881458,0.994200316
24496,714,131,2,2,9.80E-05,881460,0.994202572
18381,133,31,2,2,9.80E-05,881462,0.994204827
24450,544,328,2,2,9.80E-05,881464,0.994207083
22739,646,683,2,2,9.80E-05,881466,0.994209339
20979,371,392,2,2,9.80E-05,881468,0.994211595
16345,2,586,2,2,9.80E-05,881470,0.994213851
16301,1,404,2,2,9.80E-05,881472,0.994216106
22741,31,605,2,2,9.80E-05,881474,0.994218362
20232,522,332,2,2,9.80E-05,881476,0.994220618
20987,674,593,2,2,9.80E-05,881478,0.994222874
24474,22,207,2,2,9.80E-05,881480,0.99422513
22311,544,167,2,2,9.80E-05,881482,0.994227386
24471,103,596,2,2,9.80E-05,881484,0.994229641
22315,719,498,2,2,9.80E-05,881486,0.994231897
22745,661,313,2,2,9.80E-05,881488,0.994234153
22309,552,714,2,2,9.80E-05,881490,0.994236409
20990,342,522,2,2,9.80E-05,881492,0.994238665
18366,379,593,2,2,9.80E-05,881494,0.99424092
24462,458,236,2,2,9.80E-05,881496,0.994243176
24493,56,290,2,2,9.80E-05,881498,0.994245432
24512,97,383,2,2,9.80E-05,881500,0.994247688
22321,380,494,2,2,9.80E-05,881502,0.994249944
20228,2,508,2,2,9.80E-05,881504,0.994252199
16252,23,80,2,2,9.80E-05,881506,0.994254455
20252,332,130,2,2,9.80E-05,881508,0.994256711
20965,353,29,2,2,9.80E-05,881510,0.994258967
24519,193,141,2,2,9.80E-05,881512,0.994261223
24515,404,29,2,2,9.80E-05,881514,0.994263478
22292,492,302,2,2,9.80E-05,881516,0.994265734
16380,264,123,2,2,9.80E-05,881518,0.99426799
24443,332,683,2,2,9.80E-05,881520,0.994270246
21002,497,163,2,2,9.80E-05,881522,0.994272502
22291,446,663,2,2,9.80E-05,881524,0.994274758
22329,236,569,2,2,9.80E-05,881526,0.994277013
20250,294,80,2,2,9.80E-05,881528,0.994279269
21244,588,668,4,1,0.000196078,881532,0.994283781
28167,371,354,4,1,0.000196078,881536,0.994288292
24142,475,569,4,1,0.000196078,881540,0.994292804
26240,433,105,4,1,0.000196078,881544,0.994297316
19088,25,20,4,1,0.000196078,881548,0.994301827
23246,613,280,3,1,0.000147059,881551,0.994305211
26840,56,202,3,1,0.000147059,881554,0.994308595
23057,264,723,3,1,0.000147059,881557,0.994311978
18329,492,123,3,1,0.000147059,881560,0.994315362
22743,717,145,3,1,0.000147059,881563,0.994318746
24472,274,175,3,1,0.000147059,881566,0.994322129
25418,164,140,3,1,0.000147059,881569,0.994325513
25500,392,95,3,1,0.000147059,881572,0.994328897
24796,721,723,3,1,0.000147059,881575,0.994332281
23505,720,145,3,1,0.000147059,881578,0.994335664
17511,605,261,3,1,0.000147059,881581,0.994339048
17410,103,379,3,1,0.000147059,881584,0.994342432
25829,364,295,3,1,0.000147059,881587,0.994345815
25866,54,85,3,1,0.000147059,881590,0.994349199
23891,29,586,3,1,0.000147059,881593,0.994352583
28005,155,294,3,1,0.000147059,881596,0.994355967
29507,638,699,3,1,0.000147059,881599,0.99435935
27917,364,511,3,1,0.000147059,881602,0.994362734
29634,409,661,3,1,0.000147059,881605,0.994366118
28534,364,56,3,1,0.000147059,881608,0.994369501
21288,721,674,3,1,0.000147059,881611,0.994372885
29205,80,699,3,1,0.000147059,881614,0.994376269
28414,90,347,3,1,0.000147059,881617,0.994379653
28310,145,593,3,1,0.000147059,881620,0.994383036
29062,332,482,3,1,0.000147059,881623,0.99438642
27247,427,708,3,1,0.000147059,881626,0.994389804
18960,618,626,3,1,0.000147059,881629,0.994393187
28335,517,652,2,1,9.80E-05,881631,0.994395443
31776,471,160,2,1,9.80E-05,881633,0.994397699
31758,663,721,2,1,9.80E-05,881635,0.994399955
31736,552,493,2,1,9.80E-05,881637,0.994402211
29023,56,13,2,1,9.80E-05,881639,0.994404467
30021,290,328,2,1,9.80E-05,881641,0.994406722
27062,392,674,2,1,9.80E-05,881643,0.994408978
28347,207,25,2,1,9.80E-05,881645,0.994411234
25497,30,290,2,1,9.80E-05,881647,0.99441349
31719,427,13,2,1,9.80E-05,881649,0.994415746
31765,90,392,2,1,9.80E-05,881651,0.994418001
31704,124,720,2,1,9.80E-05,881653,0.994420257
31604,178,501,2,1,9.80E-05,881655,0.994422513
26938,655,618,2,1,9.80E-05,881657,0.994424769
31621,718,280,2,1,9.80E-05,881659,0.994427025
29211,721,246,2,1,9.80E-05,881661,0.99442928
28208,458,126,2,1,9.80E-05,881663,0.994431536
31591,528,699,2,1,9.80E-05,881665,0.994433792
28212,718,33,2,1,9.80E-05,881667,0.994436048
28211,175,380,2,1,9.80E-05,881669,0.994438304
31691,684,261,2,1,9.80E-05,881671,0.994440559
28303,508,54,2,1,9.80E-05,881673,0.994442815
31686,511,202,2,1,9.80E-05,881675,0.994445071
30000,409,204,2,1,9.80E-05,881677,0.994447327
28330,614,193,2,1,9.80E-05,881679,0.994449583
31699,497,124,2,1,9.80E-05,881681,0.994451838
25540,314,19,2,1,9.80E-05,881683,0.994454094
31696,528,446,2,1,9.80E-05,881685,0.99445635
26978,90,114,2,1,9.80E-05,881687,0.994458606
25613,588,342,2,1,9.80E-05,881689,0.994460862
25617,543,503,2,1,9.80E-05,881691,0.994463118
31673,13,721,2,1,9.80E-05,881693,0.994465373
28285,85,16,2,1,9.80E-05,881695,0.994467629
31662,85,353,2,1,9.80E-05,881697,0.994469885
25590,525,427,2,1,9.80E-05,881699,0.994472141
28606,294,56,2,1,9.80E-05,881701,0.994474397
32063,265,493,2,1,9.80E-05,881703,0.994476652
32059,714,493,2,1,9.80E-05,881705,0.994478908
30158,178,141,2,1,9.80E-05,881707,0.994481164
28591,103,682,2,1,9.80E-05,881709,0.99448342
27223,479,342,2,1,9.80E-05,881711,0.994485676
28638,32,492,2,1,9.80E-05,881713,0.994487931
32020,458,652,2,1,9.80E-05,881715,0.994490187
25146,528,640,2,1,9.80E-05,881717,0.994492443
30162,640,719,2,1,9.80E-05,881719,0.994494699
28709,394,446,2,1,9.80E-05,881721,0.994496955
28707,195,397,2,1,9.80E-05,881723,0.99449921
28734,507,207,2,1,9.80E-05,881725,0.994501466
25052,593,613,2,1,9.80E-05,881727,0.994503722
32103,164,1,2,1,9.80E-05,881729,0.994505978
30143,171,383,2,1,9.80E-05,881731,0.994508234
28771,552,593,2,1,9.80E-05,881733,0.99451049
28775,230,668,2,1,9.80E-05,881735,0.994512745
28765,517,661,2,1,9.80E-05,881737,0.994515001
28668,409,5,2,1,9.80E-05,881739,0.994517257
28760,6,719,2,1,9.80E-05,881741,0.994519513
27278,163,20,2,1,9.80E-05,881743,0.994521769
31885,571,130,2,1,9.80E-05,881745,0.994524024
31881,196,684,2,1,9.80E-05,881747,0.99452628
27079,525,167,2,1,9.80E-05,881749,0.994528536
31854,482,175,2,1,9.80E-05,881751,0.994530792
28938,717,11,2,1,9.80E-05,881753,0.994533048
28491,19,103,2,1,9.80E-05,881755,0.994535303
31902,121,64,2,1,9.80E-05,881757,0.994537559
27274,103,398,2,1,9.80E-05,881759,0.994539815
25355,479,261,2,1,9.80E-05,881761,0.994542071
27074,264,204,2,1,9.80E-05,881763,0.994544327
31793,50,494,2,1,9.80E-05,881765,0.994546582
30044,290,684,2,1,9.80E-05,881767,0.994548838
28952,158,246,2,1,9.80E-05,881769,0.994551094
31834,90,141,2,1,9.80E-05,881771,0.99455335
25228,593,482,2,1,9.80E-05,881773,0.994555606
31951,196,409,2,1,9.80E-05,881775,0.994557861
28894,64,170,2,1,9.80E-05,881777,0.994560117
25197,354,269,2,1,9.80E-05,881779,0.994562373
27249,261,383,2,1,9.80E-05,881781,0.994564629
28859,193,576,2,1,9.80E-05,881783,0.994566885
28545,145,652,2,1,9.80E-05,881785,0.994569141
31916,626,48,2,1,9.80E-05,881787,0.994571396
27267,269,562,2,1,9.80E-05,881789,0.994573652
31933,646,140,2,1,9.80E-05,881791,0.994575908
28516,448,107,2,1,9.80E-05,881793,0.994578164
28154,528,140,2,1,9.80E-05,881795,0.99458042
29867,64,167,2,1,9.80E-05,881797,0.994582675
27782,494,532,2,1,9.80E-05,881799,0.994584931
26702,3,137,2,1,9.80E-05,881801,0.994587187
27504,19,164,2,1,9.80E-05,881803,0.994589443
30590,718,632,2,1,9.80E-05,881805,0.994591699
26674,717,131,2,1,9.80E-05,881807,0.994593954
29653,257,114,2,1,9.80E-05,881809,0.99459621
27748,64,174,2,1,9.80E-05,881811,0.994598466
30992,398,492,2,1,9.80E-05,881813,0.994600722
26675,522,175,2,1,9.80E-05,881815,0.994602978
26204,145,668,2,1,9.80E-05,881817,0.994605233
26736,261,22,2,1,9.80E-05,881819,0.994607489
27854,29,609,2,1,9.80E-05,881821,0.994609745
26738,34,12,2,1,9.80E-05,881823,0.994612001
30580,156,569,2,1,9.80E-05,881825,0.994614257
27819,294,663,2,1,9.80E-05,881827,0.994616513
26208,137,443,2,1,9.80E-05,881829,0.994618768
26212,207,280,2,1,9.80E-05,881831,0.994621024
27566,701,5,2,1,9.80E-05,881833,0.99462328
29824,371,353,2,1,9.80E-05,881835,0.994625536
29751,103,552,2,1,9.80E-05,881837,0.994627792
26510,43,673,2,1,9.80E-05,881839,0.994630047
30794,525,14,2,1,9.80E-05,881841,0.994632303
26584,264,328,2,1,9.80E-05,881843,0.994634559
30712,171,652,2,1,9.80E-05,881845,0.994636815
27704,497,4,2,1,9.80E-05,881847,0.994639071
26444,265,571,2,1,9.80E-05,881849,0.994641326
26388,701,708,2,1,9.80E-05,881851,0.994643582
27713,141,295,2,1,9.80E-05,881853,0.994645838
26394,124,195,2,1,9.80E-05,881855,0.994648094
27540,497,133,2,1,9.80E-05,881857,0.99465035
29840,178,562,2,1,9.80E-05,881859,0.994652605
30829,174,414,2,1,9.80E-05,881861,0.994654861
31115,626,77,2,1,9.80E-05,881863,0.994657117
26856,560,31,2,1,9.80E-05,881865,0.994659373
31352,164,269,2,1,9.80E-05,881867,0.994661629
31398,155,528,2,1,9.80E-05,881869,0.994663885
31404,334,137,2,1,9.80E-05,881871,0.99466614
26870,30,605,2,1,9.80E-05,881873,0.994668396
25896,246,265,2,1,9.80E-05,881875,0.994670652
30473,723,31,2,1,9.80E-05,881877,0.994672908
31326,175,479,2,1,9.80E-05,881879,0.994675164
31321,511,433,2,1,9.80E-05,881881,0.994677419
29345,723,543,2,1,9.80E-05,881883,0.994679675
28074,701,394,2,1,9.80E-05,881885,0.994681931
29327,117,723,2,1,9.80E-05,881887,0.994684187
25913,310,371,2,1,9.80E-05,881889,0.994686443
25771,12,493,2,1,9.80E-05,881891,0.994688698
31504,492,13,2,1,9.80E-05,881893,0.994690954
31496,178,385,2,1,9.80E-05,881895,0.99469321
31513,576,661,2,1,9.80E-05,881897,0.994695466
31523,167,124,2,1,9.80E-05,881899,0.994697722
31425,29,207,2,1,9.80E-05,881901,0.994699977
31421,167,569,2,1,9.80E-05,881903,0.994702233
29278,23,30,2,1,9.80E-05,881905,0.994704489
31446,587,367,2,1,9.80E-05,881907,0.994706745
29347,269,145,2,1,9.80E-05,881909,0.994709001
29459,720,295,2,1,9.80E-05,881911,0.994711256
31179,140,269,2,1,9.80E-05,881913,0.994713512
31178,85,236,2,1,9.80E-05,881915,0.994715768
31206,19,202,2,1,9.80E-05,881917,0.994718024
26056,439,562,2,1,9.80E-05,881919,0.99472028
27920,720,552,2,1,9.80E-05,881921,0.994722536
27887,392,714,2,1,9.80E-05,881923,0.994724791
26755,652,479,2,1,9.80E-05,881925,0.994727047
26104,140,364,2,1,9.80E-05,881927,0.994729303
31222,493,22,2,1,9.80E-05,881929,0.994731559
27437,14,404,2,1,9.80E-05,881931,0.994733815
29918,156,137,2,1,9.80E-05,881933,0.99473607
26810,638,85,2,1,9.80E-05,881935,0.994738326
31270,571,243,2,1,9.80E-05,881937,0.994740582
27972,202,164,2,1,9.80E-05,881939,0.994742838
27449,50,269,2,1,9.80E-05,881941,0.994745094
31234,342,558,2,1,9.80E-05,881943,0.994747349
26029,507,624,2,1,9.80E-05,881945,0.994749605
26779,2,587,2,1,9.80E-05,881947,0.994751861
27989,458,708,2,1,9.80E-05,881949,0.994754117
31267,170,562,2,1,9.80E-05,881951,0.994756373
31266,703,15,2,1,9.80E-05,881953,0.994758628
27446,95,571,2,1,9.80E-05,881955,0.994760884
22082,167,30,2,1,9.80E-05,881957,0.99476314
22953,723,68,2,1,9.80E-05,881959,0.994765396
22114,30,19,2,1,9.80E-05,881961,0.994767652
23916,497,174,2,1,9.80E-05,881963,0.994769908
19842,397,20,2,1,9.80E-05,881965,0.994772163
23763,448,446,2,1,9.80E-05,881967,0.994774419
23802,54,427,2,1,9.80E-05,881969,0.994776675
23806,133,683,2,1,9.80E-05,881971,0.994778931
23811,683,280,2,1,9.80E-05,881973,0.994781187
22966,593,507,2,1,9.80E-05,881975,0.994783442
24108,243,43,2,1,9.80E-05,881977,0.994785698
21184,393,511,2,1,9.80E-05,881979,0.994787954
22830,196,364,2,1,9.80E-05,881981,0.99479021
21307,25,56,2,1,9.80E-05,881983,0.994792466
24024,243,613,2,1,9.80E-05,881985,0.994794721
16986,265,145,2,1,9.80E-05,881987,0.994796977
16962,138,393,2,1,9.80E-05,881989,0.994799233
24085,517,673,2,1,9.80E-05,881991,0.994801489
24049,294,30,2,1,9.80E-05,881993,0.994803745
23387,11,1,2,1,9.80E-05,881995,0.994806
23441,463,178,2,1,9.80E-05,881997,0.994808256
23178,280,576,2,1,9.80E-05,881999,0.994810512
21700,514,167,2,1,9.80E-05,882001,0.994812768
23175,493,348,2,1,9.80E-05,882003,0.994815024
23162,164,364,2,1,9.80E-05,882005,0.994817279
19306,720,224,2,1,9.80E-05,882007,0.994819535
23312,475,661,2,1,9.80E-05,882009,0.994821791
23274,175,22,2,1,9.80E-05,882011,0.994824047
21857,498,661,2,1,9.80E-05,882013,0.994826303
23343,160,95,2,1,9.80E-05,882015,0.994828559
21799,439,560,2,1,9.80E-05,882017,0.994830814
23355,475,85,2,1,9.80E-05,882019,0.99483307
21995,682,683,2,1,9.80E-05,882021,0.994835326
23622,140,683,2,1,9.80E-05,882023,0.994837582
23082,12,138,2,1,9.80E-05,882025,0.994839838
23657,160,535,2,1,9.80E-05,882027,0.994842093
23670,618,19,2,1,9.80E-05,882029,0.994844349
22020,295,383,2,1,9.80E-05,882031,0.994846605
23152,668,64,2,1,9.80E-05,882033,0.994848861
21973,310,332,2,1,9.80E-05,882035,0.994851117
23136,614,29,2,1,9.80E-05,882037,0.994853372
21635,494,107,2,1,9.80E-05,882039,0.994855628
23124,482,164,2,1,9.80E-05,882041,0.994857884
23564,302,494,2,1,9.80E-05,882043,0.99486014
24664,269,107,2,1,9.80E-05,882045,0.994862396
24667,497,503,2,1,9.80E-05,882047,0.994864651
20358,582,571,2,1,9.80E-05,882049,0.994866907
20415,294,131,2,1,9.80E-05,882051,0.994869163
22396,23,105,2,1,9.80E-05,882053,0.994871419
32345,433,331,2,1,9.80E-05,882055,0.994873675
20910,446,158,2,1,9.80E-05,882057,0.994875931
32207,16,19,2,1,9.80E-05,882059,0.994878186
22499,503,123,2,1,9.80E-05,882061,0.994880442
24935,170,348,2,1,9.80E-05,882063,0.994882698
24764,543,714,2,1,9.80E-05,882065,0.994884954
24835,11,493,2,1,9.80E-05,882067,0.99488721
24836,193,596,2,1,9.80E-05,882069,0.994889465
15964,164,334,2,1,9.80E-05,882071,0.994891721
20495,498,12,2,1,9.80E-05,882073,0.994893977
20497,164,609,2,1,9.80E-05,882075,0.994896233
20160,514,121,2,1,9.80E-05,882077,0.994898489
22244,195,471,2,1,9.80E-05,882079,0.994900744
24380,719,562,2,1,9.80E-05,882081,0.994903
24195,593,632,2,1,9.80E-05,882083,0.994905256
24296,525,4,2,1,9.80E-05,882085,0.994907512
24276,379,569,2,1,9.80E-05,882087,0.994909768
18916,507,529,2,1,9.80E-05,882089,0.994912023
16356,133,313,2,1,9.80E-05,882091,0.994914279
24495,32,719,2,1,9.80E-05,882093,0.994916535
24478,371,582,2,1,9.80E-05,882095,0.994918791
20222,385,427,2,1,9.80E-05,882097,0.994921047
20961,29,443,2,1,9.80E-05,882099,0.994923303
34387,1,85,1,1,4.90E-05,882100,0.99492443
29727,261,163,1,1,4.90E-05,882101,0.994925558
29907,379,19,1,1,4.90E-05,882102,0.994926686
34537,624,124,1,1,4.90E-05,882103,0.994927814
29941,571,582,1,1,4.90E-05,882104,0.994928942
34218,721,29,1,1,4.90E-05,882105,0.99493007
34377,497,448,1,1,4.90E-05,882106,0.994931198
29724,354,138,1,1,4.90E-05,882107,0.994932326
29732,618,673,1,1,4.90E-05,882108,0.994933454
29988,708,482,1,1,4.90E-05,882109,0.994934582
34216,492,133,1,1,4.90E-05,882110,0.994935709
34439,703,596,1,1,4.90E-05,882111,0.994936837
34531,126,171,1,1,4.90E-05,882112,0.994937965
34645,121,204,1,1,4.90E-05,882113,0.994939093
29940,404,174,1,1,4.90E-05,882114,0.994940221
29698,219,668,1,1,4.90E-05,882115,0.994941349
34506,250,494,1,1,4.90E-05,882116,0.994942477
34214,145,371,1,1,4.90E-05,882117,0.994943605
29908,718,582,1,1,4.90E-05,882118,0.994944733
29699,525,511,1,1,4.90E-05,882119,0.994945861
34208,492,673,1,1,4.90E-05,882120,0.994946988
34650,342,29,1,1,4.90E-05,882121,0.994948116
29835,207,181,1,1,4.90E-05,882122,0.994949244
29938,498,319,1,1,4.90E-05,882123,0.994950372
29937,703,31,1,1,4.90E-05,882124,0.9949515
34405,43,458,1,1,4.90E-05,882125,0.994952628
34314,717,448,1,1,4.90E-05,882126,0.994953756
29697,195,103,1,1,4.90E-05,882127,0.994954884
29733,699,196,1,1,4.90E-05,882128,0.994956012
34707,398,160,1,1,4.90E-05,882129,0.99495714
30081,632,719,1,1,4.90E-05,882130,0.994958268
34454,661,56,1,1,4.90E-05,882131,0.994959395
34638,626,175,1,1,4.90E-05,882132,0.994960523
34409,130,699,1,1,4.90E-05,882133,0.994961651
29692,121,398,1,1,4.90E-05,882134,0.994962779
29942,562,160,1,1,4.90E-05,882135,0.994963907
34633,414,721,1,1,4.90E-05,882136,0.994965035
29693,409,493,1,1,4.90E-05,882137,0.994966163
34303,683,364,1,1,4.90E-05,882138,0.994967291
34542,193,23,1,1,4.90E-05,882139,0.994968419
29831,528,19,1,1,4.90E-05,882140,0.994969547
29745,446,290,1,1,4.90E-05,882141,0.994970674
34709,294,544,1,1,4.90E-05,882142,0.994971802
29747,138,170,1,1,4.90E-05,882143,0.99497293
34452,652,640,1,1,4.90E-05,882144,0.994974058
34700,517,124,1,1,4.90E-05,882145,0.994975186
29737,684,404,1,1,4.90E-05,882146,0.994976314
29904,568,97,1,1,4.90E-05,882147,0.994977442
34374,11,492,1,1,4.90E-05,882148,0.99497857
29837,103,319,1,1,4.90E-05,882149,0.994979698
34639,97,492,1,1,4.90E-05,882150,0.994980826
34292,124,364,1,1,4.90E-05,882151,0.994981954
29696,552,446,1,1,4.90E-05,882152,0.994983081
29847,354,133,1,1,4.90E-05,882153,0.994984209
30083,160,593,1,1,4.90E-05,882154,0.994985337
29832,126,313,1,1,4.90E-05,882155,0.994986465
30102,257,427,1,1,4.90E-05,882156,0.994987593
29925,158,124,1,1,4.90E-05,882157,0.994988721
34508,114,160,1,1,4.90E-05,882158,0.994989849
34290,354,458,1,1,4.90E-05,882159,0.994990977
29741,392,25,1,1,4.90E-05,882160,0.994992105
34444,626,335,1,1,4.90E-05,882161,0.994993233
29721,719,571,1,1,4.90E-05,882162,0.99499436
34414,618,269,1,1,4.90E-05,882163,0.994995488
29935,164,427,1,1,4.90E-05,882164,0.994996616
34398,433,596,1,1,4.90E-05,882165,0.994997744
34431,448,342,1,1,4.90E-05,882166,0.994998872
29995,243,294,1,1,4.90E-05,882167,0.995
29713,121,170,1,1,4.90E-05,882168,0.995001128
34519,167,514,1,1,4.90E-05,882169,0.995002256
29708,207,294,1,1,4.90E-05,882170,0.995003384
29707,699,655,1,1,4.90E-05,882171,0.995004512
29934,121,708,1,1,4.90E-05,882172,0.99500564
29843,492,663,1,1,4.90E-05,882173,0.995006767
34677,626,1,1,1,4.90E-05,882174,0.995007895
34207,427,207,1,1,4.90E-05,882175,0.995009023
29994,30,720,1,1,4.90E-05,882176,0.995010151
29912,164,12,1,1,4.90E-05,882177,0.995011279
34523,137,364,1,1,4.90E-05,882178,0.995012407
29846,682,409,1,1,4.90E-05,882179,0.995013535
34198,175,552,1,1,4.90E-05,882180,0.995014663
30004,543,720,1,1,4.90E-05,882181,0.995015791
30003,596,137,1,1,4.90E-05,882182,0.995016919
34306,29,170,1,1,4.90E-05,882183,0.995018046
29930,193,398,1,1,4.90E-05,882184,0.995019174
34415,265,576,1,1,4.90E-05,882185,0.995020302
29710,334,195,1,1,4.90E-05,882186,0.99502143
29845,458,34,1,1,4.90E-05,882187,0.995022558
29929,160,393,1,1,4.90E-05,882188,0.995023686
34417,126,544,1,1,4.90E-05,882189,0.995024814
34199,404,448,1,1,4.90E-05,882190,0.995025942
34202,684,54,1,1,4.90E-05,882191,0.99502707
34293,48,719,1,1,4.90E-05,882192,0.995028198
34298,311,721,1,1,4.90E-05,882193,0.995029326
29711,385,155,1,1,4.90E-05,882194,0.995030453
34204,114,448,1,1,4.90E-05,882195,0.995031581
30097,699,274,1,1,4.90E-05,882196,0.995032709
34421,178,593,1,1,4.90E-05,882197,0.995033837
29915,13,117,1,1,4.90E-05,882198,0.995034965
29852,163,56,1,1,4.90E-05,882199,0.995036093
29714,626,224,1,1,4.90E-05,882200,0.995037221
30092,97,701,1,1,4.90E-05,882201,0.995038349
34401,508,471,1,1,4.90E-05,882202,0.995039477
34530,2,160,1,1,4.90E-05,882203,0.995040605
34411,141,632,1,1,4.90E-05,882204,0.995041732
29704,22,684,1,1,4.90E-05,882205,0.99504286
34509,170,543,1,1,4.90E-05,882206,0.995043988
29839,64,294,1,1,4.90E-05,882207,0.995045116
29909,721,427,1,1,4.90E-05,882208,0.995046244
29991,103,167,1,1,4.90E-05,882209,0.995047372
30008,414,126,1,1,4.90E-05,882210,0.9950485
34669,156,494,1,1,4.90E-05,882211,0.995049628
34437,525,126,1,1,4.90E-05,882212,0.995050756
30089,145,493,1,1,4.90E-05,882213,0.995051884
34668,302,342,1,1,4.90E-05,882214,0.995053012
34659,517,319,1,1,4.90E-05,882215,0.995054139
34654,50,178,1,1,4.90E-05,882216,0.995055267
34434,181,497,1,1,4.90E-05,882217,0.995056395
29997,427,174,1,1,4.90E-05,882218,0.995057523
34432,156,721,1,1,4.90E-05,882219,0.995058651
29718,560,80,1,1,4.90E-05,882220,0.995059779
34526,290,385,1,1,4.90E-05,882221,0.995060907
29715,163,138,1,1,4.90E-05,882222,0.995062035
29854,230,494,1,1,4.90E-05,882223,0.995063163
30006,137,280,1,1,4.90E-05,882224,0.995064291
30007,290,155,1,1,4.90E-05,882225,0.995065418
30001,22,661,1,1,4.90E-05,882226,0.995066546
29841,560,310,1,1,4.90E-05,882227,0.995067674
34433,290,195,1,1,4.90E-05,882228,0.995068802
34674,193,503,1,1,4.90E-05,882229,0.99506993
29910,684,294,1,1,4.90E-05,882230,0.995071058
34678,571,427,1,1,4.90E-05,882231,0.995072186
30091,528,383,1,1,4.90E-05,882232,0.995073314
34671,175,588,1,1,4.90E-05,882233,0.995074442
30090,261,682,1,1,4.90E-05,882234,0.99507557
30088,19,121,1,1,4.90E-05,882235,0.995076697
34459,242,193,1,1,4.90E-05,882236,0.995077825
29748,507,593,1,1,4.90E-05,882237,0.995078953
29870,97,493,1,1,4.90E-05,882238,0.995080081
34598,126,145,1,1,4.90E-05,882239,0.995081209
29868,64,246,1,1,4.90E-05,882240,0.995082337
34337,497,446,1,1,4.90E-05,882241,0.995083465
34253,463,719,1,1,4.90E-05,882242,0.995084593
29869,246,613,1,1,4.90E-05,882243,0.995085721
29884,13,683,1,1,4.90E-05,882244,0.995086849
30053,202,618,1,1,4.90E-05,882245,0.995087977
34478,164,342,1,1,4.90E-05,882246,0.995089104
30028,140,392,1,1,4.90E-05,882247,0.995090232
29860,195,290,1,1,4.90E-05,882248,0.99509136
34594,160,723,1,1,4.90E-05,882249,0.995092488
34318,414,13,1,1,4.90E-05,882250,0.995093616
29788,130,701,1,1,4.90E-05,882251,0.995094744
29790,571,167,1,1,4.90E-05,882252,0.995095872
30051,507,13,1,1,4.90E-05,882253,0.995097
34252,207,562,1,1,4.90E-05,882254,0.995098128
29882,392,4,1,1,4.90E-05,882255,0.995099256
29792,532,181,1,1,4.90E-05,882256,0.995100383
34498,414,342,1,1,4.90E-05,882257,0.995101511
29782,717,334,1,1,4.90E-05,882258,0.995102639
29864,568,295,1,1,4.90E-05,882259,0.995103767
29967,19,140,1,1,4.90E-05,882260,0.995104895
29861,138,605,1,1,4.90E-05,882261,0.995106023
30025,364,543,1,1,4.90E-05,882262,0.995107151
34316,433,25,1,1,4.90E-05,882263,0.995108279
34232,493,448,1,1,4.90E-05,882264,0.995109407
29862,302,137,1,1,4.90E-05,882265,0.995110535
29957,334,174,1,1,4.90E-05,882266,0.995111663
30027,133,508,1,1,4.90E-05,882267,0.99511279
34242,353,668,1,1,4.90E-05,882268,0.995113918
29981,261,133,1,1,4.90E-05,882269,0.995115046
34600,178,392,1,1,4.90E-05,882270,0.995116174
34344,175,497,1,1,4.90E-05,882271,0.995117302
29885,14,246,1,1,4.90E-05,882272,0.99511843
29965,613,514,1,1,4.90E-05,882273,0.995119558
29863,503,663,1,1,4.90E-05,882274,0.995120686
34342,80,202,1,1,4.90E-05,882275,0.995121814
29966,295,613,1,1,4.90E-05,882276,0.995122942
29781,347,571,1,1,4.90E-05,882277,0.995124069
30050,29,511,1,1,4.90E-05,882278,0.995125197
34336,207,124,1,1,4.90E-05,882279,0.995126325
29970,156,103,1,1,4.90E-05,882280,0.995127453
29974,97,163,1,1,4.90E-05,882281,0.995128581
29876,613,632,1,1,4.90E-05,882282,0.995129709
34493,479,371,1,1,4.90E-05,882283,0.995130837
34572,427,371,1,1,4.90E-05,882284,0.995131965
30040,170,274,1,1,4.90E-05,882285,0.995133093
29873,43,155,1,1,4.90E-05,882286,0.995134221
30038,646,689,1,1,4.90E-05,882287,0.995135349
34330,13,133,1,1,4.90E-05,882288,0.995136476
34326,354,124,1,1,4.90E-05,882289,0.995137604
30034,371,673,1,1,4.90E-05,882290,0.995138732
29795,181,367,1,1,4.90E-05,882291,0.99513986
29976,544,202,1,1,4.90E-05,882292,0.995140988
29872,175,335,1,1,4.90E-05,882293,0.995142116
34587,701,250,1,1,4.90E-05,882294,0.995143244
29799,517,13,1,1,4.90E-05,882295,0.995144372
29804,652,224,1,1,4.90E-05,882296,0.9951455
34495,721,493,1,1,4.90E-05,882297,0.995146628
34322,126,364,1,1,4.90E-05,882298,0.995147755
34490,353,342,1,1,4.90E-05,882299,0.995148883
30042,64,195,1,1,4.90E-05,882300,0.995150011
34479,409,593,1,1,4.90E-05,882301,0.995151139
29973,448,683,1,1,4.90E-05,882302,0.995152267
29980,446,448,1,1,4.90E-05,882303,0.995153395
30046,514,569,1,1,4.90E-05,882304,0.995154523
29881,511,12,1,1,4.90E-05,882305,0.995155651
34319,207,265,1,1,4.90E-05,882306,0.995156779
29812,433,348,1,1,4.90E-05,882307,0.995157907
29811,43,207,1,1,4.90E-05,882308,0.995159035
34481,568,380,1,1,4.90E-05,882309,0.995160162
34564,342,145,1,1,4.90E-05,882310,0.99516129
30032,514,618,1,1,4.90E-05,882311,0.995162418
30033,683,652,1,1,4.90E-05,882312,0.995163546
29793,409,130,1,1,4.90E-05,882313,0.995164674
34247,29,605,1,1,4.90E-05,882314,0.995165802
30043,492,2,1,1,4.90E-05,882315,0.99516693
34571,130,202,1,1,4.90E-05,882316,0.995168058
34489,632,409,1,1,4.90E-05,882317,0.995169186
34248,587,77,1,1,4.90E-05,882318,0.995170314
34321,404,721,1,1,4.90E-05,882319,0.995171441
34345,85,596,1,1,4.90E-05,882320,0.995172569
34501,332,552,1,1,4.90E-05,882321,0.995173697
34455,155,624,1,1,4.90E-05,882322,0.995174825
34465,701,121,1,1,4.90E-05,882323,0.995175953
34315,646,1,1,1,4.90E-05,882324,0.995177081
34625,124,56,1,1,4.90E-05,882325,0.995178209
29948,236,719,1,1,4.90E-05,882326,0.995179337
34549,196,319,1,1,4.90E-05,882327,0.995180465
34622,332,294,1,1,4.90E-05,882328,0.995181593
34463,371,439,1,1,4.90E-05,882329,0.995182721
29984,703,475,1,1,4.90E-05,882330,0.995183848
34620,5,605,1,1,4.90E-05,882331,0.995184976
29762,334,290,1,1,4.90E-05,882332,0.995186104
34559,265,492,1,1,4.90E-05,882333,0.995187232
34225,708,652,1,1,4.90E-05,882334,0.99518836
34556,701,673,1,1,4.90E-05,882335,0.995189488
29765,33,525,1,1,4.90E-05,882336,0.995190616
29767,661,354,1,1,4.90E-05,882337,0.995191744
34278,624,385,1,1,4.90E-05,882338,0.995192872
30064,178,655,1,1,4.90E-05,882339,0.995194
29892,708,514,1,1,4.90E-05,882340,0.995195127
34275,663,433,1,1,4.90E-05,882341,0.995196255
29946,508,302,1,1,4.90E-05,882342,0.995197383
30068,160,683,1,1,4.90E-05,882343,0.995198511
34503,552,43,1,1,4.90E-05,882344,0.995199639
34626,492,1,1,1,4.90E-05,882345,0.995200767
30014,103,140,1,1,4.90E-05,882346,0.995201895
30016,482,723,1,1,4.90E-05,882347,0.995203023
34219,219,525,1,1,4.90E-05,882348,0.995204151
34632,175,582,1,1,4.90E-05,882349,0.995205279
29830,29,587,1,1,4.90E-05,882350,0.995206406
34220,15,342,1,1,4.90E-05,882351,0.995207534
29828,178,250,1,1,4.90E-05,882352,0.995208662
34573,90,404,1,1,4.90E-05,882353,0.99520979
29753,354,332,1,1,4.90E-05,882354,0.995210918
34460,126,507,1,1,4.90E-05,882355,0.995212046
29894,492,22,1,1,4.90E-05,882356,0.995213174
30018,334,646,1,1,4.90E-05,882357,0.995214302
34222,334,269,1,1,4.90E-05,882358,0.99521543
34281,508,593,1,1,4.90E-05,882359,0.995216558
34223,155,605,1,1,4.90E-05,882360,0.995217686
29827,307,673,1,1,4.90E-05,882361,0.995218813
30069,114,720,1,1,4.90E-05,882362,0.995219941
29891,385,618,1,1,4.90E-05,882363,0.995221069
34264,448,701,1,1,4.90E-05,882364,0.995222197
29949,587,311,1,1,4.90E-05,882365,0.995223325
34231,626,588,1,1,4.90E-05,882366,0.995224453
29773,718,145,1,1,4.90E-05,882367,0.995225581
34347,195,175,1,1,4.90E-05,882368,0.995226709
34603,684,624,1,1,4.90E-05,882369,0.995227837
34558,121,493,1,1,4.90E-05,882370,0.995228965
29774,508,347,1,1,4.90E-05,882371,0.995230092
29859,721,43,1,1,4.90E-05,882372,0.99523122
34477,624,364,1,1,4.90E-05,882373,0.995232348
30056,133,593,1,1,4.90E-05,882374,0.995233476
29819,12,167,1,1,4.90E-05,882375,0.995234604
30023,170,15,1,1,4.90E-05,882376,0.995235732
29775,652,64,1,1,4.90E-05,882377,0.99523686
34262,23,475,1,1,4.90E-05,882378,0.995237988
29777,19,85,1,1,4.90E-05,882379,0.995239116
29983,414,448,1,1,4.90E-05,882380,0.995240244
29815,22,85,1,1,4.90E-05,882381,0.995241372
29778,48,23,1,1,4.90E-05,882382,0.995242499
30055,493,97,1,1,4.90E-05,882383,0.995243627
34474,167,97,1,1,4.90E-05,882384,0.995244755
30058,126,354,1,1,4.90E-05,882385,0.995245883
34619,717,26,1,1,4.90E-05,882386,0.995247011
29953,446,265,1,1,4.90E-05,882387,0.995248139
29768,155,544,1,1,4.90E-05,882388,0.995249267
29769,502,720,1,1,4.90E-05,882389,0.995250395
34613,348,342,1,1,4.90E-05,882390,0.995251523
29822,458,1,1,1,4.90E-05,882391,0.995252651
34466,175,367,1,1,4.90E-05,882392,0.995253778
29950,170,246,1,1,4.90E-05,882393,0.995254906
29820,20,85,1,1,4.90E-05,882394,0.995256034
34471,257,689,1,1,4.90E-05,882395,0.995257162
34361,294,562,1,1,4.90E-05,882396,0.99525829
34227,342,511,1,1,4.90E-05,882397,0.995259418
34612,207,684,1,1,4.90E-05,882398,0.995260546
30060,230,371,1,1,4.90E-05,882399,0.995261674
30059,311,160,1,1,4.90E-05,882400,0.995262802
34611,175,107,1,1,4.90E-05,882401,0.99526393
34607,576,708,1,1,4.90E-05,882402,0.995265058
34606,587,11,1,1,4.90E-05,882403,0.995266185
34228,719,605,1,1,4.90E-05,882404,0.995267313
34545,535,124,1,1,4.90E-05,882405,0.995268441
32152,552,246,1,1,4.90E-05,882406,0.995269569
29687,479,458,1,1,4.90E-05,882407,0.995270697
29010,193,130,1,1,4.90E-05,882408,0.995271825
35336,13,23,1,1,4.90E-05,882409,0.995272953
29020,448,1,1,1,4.90E-05,882410,0.995274081
35337,310,719,1,1,4.90E-05,882411,0.995275209
29017,482,497,1,1,4.90E-05,882412,0.995276337
29014,482,85,1,1,4.90E-05,882413,0.995277464
35338,560,364,1,1,4.90E-05,882414,0.995278592
35372,141,178,1,1,4.90E-05,882415,0.99527972
35374,394,124,1,1,4.90E-05,882416,0.995280848
29009,114,618,1,1,4.90E-05,882417,0.995281976
35383,195,646,1,1,4.90E-05,882418,0.995283104
35375,471,269,1,1,4.90E-05,882419,0.995284232
35376,543,409,1,1,4.90E-05,882420,0.99528536
29008,90,364,1,1,4.90E-05,882421,0.995286488
35377,446,624,1,1,4.90E-05,882422,0.995287616
29007,19,497,1,1,4.90E-05,882423,0.995288744
29006,335,458,1,1,4.90E-05,882424,0.995289871
29004,121,511,1,1,4.90E-05,882425,0.995290999
35379,204,493,1,1,4.90E-05,882426,0.995292127
29026,552,525,1,1,4.90E-05,882427,0.995293255
29028,494,404,1,1,4.90E-05,882428,0.995294383
29030,54,663,1,1,4.90E-05,882429,0.995295511
29031,463,137,1,1,4.90E-05,882430,0.995296639
29064,433,207,1,1,4.90E-05,882431,0.995297767
35310,347,458,1,1,4.90E-05,882432,0.995298895
35313,246,508,1,1,4.90E-05,882433,0.995300023
35316,507,178,1,1,4.90E-05,882434,0.99530115
35329,383,448,1,1,4.90E-05,882435,0.995302278
29058,170,475,1,1,4.90E-05,882436,0.995303406
35330,295,492,1,1,4.90E-05,882437,0.995304534
35331,624,265,1,1,4.90E-05,882438,0.995305662
35332,155,246,1,1,4.90E-05,882439,0.99530679
35333,295,342,1,1,4.90E-05,882440,0.995307918
29052,443,175,1,1,4.90E-05,882441,0.995309046
29049,23,404,1,1,4.90E-05,882442,0.995310174
29047,160,15,1,1,4.90E-05,882443,0.995311302
35334,124,613,1,1,4.90E-05,882444,0.99531243
29042,703,689,1,1,4.90E-05,882445,0.995313557
29041,596,175,1,1,4.90E-05,882446,0.995314685
35335,117,195,1,1,4.90E-05,882447,0.995315813
35382,482,446,1,1,4.90E-05,882448,0.995316941
35385,721,661,1,1,4.90E-05,882449,0.995318069
35191,414,290,1,1,4.90E-05,882450,0.995319197
28950,124,393,1,1,4.90E-05,882451,0.995320325
35406,482,558,1,1,4.90E-05,882452,0.995321453
28963,646,493,1,1,4.90E-05,882453,0.995322581
35407,689,493,1,1,4.90E-05,882454,0.995323709
35408,576,443,1,1,4.90E-05,882455,0.995324836
28960,511,673,1,1,4.90E-05,882456,0.995325964
28958,494,97,1,1,4.90E-05,882457,0.995327092
28954,124,175,1,1,4.90E-05,882458,0.99532822
28953,25,439,1,1,4.90E-05,882459,0.995329348
28947,398,493,1,1,4.90E-05,882460,0.995330476
35388,560,295,1,1,4.90E-05,882461,0.995331604
28946,479,175,1,1,4.90E-05,882462,0.995332732
28945,626,314,1,1,4.90E-05,882463,0.99533386
35410,568,311,1,1,4.90E-05,882464,0.995334988
35411,138,392,1,1,4.90E-05,882465,0.995336115
28942,290,397,1,1,4.90E-05,882466,0.995337243
28937,310,701,1,1,4.90E-05,882467,0.995338371
28934,175,632,1,1,4.90E-05,882468,0.995339499
28932,124,193,1,1,4.90E-05,882469,0.995340627
28965,560,663,1,1,4.90E-05,882470,0.995341755
28966,141,97,1,1,4.90E-05,882471,0.995342883
28967,163,54,1,1,4.90E-05,882472,0.995344011
28968,30,23,1,1,4.90E-05,882473,0.995345139
28995,498,448,1,1,4.90E-05,882474,0.995346267
35393,586,207,1,1,4.90E-05,882475,0.995347395
35394,269,439,1,1,4.90E-05,882476,0.995348522
35395,141,714,1,1,4.90E-05,882477,0.99534965
28988,517,646,1,1,4.90E-05,882478,0.995350778
28987,1,668,1,1,4.90E-05,882479,0.995351906
35397,164,661,1,1,4.90E-05,882480,0.995353034
28986,655,175,1,1,4.90E-05,882481,0.995354162
28985,20,332,1,1,4.90E-05,882482,0.99535529
28984,673,175,1,1,4.90E-05,882483,0.995356418
28983,626,84,1,1,4.90E-05,882484,0.995357546
35399,723,181,1,1,4.90E-05,882485,0.995358674
28982,689,673,1,1,4.90E-05,882486,0.995359801
28978,673,290,1,1,4.90E-05,882487,0.995360929
35402,123,576,1,1,4.90E-05,882488,0.995362057
35405,160,721,1,1,4.90E-05,882489,0.995363185
28972,290,543,1,1,4.90E-05,882490,0.995364313
35309,568,443,1,1,4.90E-05,882491,0.995365441
29074,503,364,1,1,4.90E-05,882492,0.995366569
29075,699,543,1,1,4.90E-05,882493,0.995367697
29150,414,624,1,1,4.90E-05,882494,0.995368825
35203,23,5,1,1,4.90E-05,882495,0.995369953
35205,19,54,1,1,4.90E-05,882496,0.995371081
29163,90,295,1,1,4.90E-05,882497,0.995372208
29161,23,311,1,1,4.90E-05,882498,0.995373336
29159,674,178,1,1,4.90E-05,882499,0.995374464
29152,261,543,1,1,4.90E-05,882500,0.995375592
29151,718,131,1,1,4.90E-05,882501,0.99537672
35208,626,178,1,1,4.90E-05,882502,0.995377848
35209,593,332,1,1,4.90E-05,882503,0.995378976
35305,439,684,1,1,4.90E-05,882504,0.995380104
35213,230,721,1,1,4.90E-05,882505,0.995381232
29147,26,181,1,1,4.90E-05,882506,0.99538236
29145,596,371,1,1,4.90E-05,882507,0.995383487
29143,364,708,1,1,4.90E-05,882508,0.995384615
29142,587,295,1,1,4.90E-05,882509,0.995385743
35217,701,181,1,1,4.90E-05,882510,0.995386871
35218,140,576,1,1,4.90E-05,882511,0.995387999
29136,29,614,1,1,4.90E-05,882512,0.995389127
29167,294,596,1,1,4.90E-05,882513,0.995390255
35200,158,319,1,1,4.90E-05,882514,0.995391383
29170,202,674,1,1,4.90E-05,882515,0.995392511
29177,721,204,1,1,4.90E-05,882516,0.995393639
29200,294,13,1,1,4.90E-05,882517,0.995394767
35192,525,1,1,1,4.90E-05,882518,0.995395894
29199,14,682,1,1,4.90E-05,882519,0.995397022
29196,492,145,1,1,4.90E-05,882520,0.99539815
35194,427,163,1,1,4.90E-05,882521,0.995399278
29195,652,33,1,1,4.90E-05,882522,0.995400406
29194,50,171,1,1,4.90E-05,882523,0.995401534
35195,568,26,1,1,4.90E-05,882524,0.995402662
29191,443,571,1,1,4.90E-05,882525,0.99540379
29187,19,439,1,1,4.90E-05,882526,0.995404918
29186,723,33,1,1,4.90E-05,882527,0.995406046
35197,164,446,1,1,4.90E-05,882528,0.995407173
35198,479,202,1,1,4.90E-05,882529,0.995408301
35199,683,64,1,1,4.90E-05,882530,0.995409429
29181,652,535,1,1,4.90E-05,882531,0.995410557
29180,178,103,1,1,4.90E-05,882532,0.995411685
29178,508,224,1,1,4.90E-05,882533,0.995412813
29133,126,708,1,1,4.90E-05,882534,0.995413941
29132,560,130,1,1,4.90E-05,882535,0.995415069
35221,638,576,1,1,4.90E-05,882536,0.995416197
29100,167,84,1,1,4.90E-05,882537,0.995417325
35261,397,43,1,1,4.90E-05,882538,0.995418453
29096,64,1,1,1,4.90E-05,882539,0.99541958
29095,558,261,1,1,4.90E-05,882540,0.995420708
35262,175,652,1,1,4.90E-05,882541,0.995421836
29092,202,31,1,1,4.90E-05,882542,0.995422964
35293,699,632,1,1,4.90E-05,882543,0.995424092
35298,178,398,1,1,4.90E-05,882544,0.99542522
29091,19,562,1,1,4.90E-05,882545,0.995426348
29088,613,265,1,1,4.90E-05,882546,0.995427476
29087,511,29,1,1,4.90E-05,882547,0.995428604
29086,114,29,1,1,4.90E-05,882548,0.995429732
29085,114,207,1,1,4.90E-05,882549,0.995430859
35304,663,257,1,1,4.90E-05,882550,0.995431987
29081,140,195,1,1,4.90E-05,882551,0.995433115
29080,11,171,1,1,4.90E-05,882552,0.995434243
29079,242,409,1,1,4.90E-05,882553,0.995435371
29078,103,624,1,1,4.90E-05,882554,0.995436499
29098,261,156,1,1,4.90E-05,882555,0.995437627
29102,525,158,1,1,4.90E-05,882556,0.995438755
35225,181,313,1,1,4.90E-05,882557,0.995439883
29103,23,473,1,1,4.90E-05,882558,0.995441011
29124,126,562,1,1,4.90E-05,882559,0.995442139
35227,25,525,1,1,4.90E-05,882560,0.995443266
35229,11,290,1,1,4.90E-05,882561,0.995444394
29123,50,12,1,1,4.90E-05,882562,0.995445522
29122,718,354,1,1,4.90E-05,882563,0.99544665
29120,5,264,1,1,4.90E-05,882564,0.995447778
35232,5,342,1,1,4.90E-05,882565,0.995448906
29119,562,701,1,1,4.90E-05,882566,0.995450034
29118,701,596,1,1,4.90E-05,882567,0.995451162
29116,404,494,1,1,4.90E-05,882568,0.99545229
29114,171,683,1,1,4.90E-05,882569,0.995453418
35237,568,528,1,1,4.90E-05,882570,0.995454545
29107,175,397,1,1,4.90E-05,882571,0.995455673
29106,397,13,1,1,4.90E-05,882572,0.995456801
35242,433,354,1,1,4.90E-05,882573,0.995457929
35244,576,196,1,1,4.90E-05,882574,0.995459057
35245,10,721,1,1,4.90E-05,882575,0.995460185
28931,544,290,1,1,4.90E-05,882576,0.995461313
35412,50,342,1,1,4.90E-05,882577,0.995462441
35414,347,699,1,1,4.90E-05,882578,0.995463569
35527,121,364,1,1,4.90E-05,882579,0.995464697
28795,719,618,1,1,4.90E-05,882580,0.995465824
28793,90,307,1,1,4.90E-05,882581,0.995466952
28792,332,207,1,1,4.90E-05,882582,0.99546808
28788,196,503,1,1,4.90E-05,882583,0.995469208
35513,114,624,1,1,4.90E-05,882584,0.995470336
28786,178,25,1,1,4.90E-05,882585,0.995471464
35520,720,661,1,1,4.90E-05,882586,0.995472592
28783,446,543,1,1,4.90E-05,882587,0.99547372
28780,571,552,1,1,4.90E-05,882588,0.995474848
35498,85,77,1,1,4.90E-05,882589,0.995475976
28778,202,5,1,1,4.90E-05,882590,0.995477104
28777,2,19,1,1,4.90E-05,882591,0.995478231
28776,11,195,1,1,4.90E-05,882592,0.995479359
35531,568,632,1,1,4.90E-05,882593,0.995480487
28772,409,33,1,1,4.90E-05,882594,0.995481615
35533,494,167,1,1,4.90E-05,882595,0.995482743
28767,652,335,1,1,4.90E-05,882596,0.995483871
35536,371,328,1,1,4.90E-05,882597,0.995484999
28796,195,130,1,1,4.90E-05,882598,0.995486127
35510,568,367,1,1,4.90E-05,882599,0.995487255
28797,624,77,1,1,4.90E-05,882600,0.995488383
28799,332,193,1,1,4.90E-05,882601,0.99548951
28823,507,19,1,1,4.90E-05,882602,0.995490638
28821,181,32,1,1,4.90E-05,882603,0.995491766
35502,720,624,1,1,4.90E-05,882604,0.995492894
28819,427,446,1,1,4.90E-05,882605,0.995494022
28816,586,371,1,1,4.90E-05,882606,0.99549515
28815,723,348,1,1,4.90E-05,882607,0.995496278
28813,193,427,1,1,4.90E-05,882608,0.995497406
35503,699,195,1,1,4.90E-05,882609,0.995498534
28809,529,332,1,1,4.90E-05,882610,0.995499662
28808,23,708,1,1,4.90E-05,882611,0.99550079
28807,117,448,1,1,4.90E-05,882612,0.995501917
28806,618,646,1,1,4.90E-05,882613,0.995503045
28805,380,160,1,1,4.90E-05,882614,0.995504173
35504,661,12,1,1,4.90E-05,882615,0.995505301
35507,160,195,1,1,4.90E-05,882616,0.995506429
28802,175,196,1,1,4.90E-05,882617,0.995507557
28801,448,261,1,1,4.90E-05,882618,0.995508685
35537,342,640,1,1,4.90E-05,882619,0.995509813
28763,397,371,1,1,4.90E-05,882620,0.995510941
28762,364,605,1,1,4.90E-05,882621,0.995512069
35568,178,328,1,1,4.90E-05,882622,0.995513196
28743,10,138,1,1,4.90E-05,882623,0.995514324
28741,103,4,1,1,4.90E-05,882624,0.995515452
35571,560,117,1,1,4.90E-05,882625,0.99551658
28736,492,56,1,1,4.90E-05,882626,0.995517708
28733,558,525,1,1,4.90E-05,882627,0.995518836
35572,503,328,1,1,4.90E-05,882628,0.995519964
35573,107,668,1,1,4.90E-05,882629,0.995521092
28732,371,50,1,1,4.90E-05,882630,0.99552222
28731,246,158,1,1,4.90E-05,882631,0.995523348
28729,242,544,1,1,4.90E-05,882632,0.995524476
28728,243,721,1,1,4.90E-05,882633,0.995525603
28727,269,646,1,1,4.90E-05,882634,0.995526731
35575,294,290,1,1,4.90E-05,882635,0.995527859
35576,385,207,1,1,4.90E-05,882636,0.995528987
35579,64,90,1,1,4.90E-05,882637,0.995530115
35582,703,141,1,1,4.90E-05,882638,0.995531243
28720,703,33,1,1,4.90E-05,882639,0.995532371
35569,124,163,1,1,4.90E-05,882640,0.995533499
35567,723,393,1,1,4.90E-05,882641,0.995534627
35538,571,689,1,1,4.90E-05,882642,0.995535755
28745,294,181,1,1,4.90E-05,882643,0.995536882
35539,404,332,1,1,4.90E-05,882644,0.99553801
28758,668,397,1,1,4.90E-05,882645,0.995539138
35542,508,529,1,1,4.90E-05,882646,0.995540266
35545,43,569,1,1,4.90E-05,882647,0.995541394
28756,56,160,1,1,4.90E-05,882648,0.995542522
35553,347,19,1,1,4.90E-05,882649,0.99554365
28755,503,614,1,1,4.90E-05,882650,0.995544778
35557,294,502,1,1,4.90E-05,882651,0.995545906
28754,138,23,1,1,4.90E-05,882652,0.995547034
28753,269,588,1,1,4.90E-05,882653,0.995548162
28752,140,409,1,1,4.90E-05,882654,0.995549289
35559,501,701,1,1,4.90E-05,882655,0.995550417
28751,668,193,1,1,4.90E-05,882656,0.995551545
35562,703,522,1,1,4.90E-05,882657,0.995552673
28749,261,30,1,1,4.90E-05,882658,0.995553801
28746,383,29,1,1,4.90E-05,882659,0.995554929
35564,141,511,1,1,4.90E-05,882660,0.995556057
35499,174,593,1,1,4.90E-05,882661,0.995557185
28826,13,714,1,1,4.90E-05,882662,0.995558313
28929,397,174,1,1,4.90E-05,882663,0.995559441
35452,404,193,1,1,4.90E-05,882664,0.995560568
28895,204,683,1,1,4.90E-05,882665,0.995561696
35426,560,3,1,1,4.90E-05,882666,0.995562824
35428,640,85,1,1,4.90E-05,882667,0.995563952
35429,503,492,1,1,4.90E-05,882668,0.99556508
28893,103,614,1,1,4.90E-05,882669,0.995566208
28891,723,243,1,1,4.90E-05,882670,0.995567336
35450,302,626,1,1,4.90E-05,882671,0.995568464
28884,364,503,1,1,4.90E-05,882672,0.995569592
28882,663,137,1,1,4.90E-05,882673,0.99557072
35497,682,342,1,1,4.90E-05,882674,0.995571848
28879,522,178,1,1,4.90E-05,882675,0.995572975
35462,280,124,1,1,4.90E-05,882676,0.995574103
35465,482,701,1,1,4.90E-05,882677,0.995575231
35466,294,576,1,1,4.90E-05,882678,0.995576359
35468,508,582,1,1,4.90E-05,882679,0.995577487
35469,719,383,1,1,4.90E-05,882680,0.995578615
28875,364,383,1,1,4.90E-05,882681,0.995579743
35471,202,12,1,1,4.90E-05,882682,0.995580871
28898,138,56,1,1,4.90E-05,882683,0.995581999
35425,721,54,1,1,4.90E-05,882684,0.995583127
35424,646,319,1,1,4.90E-05,882685,0.995584254
28902,342,10,1,1,4.90E-05,882686,0.995585382
35415,560,529,1,1,4.90E-05,882687,0.99558651
35418,398,207,1,1,4.90E-05,882688,0.995587638
28927,448,56,1,1,4.90E-05,882689,0.995588766
28926,508,3,1,1,4.90E-05,882690,0.995589894
28924,640,207,1,1,4.90E-05,882691,0.995591022
35419,371,230,1,1,4.90E-05,882692,0.99559215
28923,492,264,1,1,4.90E-05,882693,0.995593278
28919,56,494,1,1,4.90E-05,882694,0.995594406
28918,97,261,1,1,4.90E-05,882695,0.995595533
28916,121,25,1,1,4.90E-05,882696,0.995596661
28915,54,264,1,1,4.90E-05,882697,0.995597789
28914,2,646,1,1,4.90E-05,882698,0.995598917
28910,6,458,1,1,4.90E-05,882699,0.995600045
28907,448,12,1,1,4.90E-05,882700,0.995601173
28906,290,587,1,1,4.90E-05,882701,0.995602301
28905,243,178,1,1,4.90E-05,882702,0.995603429
35422,126,609,1,1,4.90E-05,882703,0.995604557
28874,23,126,1,1,4.90E-05,882704,0.995605685
28873,528,204,1,1,4.90E-05,882705,0.995606813
28870,525,605,1,1,4.90E-05,882706,0.99560794
35483,448,274,1,1,4.90E-05,882707,0.995609068
28841,302,720,1,1,4.90E-05,882708,0.995610196
35485,618,721,1,1,4.90E-05,882709,0.995611324
28838,347,124,1,1,4.90E-05,882710,0.995612452
35487,404,525,1,1,4.90E-05,882711,0.99561358
35488,482,511,1,1,4.90E-05,882712,0.995614708
28834,605,427,1,1,4.90E-05,882713,0.995615836
28833,16,178,1,1,4.90E-05,882714,0.995616964
35489,22,178,1,1,4.90E-05,882715,0.995618092
28832,626,280,1,1,4.90E-05,882716,0.995619219
28830,383,20,1,1,4.90E-05,882717,0.995620347
35490,517,163,1,1,4.90E-05,882718,0.995621475
35491,371,64,1,1,4.90E-05,882719,0.995622603
35492,156,246,1,1,4.90E-05,882720,0.995623731
35493,133,668,1,1,4.90E-05,882721,0.995624859
35494,568,156,1,1,4.90E-05,882722,0.995625987
35495,414,193,1,1,4.90E-05,882723,0.995627115
35496,683,723,1,1,4.90E-05,882724,0.995628243
35484,482,342,1,1,4.90E-05,882725,0.995629371
35482,703,347,1,1,4.90E-05,882726,0.995630499
35473,334,133,1,1,4.90E-05,882727,0.995631626
28846,250,155,1,1,4.90E-05,882728,0.995632754
28868,525,503,1,1,4.90E-05,882729,0.995633882
28867,202,638,1,1,4.90E-05,882730,0.99563501
28866,492,15,1,1,4.90E-05,882731,0.995636138
35475,25,587,1,1,4.90E-05,882732,0.995637266
35477,246,167,1,1,4.90E-05,882733,0.995638394
28864,257,535,1,1,4.90E-05,882734,0.995639522
28863,13,328,1,1,4.90E-05,882735,0.99564065
28862,380,458,1,1,4.90E-05,882736,0.995641778
28861,16,720,1,1,4.90E-05,882737,0.995642905
28860,202,10,1,1,4.90E-05,882738,0.995644033
35479,294,448,1,1,4.90E-05,882739,0.995645161
28856,19,193,1,1,4.90E-05,882740,0.995646289
28855,721,479,1,1,4.90E-05,882741,0.995647417
35481,163,121,1,1,4.90E-05,882742,0.995648545
28853,517,494,1,1,4.90E-05,882743,0.995649673
28850,414,294,1,1,4.90E-05,882744,0.995650801
28847,261,723,1,1,4.90E-05,882745,0.995651929
29201,703,9,1,1,4.90E-05,882746,0.995653057
29204,507,503,1,1,4.90E-05,882747,0.995654185
29684,114,138,1,1,4.90E-05,882748,0.995655312
34887,646,614,1,1,4.90E-05,882749,0.99565644
34878,576,236,1,1,4.90E-05,882750,0.995657568
34881,703,479,1,1,4.90E-05,882751,0.995658696
29540,107,720,1,1,4.90E-05,882752,0.995659824
29538,502,364,1,1,4.90E-05,882753,0.995660952
34882,701,392,1,1,4.90E-05,882754,0.99566208
34883,269,196,1,1,4.90E-05,882755,0.995663208
34885,568,25,1,1,4.90E-05,882756,0.995664336
34886,624,668,1,1,4.90E-05,882757,0.995665464
34888,661,723,1,1,4.90E-05,882758,0.995666591
34891,652,242,1,1,4.90E-05,882759,0.995667719
29533,684,723,1,1,4.90E-05,882760,0.995668847
29531,14,720,1,1,4.90E-05,882761,0.995669975
29528,202,439,1,1,4.90E-05,882762,0.995671103
29527,10,342,1,1,4.90E-05,882763,0.995672231
34889,171,568,1,1,4.90E-05,882764,0.995673359
29525,164,493,1,1,4.90E-05,882765,0.995674487
29524,446,246,1,1,4.90E-05,882766,0.995675615
29522,560,443,1,1,4.90E-05,882767,0.995676743
34877,131,626,1,1,4.90E-05,882768,0.995677871
34876,1,493,1,1,4.90E-05,882769,0.995678998
34875,596,576,1,1,4.90E-05,882770,0.995680126
29541,683,404,1,1,4.90E-05,882771,0.995681254
34853,22,613,1,1,4.90E-05,882772,0.995682382
29567,364,409,1,1,4.90E-05,882773,0.99568351
29562,475,319,1,1,4.90E-05,882774,0.995684638
29559,64,587,1,1,4.90E-05,882775,0.995685766
29556,482,20,1,1,4.90E-05,882776,0.995686894
34856,167,446,1,1,4.90E-05,882777,0.995688022
34858,626,236,1,1,4.90E-05,882778,0.99568915
29552,618,720,1,1,4.90E-05,882779,0.995690277
34864,261,167,1,1,4.90E-05,882780,0.995691405
29551,265,673,1,1,4.90E-05,882781,0.995692533
29550,471,175,1,1,4.90E-05,882782,0.995693661
34865,178,528,1,1,4.90E-05,882783,0.995694789
34866,5,133,1,1,4.90E-05,882784,0.995695917
34867,632,571,1,1,4.90E-05,882785,0.995697045
34869,12,103,1,1,4.90E-05,882786,0.995698173
29543,723,354,1,1,4.90E-05,882787,0.995699301
34872,720,124,1,1,4.90E-05,882788,0.995700429
34890,661,181,1,1,4.90E-05,882789,0.995701557
29518,588,124,1,1,4.90E-05,882790,0.995702684
35189,719,701,1,1,4.90E-05,882791,0.995703812
29472,718,204,1,1,4.90E-05,882792,0.99570494
29480,576,479,1,1,4.90E-05,882793,0.995706068
29479,290,689,1,1,4.90E-05,882794,0.995707196
29478,126,13,1,1,4.90E-05,882795,0.995708324
29477,138,511,1,1,4.90E-05,882796,0.995709452
29475,576,140,1,1,4.90E-05,882797,0.99571058
29474,492,414,1,1,4.90E-05,882798,0.995711708
34916,661,29,1,1,4.90E-05,882799,0.995712836
29473,26,576,1,1,4.90E-05,882800,0.995713963
29470,33,626,1,1,4.90E-05,882801,0.995715091
29517,463,332,1,1,4.90E-05,882802,0.995716219
29469,507,414,1,1,4.90E-05,882803,0.995717347
29468,661,34,1,1,4.90E-05,882804,0.995718475
29466,482,443,1,1,4.90E-05,882805,0.995719603
29464,392,668,1,1,4.90E-05,882806,0.995720731
34919,140,90,1,1,4.90E-05,882807,0.995721859
34920,261,5,1,1,4.90E-05,882808,0.995722987
29457,195,404,1,1,4.90E-05,882809,0.995724115
29456,313,719,1,1,4.90E-05,882810,0.995725242
34911,13,503,1,1,4.90E-05,882811,0.99572637
29484,721,618,1,1,4.90E-05,882812,0.995727498
34909,587,25,1,1,4.90E-05,882813,0.995728626
34899,618,568,1,1,4.90E-05,882814,0.995729754
34892,242,43,1,1,4.90E-05,882815,0.995730882
29513,682,137,1,1,4.90E-05,882816,0.99573201
29512,439,446,1,1,4.90E-05,882817,0.995733138
29511,121,13,1,1,4.90E-05,882818,0.995734266
34893,571,529,1,1,4.90E-05,882819,0.995735394
29506,427,502,1,1,4.90E-05,882820,0.995736522
29503,195,379,1,1,4.90E-05,882821,0.995737649
29502,646,22,1,1,4.90E-05,882822,0.995738777
34894,723,48,1,1,4.90E-05,882823,0.995739905
34895,178,124,1,1,4.90E-05,882824,0.995741033
34897,652,294,1,1,4.90E-05,882825,0.995742161
29496,175,33,1,1,4.90E-05,882826,0.995743289
34898,458,502,1,1,4.90E-05,882827,0.995744417
29493,164,328,1,1,4.90E-05,882828,0.995745545
29492,158,178,1,1,4.90E-05,882829,0.995746673
29488,404,13,1,1,4.90E-05,882830,0.995747801
29487,514,5,1,1,4.90E-05,882831,0.995748928
29568,141,708,1,1,4.90E-05,882832,0.995750056
34852,501,668,1,1,4.90E-05,882833,0.995751184
34851,576,22,1,1,4.90E-05,882834,0.995752312
29650,3,721,1,1,4.90E-05,882835,0.99575344
34736,463,720,1,1,4.90E-05,882836,0.995754568
34737,178,503,1,1,4.90E-05,882837,0.995755696
34738,471,202,1,1,4.90E-05,882838,0.995756824
29659,683,383,1,1,4.90E-05,882839,0.995757952
29655,207,54,1,1,4.90E-05,882840,0.99575908
29654,719,140,1,1,4.90E-05,882841,0.995760208
34739,503,5,1,1,4.90E-05,882842,0.995761335
34740,85,14,1,1,4.90E-05,882843,0.995762463
29645,458,614,1,1,4.90E-05,882844,0.995763591
34850,398,433,1,1,4.90E-05,882845,0.995764719
29644,443,371,1,1,4.90E-05,882846,0.995765847
29643,310,43,1,1,4.90E-05,882847,0.995766975
29642,167,193,1,1,4.90E-05,882848,0.995768103
29641,661,560,1,1,4.90E-05,882849,0.995769231
29640,398,618,1,1,4.90E-05,882850,0.995770359
34741,560,280,1,1,4.90E-05,882851,0.995771487
29635,307,269,1,1,4.90E-05,882852,0.995772614
34742,164,103,1,1,4.90E-05,882853,0.995773742
29665,503,385,1,1,4.90E-05,882854,0.99577487
34734,446,652,1,1,4.90E-05,882855,0.995775998
29666,525,708,1,1,4.90E-05,882856,0.995777126
29667,609,29,1,1,4.90E-05,882857,0.995778254
29683,332,328,1,1,4.90E-05,882858,0.995779382
34712,124,392,1,1,4.90E-05,882859,0.99578051
29681,313,342,1,1,4.90E-05,882860,0.995781638
34715,528,174,1,1,4.90E-05,882861,0.995782766
34722,673,103,1,1,4.90E-05,882862,0.995783894
29679,50,207,1,1,4.90E-05,882863,0.995785021
34723,207,507,1,1,4.90E-05,882864,0.995786149
34726,126,443,1,1,4.90E-05,882865,0.995787277
34727,458,714,1,1,4.90E-05,882866,0.995788405
34729,626,479,1,1,4.90E-05,882867,0.995789533
34730,502,571,1,1,4.90E-05,882868,0.995790661
34731,392,138,1,1,4.90E-05,882869,0.995791789
34732,723,274,1,1,4.90E-05,882870,0.995792917
29673,294,243,1,1,4.90E-05,882871,0.995794045
29669,224,613,1,1,4.90E-05,882872,0.995795173
34733,721,626,1,1,4.90E-05,882873,0.9957963
29668,170,22,1,1,4.90E-05,882874,0.995797428
29630,720,242,1,1,4.90E-05,882875,0.995798556
34743,371,274,1,1,4.90E-05,882876,0.995799684
29627,85,535,1,1,4.90E-05,882877,0.995800812
29597,23,295,1,1,4.90E-05,882878,0.99580194
29594,167,652,1,1,4.90E-05,882879,0.995803068
29591,174,274,1,1,4.90E-05,882880,0.995804196
29590,20,528,1,1,4.90E-05,882881,0.995805324
29589,175,463,1,1,4.90E-05,882882,0.995806452
29588,719,543,1,1,4.90E-05,882883,0.99580758
34840,498,124,1,1,4.90E-05,882884,0.995808707
29585,294,652,1,1,4.90E-05,882885,0.995809835
34841,508,618,1,1,4.90E-05,882886,0.995810963
34842,85,379,1,1,4.90E-05,882887,0.995812091
34843,332,383,1,1,4.90E-05,882888,0.995813219
29583,529,673,1,1,4.90E-05,882889,0.995814347
34844,364,5,1,1,4.90E-05,882890,0.995815475
34848,295,19,1,1,4.90E-05,882891,0.995816603
29581,16,319,1,1,4.90E-05,882892,0.995817731
34849,587,655,1,1,4.90E-05,882893,0.995818859
29577,347,714,1,1,4.90E-05,882894,0.995819986
29575,178,532,1,1,4.90E-05,882895,0.995821114
34839,568,674,1,1,4.90E-05,882896,0.995822242
34838,175,155,1,1,4.90E-05,882897,0.99582337
29619,587,353,1,1,4.90E-05,882898,0.995824498
29599,646,31,1,1,4.90E-05,882899,0.995825626
34744,178,684,1,1,4.90E-05,882900,0.995826754
29616,175,313,1,1,4.90E-05,882901,0.995827882
34745,193,392,1,1,4.90E-05,882902,0.99582901
34746,371,48,1,1,4.90E-05,882903,0.995830138
29613,202,334,1,1,4.90E-05,882904,0.995831266
29612,493,196,1,1,4.90E-05,882905,0.995832393
29609,264,54,1,1,4.90E-05,882906,0.995833521
29608,171,409,1,1,4.90E-05,882907,0.995834649
29607,703,708,1,1,4.90E-05,882908,0.995835777
34774,613,328,1,1,4.90E-05,882909,0.995836905
34775,568,105,1,1,4.90E-05,882910,0.995838033
29606,174,367,1,1,4.90E-05,882911,0.995839161
29604,409,156,1,1,4.90E-05,882912,0.995840289
29603,141,514,1,1,4.90E-05,882913,0.995841417
34776,482,517,1,1,4.90E-05,882914,0.995842545
34836,493,85,1,1,4.90E-05,882915,0.995843672
29602,117,29,1,1,4.90E-05,882916,0.9958448
29455,77,684,1,1,4.90E-05,882917,0.995845928
34924,334,717,1,1,4.90E-05,882918,0.995847056
34926,673,701,1,1,4.90E-05,882919,0.995848184
29280,138,439,1,1,4.90E-05,882920,0.995849312
29291,703,302,1,1,4.90E-05,882921,0.99585044
29290,117,560,1,1,4.90E-05,882922,0.995851568
35104,720,394,1,1,4.90E-05,882923,0.995852696
35105,482,587,1,1,4.90E-05,882924,0.995853824
35106,174,684,1,1,4.90E-05,882925,0.995854952
35107,181,13,1,1,4.90E-05,882926,0.995856079
29282,719,294,1,1,4.90E-05,882927,0.995857207
35108,261,193,1,1,4.90E-05,882928,0.995858335
35109,508,310,1,1,4.90E-05,882929,0.995859463
29320,364,618,1,1,4.90E-05,882930,0.995860591
29277,280,19,1,1,4.90E-05,882931,0.995861719
29276,19,290,1,1,4.90E-05,882932,0.995862847
29275,501,294,1,1,4.90E-05,882933,0.995863975
35110,668,439,1,1,4.90E-05,882934,0.995865103
29267,121,156,1,1,4.90E-05,882935,0.995866231
35112,638,269,1,1,4.90E-05,882936,0.995867358
29265,699,15,1,1,4.90E-05,882937,0.995868486
29264,170,397,1,1,4.90E-05,882938,0.995869614
35043,246,31,1,1,4.90E-05,882939,0.995870742
29292,503,313,1,1,4.90E-05,882940,0.99587187
29293,307,133,1,1,4.90E-05,882941,0.995872998
35040,632,613,1,1,4.90E-05,882942,0.995874126
29317,427,503,1,1,4.90E-05,882943,0.995875254
29316,392,348,1,1,4.90E-05,882944,0.995876382
35028,124,246,1,1,4.90E-05,882945,0.99587751
29313,720,171,1,1,4.90E-05,882946,0.995878637
29312,90,463,1,1,4.90E-05,882947,0.995879765
29309,714,586,1,1,4.90E-05,882948,0.995880893
29308,261,126,1,1,4.90E-05,882949,0.995882021
35029,16,492,1,1,4.90E-05,882950,0.995883149
29306,661,48,1,1,4.90E-05,882951,0.995884277
35030,683,593,1,1,4.90E-05,882952,0.995885405
35031,269,560,1,1,4.90E-05,882953,0.995886533
35032,511,43,1,1,4.90E-05,882954,0.995887661
35033,682,103,1,1,4.90E-05,882955,0.995888789
29301,535,624,1,1,4.90E-05,882956,0.995889917
35034,202,587,1,1,4.90E-05,882957,0.995891044
35035,354,433,1,1,4.90E-05,882958,0.995892172
35039,155,138,1,1,4.90E-05,882959,0.9958933
29263,264,632,1,1,4.90E-05,882960,0.995894428
29262,84,569,1,1,4.90E-05,882961,0.995895556
29261,562,409,1,1,4.90E-05,882962,0.995896684
35154,43,571,1,1,4.90E-05,882963,0.995897812
29238,723,196,1,1,4.90E-05,882964,0.99589894
35157,719,507,1,1,4.90E-05,882965,0.995900068
29236,720,511,1,1,4.90E-05,882966,0.995901196
29235,50,163,1,1,4.90E-05,882967,0.995902323
35179,586,720,1,1,4.90E-05,882968,0.995903451
29234,446,124,1,1,4.90E-05,882969,0.995904579
29233,290,1,1,1,4.90E-05,882970,0.995905707
35180,27,257,1,1,4.90E-05,882971,0.995906835
29231,508,522,1,1,4.90E-05,882972,0.995907963
35183,332,673,1,1,4.90E-05,882973,0.995909091
35184,54,458,1,1,4.90E-05,882974,0.995910219
29219,163,5,1,1,4.90E-05,882975,0.995911347
29217,646,439,1,1,4.90E-05,882976,0.995912475
35187,114,371,1,1,4.90E-05,882977,0.995913603
29216,31,433,1,1,4.90E-05,882978,0.99591473
29207,353,19,1,1,4.90E-05,882979,0.995915858
29206,723,3,1,1,4.90E-05,882980,0.995916986
29239,532,19,1,1,4.90E-05,882981,0.995918114
35152,160,175,1,1,4.90E-05,882982,0.995919242
29260,668,274,1,1,4.90E-05,882983,0.99592037
29241,528,246,1,1,4.90E-05,882984,0.995921498
35115,646,668,1,1,4.90E-05,882985,0.995922626
35119,720,587,1,1,4.90E-05,882986,0.995923754
35120,720,117,1,1,4.90E-05,882987,0.995924882
35121,571,193,1,1,4.90E-05,882988,0.995926009
35122,367,569,1,1,4.90E-05,882989,0.995927137
35123,328,717,1,1,4.90E-05,882990,0.995928265
35144,398,576,1,1,4.90E-05,882991,0.995929393
29256,528,668,1,1,4.90E-05,882992,0.995930521
29253,274,138,1,1,4.90E-05,882993,0.995931649
29251,207,117,1,1,4.90E-05,882994,0.995932777
29250,1,175,1,1,4.90E-05,882995,0.995933905
35145,560,588,1,1,4.90E-05,882996,0.995935033
29246,632,332,1,1,4.90E-05,882997,0.995936161
35146,624,701,1,1,4.90E-05,882998,0.995937289
29244,638,124,1,1,4.90E-05,882999,0.995938416
35149,242,525,1,1,4.90E-05,883000,0.995939544
35150,525,171,1,1,4.90E-05,883001,0.995940672
35020,475,269,1,1,4.90E-05,883002,0.9959418
29321,131,446,1,1,4.90E-05,883003,0.995942928
29453,720,126,1,1,4.90E-05,883004,0.995944056
29402,5,4,1,1,4.90E-05,883005,0.995945184
29417,170,552,1,1,4.90E-05,883006,0.995946312
34943,652,427,1,1,4.90E-05,883007,0.99594744
29413,544,269,1,1,4.90E-05,883008,0.995948568
29408,475,163,1,1,4.90E-05,883009,0.995949695
29407,175,544,1,1,4.90E-05,883010,0.995950823
34945,170,404,1,1,4.90E-05,883011,0.995951951
29405,409,497,1,1,4.90E-05,883012,0.995953079
29404,364,544,1,1,4.90E-05,883013,0.995954207
29398,439,668,1,1,4.90E-05,883014,0.995955335
29323,646,392,1,1,4.90E-05,883015,0.995956463
29397,124,605,1,1,4.90E-05,883016,0.995957591
29396,22,721,1,1,4.90E-05,883017,0.995958719
29395,107,371,1,1,4.90E-05,883018,0.995959847
29394,164,178,1,1,4.90E-05,883019,0.995960975
34946,158,342,1,1,4.90E-05,883020,0.995962102
29393,196,525,1,1,4.90E-05,883021,0.99596323
34954,54,618,1,1,4.90E-05,883022,0.995964358
34955,576,48,1,1,4.90E-05,883023,0.995965486
29418,720,427,1,1,4.90E-05,883024,0.995966614
29419,107,342,1,1,4.90E-05,883025,0.995967742
29422,446,544,1,1,4.90E-05,883026,0.99596887
29426,684,167,1,1,4.90E-05,883027,0.995969998
29452,673,269,1,1,4.90E-05,883028,0.995971126
34927,348,257,1,1,4.90E-05,883029,0.995972254
29448,364,265,1,1,4.90E-05,883030,0.995973381
34928,30,493,1,1,4.90E-05,883031,0.995974509
29447,593,195,1,1,4.90E-05,883032,0.995975637
29446,593,207,1,1,4.90E-05,883033,0.995976765
29445,507,163,1,1,4.90E-05,883034,0.995977893
34929,568,68,1,1,4.90E-05,883035,0.995979021
34939,269,640,1,1,4.90E-05,883036,0.995980149
29440,290,174,1,1,4.90E-05,883037,0.995981277
29436,85,311,1,1,4.90E-05,883038,0.995982405
29435,448,596,1,1,4.90E-05,883039,0.995983533
34940,280,494,1,1,4.90E-05,883040,0.995984661
29431,699,587,1,1,4.90E-05,883041,0.995985788
34941,492,171,1,1,4.90E-05,883042,0.995986916
29429,155,684,1,1,4.90E-05,883043,0.995988044
34942,613,652,1,1,4.90E-05,883044,0.995989172
29392,269,48,1,1,4.90E-05,883045,0.9959903
34956,661,511,1,1,4.90E-05,883046,0.995991428
34957,626,535,1,1,4.90E-05,883047,0.995992556
34998,243,717,1,1,4.90E-05,883048,0.995993684
34999,446,674,1,1,4.90E-05,883049,0.995994812
29344,587,230,1,1,4.90E-05,883050,0.99599594
29342,332,126,1,1,4.90E-05,883051,0.995997067
29341,632,503,1,1,4.90E-05,883052,0.995998195
29340,230,719,1,1,4.90E-05,883053,0.995999323
35000,158,576,1,1,4.90E-05,883054,0.996000451
35001,156,178,1,1,4.90E-05,883055,0.996001579
29339,64,280,1,1,4.90E-05,883056,0.996002707
29336,178,624,1,1,4.90E-05,883057,0.996003835
35017,652,661,1,1,4.90E-05,883058,0.996004963
29335,618,383,1,1,4.90E-05,883059,0.996006091
29330,171,714,1,1,4.90E-05,883060,0.996007219
29328,394,652,1,1,4.90E-05,883061,0.996008346
29326,167,397,1,1,4.90E-05,883062,0.996009474
35018,714,265,1,1,4.90E-05,883063,0.996010602
29325,29,140,1,1,4.90E-05,883064,0.99601173
29324,160,517,1,1,4.90E-05,883065,0.996012858
29350,719,167,1,1,4.90E-05,883066,0.996013986
34997,552,717,1,1,4.90E-05,883067,0.996015114
34963,195,609,1,1,4.90E-05,883068,0.996016242
34996,114,23,1,1,4.90E-05,883069,0.99601737
34964,269,126,1,1,4.90E-05,883070,0.996018498
29386,163,503,1,1,4.90E-05,883071,0.996019626
29385,29,528,1,1,4.90E-05,883072,0.996020753
29384,517,409,1,1,4.90E-05,883073,0.996021881
29382,14,383,1,1,4.90E-05,883074,0.996023009
29378,54,103,1,1,4.90E-05,883075,0.996024137
29377,13,673,1,1,4.90E-05,883076,0.996025265
29376,502,482,1,1,4.90E-05,883077,0.996026393
29369,246,348,1,1,4.90E-05,883078,0.996027521
29367,15,246,1,1,4.90E-05,883079,0.996028649
34966,204,319,1,1,4.90E-05,883080,0.996029777
34993,482,4,1,1,4.90E-05,883081,0.996030905
34994,532,43,1,1,4.90E-05,883082,0.996032032
29364,32,371,1,1,4.90E-05,883083,0.99603316
29363,342,517,1,1,4.90E-05,883084,0.996034288
34995,257,348,1,1,4.90E-05,883085,0.996035416
29362,508,31,1,1,4.90E-05,883086,0.996036544
34944,433,522,1,1,4.90E-05,883087,0.996037672
30461,195,439,1,1,4.90E-05,883088,0.9960388
30109,701,328,1,1,4.90E-05,883089,0.996039928
32904,103,274,1,1,4.90E-05,883090,0.996041056
32897,502,613,1,1,4.90E-05,883091,0.996042184
31533,178,265,1,1,4.90E-05,883092,0.996043312
32898,181,295,1,1,4.90E-05,883093,0.996044439
31529,264,138,1,1,4.90E-05,883094,0.996045567
32899,525,458,1,1,4.90E-05,883095,0.996046695
31528,723,95,1,1,4.90E-05,883096,0.996047823
31527,498,492,1,1,4.90E-05,883097,0.996048951
31524,242,138,1,1,4.90E-05,883098,0.996050079
32900,409,618,1,1,4.90E-05,883099,0.996051207
32905,508,334,1,1,4.90E-05,883100,0.996052335
31507,682,246,1,1,4.90E-05,883101,0.996053463
32906,43,138,1,1,4.90E-05,883102,0.996054591
32908,141,13,1,1,4.90E-05,883103,0.996055718
31521,703,105,1,1,4.90E-05,883104,0.996056846
32910,674,137,1,1,4.90E-05,883105,0.996057974
32911,699,242,1,1,4.90E-05,883106,0.996059102
31514,130,458,1,1,4.90E-05,883107,0.99606023
32912,379,43,1,1,4.90E-05,883108,0.996061358
32914,202,264,1,1,4.90E-05,883109,0.996062486
31509,342,141,1,1,4.90E-05,883110,0.996063614
31539,576,25,1,1,4.90E-05,883111,0.996064742
31540,719,439,1,1,4.90E-05,883112,0.99606587
32896,175,404,1,1,4.90E-05,883113,0.996066998
31542,652,4,1,1,4.90E-05,883114,0.996068125
31569,723,379,1,1,4.90E-05,883115,0.996069253
31568,141,23,1,1,4.90E-05,883116,0.996070381
32857,295,371,1,1,4.90E-05,883117,0.996071509
32858,202,482,1,1,4.90E-05,883118,0.996072637
32860,392,269,1,1,4.90E-05,883119,0.996073765
32862,503,195,1,1,4.90E-05,883120,0.996074893
31563,29,328,1,1,4.90E-05,883121,0.996076021
32865,19,246,1,1,4.90E-05,883122,0.996077149
31558,117,587,1,1,4.90E-05,883123,0.996078277
31557,29,433,1,1,4.90E-05,883124,0.996079404
32868,668,103,1,1,4.90E-05,883125,0.996080532
32872,90,2,1,1,4.90E-05,883126,0.99608166
32889,181,178,1,1,4.90E-05,883127,0.996082788
32891,90,646,1,1,4.90E-05,883128,0.996083916
31551,84,668,1,1,4.90E-05,883129,0.996085044
32893,613,163,1,1,4.90E-05,883130,0.996086172
31550,170,54,1,1,4.90E-05,883131,0.9960873
31549,124,414,1,1,4.90E-05,883132,0.996088428
32894,181,15,1,1,4.90E-05,883133,0.996089556
31508,605,493,1,1,4.90E-05,883134,0.996090684
31506,511,117,1,1,4.90E-05,883135,0.996091811
31575,699,64,1,1,4.90E-05,883136,0.996092939
31442,646,126,1,1,4.90E-05,883137,0.996094067
32933,257,141,1,1,4.90E-05,883138,0.996095195
31447,552,23,1,1,4.90E-05,883139,0.996096323
32934,571,364,1,1,4.90E-05,883140,0.996097451
32935,2,684,1,1,4.90E-05,883141,0.996098579
32936,703,443,1,1,4.90E-05,883142,0.996099707
32940,646,54,1,1,4.90E-05,883143,0.996100835
32943,137,385,1,1,4.90E-05,883144,0.996101963
32946,141,439,1,1,4.90E-05,883145,0.99610309
32950,701,195,1,1,4.90E-05,883146,0.996104218
31441,347,43,1,1,4.90E-05,883147,0.996105346
31505,560,379,1,1,4.90E-05,883148,0.996106474
31439,269,137,1,1,4.90E-05,883149,0.996107602
31430,1,319,1,1,4.90E-05,883150,0.99610873
32951,170,535,1,1,4.90E-05,883151,0.996109858
31428,269,156,1,1,4.90E-05,883152,0.996110986
31423,717,446,1,1,4.90E-05,883153,0.996112114
32952,522,371,1,1,4.90E-05,883154,0.996113242
32967,655,43,1,1,4.90E-05,883155,0.99611437
31420,684,383,1,1,4.90E-05,883156,0.996115497
31417,717,22,1,1,4.90E-05,883157,0.996116625
32932,684,174,1,1,4.90E-05,883158,0.996117753
31455,269,508,1,1,4.90E-05,883159,0.996118881
31459,264,552,1,1,4.90E-05,883160,0.996120009
32930,174,43,1,1,4.90E-05,883161,0.996121137
32915,409,501,1,1,4.90E-05,883162,0.996122265
31499,668,295,1,1,4.90E-05,883163,0.996123393
32918,342,26,1,1,4.90E-05,883164,0.996124521
32919,543,138,1,1,4.90E-05,883165,0.996125649
32925,613,319,1,1,4.90E-05,883166,0.996126776
31495,613,618,1,1,4.90E-05,883167,0.996127904
32926,178,502,1,1,4.90E-05,883168,0.996129032
31492,668,720,1,1,4.90E-05,883169,0.99613016
31489,15,493,1,1,4.90E-05,883170,0.996131288
31488,19,242,1,1,4.90E-05,883171,0.996132416
31483,684,114,1,1,4.90E-05,883172,0.996133544
31481,668,140,1,1,4.90E-05,883173,0.996134672
31480,668,4,1,1,4.90E-05,883174,0.9961358
31479,107,701,1,1,4.90E-05,883175,0.996136928
32927,126,398,1,1,4.90E-05,883176,0.996138055
31478,684,661,1,1,4.90E-05,883177,0.996139183
32928,181,397,1,1,4.90E-05,883178,0.996140311
32929,170,661,1,1,4.90E-05,883179,0.996141439
31465,12,160,1,1,4.90E-05,883180,0.996142567
31574,562,626,1,1,4.90E-05,883181,0.996143695
31577,167,242,1,1,4.90E-05,883182,0.996144823
32686,117,138,1,1,4.90E-05,883183,0.996145951
32736,535,175,1,1,4.90E-05,883184,0.996147079
32703,560,29,1,1,4.90E-05,883185,0.996148207
32704,720,701,1,1,4.90E-05,883186,0.996149335
31655,699,646,1,1,4.90E-05,883187,0.996150462
31654,494,219,1,1,4.90E-05,883188,0.99615159
32730,19,482,1,1,4.90E-05,883189,0.996152718
31653,141,532,1,1,4.90E-05,883190,0.996153846
32733,195,501,1,1,4.90E-05,883191,0.996154974
31649,219,43,1,1,4.90E-05,883192,0.996156102
32734,14,332,1,1,4.90E-05,883193,0.99615723
31647,126,532,1,1,4.90E-05,883194,0.996158358
32780,257,310,1,1,4.90E-05,883195,0.996159486
31646,501,207,1,1,4.90E-05,883196,0.996160614
31642,511,246,1,1,4.90E-05,883197,0.996161741
31641,10,19,1,1,4.90E-05,883198,0.996162869
32747,26,492,1,1,4.90E-05,883199,0.996163997
31636,492,593,1,1,4.90E-05,883200,0.996165125
32777,103,22,1,1,4.90E-05,883201,0.996166253
31634,718,29,1,1,4.90E-05,883202,0.996167381
31633,492,544,1,1,4.90E-05,883203,0.996168509
32778,261,661,1,1,4.90E-05,883204,0.996169637
31660,124,140,1,1,4.90E-05,883205,0.996170765
31661,23,673,1,1,4.90E-05,883206,0.996171893
32702,295,668,1,1,4.90E-05,883207,0.996173021
32701,124,383,1,1,4.90E-05,883208,0.996174148
32688,332,414,1,1,4.90E-05,883209,0.996175276
31689,482,265,1,1,4.90E-05,883210,0.996176404
32689,508,586,1,1,4.90E-05,883211,0.996177532
31684,655,13,1,1,4.90E-05,883212,0.99617866
32690,175,501,1,1,4.90E-05,883213,0.996179788
31679,19,25,1,1,4.90E-05,883214,0.996180916
32692,140,29,1,1,4.90E-05,883215,0.996182044
31676,5,22,1,1,4.90E-05,883216,0.996183172
31675,26,43,1,1,4.90E-05,883217,0.9961843
32693,624,414,1,1,4.90E-05,883218,0.996185427
32694,655,576,1,1,4.90E-05,883219,0.996186555
32695,446,261,1,1,4.90E-05,883220,0.996187683
32696,178,497,1,1,4.90E-05,883221,0.996188811
31671,703,20,1,1,4.90E-05,883222,0.996189939
32697,661,20,1,1,4.90E-05,883223,0.996191067
31670,721,673,1,1,4.90E-05,883224,0.996192195
31669,683,502,1,1,4.90E-05,883225,0.996193323
31665,137,130,1,1,4.90E-05,883226,0.996194451
31664,717,463,1,1,4.90E-05,883227,0.996195579
32779,717,443,1,1,4.90E-05,883228,0.996196707
31629,661,502,1,1,4.90E-05,883229,0.996197834
31579,97,23,1,1,4.90E-05,883230,0.996198962
31595,439,294,1,1,4.90E-05,883231,0.99620009
32808,703,167,1,1,4.90E-05,883232,0.996201218
31609,328,684,1,1,4.90E-05,883233,0.996202346
31608,294,171,1,1,4.90E-05,883234,0.996203474
32810,364,2,1,1,4.90E-05,883235,0.996204602
32814,719,482,1,1,4.90E-05,883236,0.99620573
31603,638,494,1,1,4.90E-05,883237,0.996206858
32817,196,482,1,1,4.90E-05,883238,0.996207986
32823,33,699,1,1,4.90E-05,883239,0.996209113
32825,195,507,1,1,4.90E-05,883240,0.996210241
31592,568,224,1,1,4.90E-05,883241,0.996211369
32781,475,137,1,1,4.90E-05,883242,0.996212497
31588,170,632,1,1,4.90E-05,883243,0.996213625
31587,138,587,1,1,4.90E-05,883244,0.996214753
32839,342,15,1,1,4.90E-05,883245,0.996215881
32844,54,90,1,1,4.90E-05,883246,0.996217009
31582,624,23,1,1,4.90E-05,883247,0.996218137
32845,682,294,1,1,4.90E-05,883248,0.996219265
32851,514,624,1,1,4.90E-05,883249,0.996220393
32854,479,133,1,1,4.90E-05,883250,0.99622152
32856,568,14,1,1,4.90E-05,883251,0.996222648
32805,280,717,1,1,4.90E-05,883252,0.996223776
32803,202,130,1,1,4.90E-05,883253,0.996224904
32802,103,562,1,1,4.90E-05,883254,0.996226032
31610,364,661,1,1,4.90E-05,883255,0.99622716
32782,29,171,1,1,4.90E-05,883256,0.996228288
32783,494,140,1,1,4.90E-05,883257,0.996229416
31626,409,164,1,1,4.90E-05,883258,0.996230544
32784,371,558,1,1,4.90E-05,883259,0.996231672
32785,471,319,1,1,4.90E-05,883260,0.996232799
32786,178,517,1,1,4.90E-05,883261,0.996233927
32787,393,448,1,1,4.90E-05,883262,0.996235055
31623,117,140,1,1,4.90E-05,883263,0.996236183
32789,719,684,1,1,4.90E-05,883264,0.996237311
32791,64,492,1,1,4.90E-05,883265,0.996238439
32792,64,508,1,1,4.90E-05,883266,0.996239567
32793,596,458,1,1,4.90E-05,883267,0.996240695
32794,684,181,1,1,4.90E-05,883268,0.996241823
31620,54,1,1,1,4.90E-05,883269,0.996242951
32795,290,178,1,1,4.90E-05,883270,0.996244079
31619,661,265,1,1,4.90E-05,883271,0.996245206
31618,171,446,1,1,4.90E-05,883272,0.996246334
32799,689,202,1,1,4.90E-05,883273,0.996247462
32800,14,673,1,1,4.90E-05,883274,0.99624859
32969,64,13,1,1,4.90E-05,883275,0.996249718
32976,392,517,1,1,4.90E-05,883276,0.996250846
31413,121,652,1,1,4.90E-05,883277,0.996251974
31209,699,618,1,1,4.90E-05,883278,0.996253102
31227,587,614,1,1,4.90E-05,883279,0.99625423
33131,13,593,1,1,4.90E-05,883280,0.996255358
33132,294,511,1,1,4.90E-05,883281,0.996256485
31217,170,414,1,1,4.90E-05,883282,0.996257613
33134,13,319,1,1,4.90E-05,883283,0.996258741
33135,446,701,1,1,4.90E-05,883284,0.996259869
31216,26,103,1,1,4.90E-05,883285,0.996260997
31214,171,701,1,1,4.90E-05,883286,0.996262125
31212,364,613,1,1,4.90E-05,883287,0.996263253
33136,517,493,1,1,4.90E-05,883288,0.996264381
33148,701,446,1,1,4.90E-05,883289,0.996265509
33137,290,528,1,1,4.90E-05,883290,0.996266637
31204,342,398,1,1,4.90E-05,883291,0.996267764
33138,175,586,1,1,4.90E-05,883292,0.996268892
31203,719,290,1,1,4.90E-05,883293,0.99627002
33139,224,568,1,1,4.90E-05,883294,0.996271148
33142,274,684,1,1,4.90E-05,883295,0.996272276
31199,719,529,1,1,4.90E-05,883296,0.996273404
31198,332,261,1,1,4.90E-05,883297,0.996274532
33143,264,160,1,1,4.90E-05,883298,0.99627566
31230,34,137,1,1,4.90E-05,883299,0.996276788
33130,23,77,1,1,4.90E-05,883300,0.996277916
33129,11,124,1,1,4.90E-05,883301,0.996279044
31239,458,560,1,1,4.90E-05,883302,0.996280171
33102,126,250,1,1,4.90E-05,883303,0.996281299
33103,95,576,1,1,4.90E-05,883304,0.996282427
33105,140,133,1,1,4.90E-05,883305,0.996283555
33114,699,511,1,1,4.90E-05,883306,0.996284683
31264,43,492,1,1,4.90E-05,883307,0.996285811
33115,156,409,1,1,4.90E-05,883308,0.996286939
33121,652,508,1,1,4.90E-05,883309,0.996288067
31262,624,605,1,1,4.90E-05,883310,0.996289195
31261,124,673,1,1,4.90E-05,883311,0.996290323
31260,528,494,1,1,4.90E-05,883312,0.99629145
33122,347,163,1,1,4.90E-05,883313,0.996292578
31259,334,103,1,1,4.90E-05,883314,0.996293706
33123,571,246,1,1,4.90E-05,883315,0.996294834
31253,294,701,1,1,4.90E-05,883316,0.996295962
33124,383,492,1,1,4.90E-05,883317,0.99629709
33126,507,493,1,1,4.90E-05,883318,0.996298218
31252,562,571,1,1,4.90E-05,883319,0.996299346
31248,605,171,1,1,4.90E-05,883320,0.996300474
33128,719,265,1,1,4.90E-05,883321,0.996301602
33147,492,307,1,1,4.90E-05,883322,0.99630273
31196,508,140,1,1,4.90E-05,883323,0.996303857
32987,703,13,1,1,4.90E-05,883324,0.996304985
31164,30,133,1,1,4.90E-05,883325,0.996306113
33178,167,609,1,1,4.90E-05,883326,0.996307241
33179,723,5,1,1,4.90E-05,883327,0.996308369
33187,446,517,1,1,4.90E-05,883328,0.996309497
31169,265,618,1,1,4.90E-05,883329,0.996310625
31167,34,646,1,1,4.90E-05,883330,0.996311753
33189,126,156,1,1,4.90E-05,883331,0.996312881
33198,492,64,1,1,4.90E-05,883332,0.996314009
31165,155,571,1,1,4.90E-05,883333,0.996315136
33207,568,544,1,1,4.90E-05,883334,0.996316264
31163,448,532,1,1,4.90E-05,883335,0.996317392
31193,160,313,1,1,4.90E-05,883336,0.99631852
31162,586,576,1,1,4.90E-05,883337,0.996319648
33211,493,1,1,1,4.90E-05,883338,0.996320776
33212,54,501,1,1,4.90E-05,883339,0.996321904
31161,15,720,1,1,4.90E-05,883340,0.996323032
33213,721,624,1,1,4.90E-05,883341,0.99632416
31153,137,414,1,1,4.90E-05,883342,0.996325288
31152,529,446,1,1,4.90E-05,883343,0.996326416
33216,160,427,1,1,4.90E-05,883344,0.996327543
31150,640,261,1,1,4.90E-05,883345,0.996328671
33177,261,178,1,1,4.90E-05,883346,0.996329799
31172,307,202,1,1,4.90E-05,883347,0.996330927
31173,439,493,1,1,4.90E-05,883348,0.996332055
31175,3,178,1,1,4.90E-05,883349,0.996333183
33151,246,383,1,1,4.90E-05,883350,0.996334311
33152,274,181,1,1,4.90E-05,883351,0.996335439
33153,492,605,1,1,4.90E-05,883352,0.996336567
33154,126,517,1,1,4.90E-05,883353,0.996337695
31191,379,371,1,1,4.90E-05,883354,0.996338822
33156,427,569,1,1,4.90E-05,883355,0.99633995
33157,170,514,1,1,4.90E-05,883356,0.996341078
31189,721,508,1,1,4.90E-05,883357,0.996342206
31187,124,652,1,1,4.90E-05,883358,0.996343334
31185,587,84,1,1,4.90E-05,883359,0.996344462
31183,364,294,1,1,4.90E-05,883360,0.99634559
33158,107,257,1,1,4.90E-05,883361,0.996346718
33160,398,448,1,1,4.90E-05,883362,0.996347846
33161,668,458,1,1,4.90E-05,883363,0.996348974
33162,124,332,1,1,4.90E-05,883364,0.996350102
33164,646,174,1,1,4.90E-05,883365,0.996351229
31176,171,12,1,1,4.90E-05,883366,0.996352357
33167,347,138,1,1,4.90E-05,883367,0.996353485
33175,701,141,1,1,4.90E-05,883368,0.996354613
33101,4,618,1,1,4.90E-05,883369,0.996355741
33100,492,160,1,1,4.90E-05,883370,0.996356869
31268,261,587,1,1,4.90E-05,883371,0.996357997
31348,23,163,1,1,4.90E-05,883372,0.996359125
33007,605,193,1,1,4.90E-05,883373,0.996360253
31357,342,354,1,1,4.90E-05,883374,0.996361381
31355,613,15,1,1,4.90E-05,883375,0.996362508
33012,398,624,1,1,4.90E-05,883376,0.996363636
33015,202,107,1,1,4.90E-05,883377,0.996364764
33016,334,720,1,1,4.90E-05,883378,0.996365892
33018,492,723,1,1,4.90E-05,883379,0.99636702
33019,328,332,1,1,4.90E-05,883380,0.996368148
33020,718,103,1,1,4.90E-05,883381,0.996369276
31346,2,569,1,1,4.90E-05,883382,0.996370404
31269,714,334,1,1,4.90E-05,883383,0.996371532
33021,371,158,1,1,4.90E-05,883384,0.99637266
33024,121,269,1,1,4.90E-05,883385,0.996373788
31345,719,587,1,1,4.90E-05,883386,0.996374915
33029,175,514,1,1,4.90E-05,883387,0.996376043
31344,195,701,1,1,4.90E-05,883388,0.996377171
31341,85,335,1,1,4.90E-05,883389,0.996378299
33033,502,576,1,1,4.90E-05,883390,0.996379427
31337,663,138,1,1,4.90E-05,883391,0.996380555
31336,721,175,1,1,4.90E-05,883392,0.996381683
31358,195,193,1,1,4.90E-05,883393,0.996382811
31360,334,673,1,1,4.90E-05,883394,0.996383939
31361,571,502,1,1,4.90E-05,883395,0.996385067
31362,673,624,1,1,4.90E-05,883396,0.996386194
32988,121,684,1,1,4.90E-05,883397,0.996387322
31406,145,626,1,1,4.90E-05,883398,0.99638845
32989,164,448,1,1,4.90E-05,883399,0.996389578
31403,167,171,1,1,4.90E-05,883400,0.996390706
32990,307,43,1,1,4.90E-05,883401,0.996391834
32991,26,668,1,1,4.90E-05,883402,0.996392962
32993,720,141,1,1,4.90E-05,883403,0.99639409
31392,23,535,1,1,4.90E-05,883404,0.996395218
31391,269,497,1,1,4.90E-05,883405,0.996396346
32994,124,269,1,1,4.90E-05,883406,0.996397473
31385,121,14,1,1,4.90E-05,883407,0.996398601
31384,492,507,1,1,4.90E-05,883408,0.996399729
31379,22,261,1,1,4.90E-05,883409,0.996400857
31376,632,269,1,1,4.90E-05,883410,0.996401985
31371,257,482,1,1,4.90E-05,883411,0.996403113
32996,371,498,1,1,4.90E-05,883412,0.996404241
32998,576,314,1,1,4.90E-05,883413,0.996405369
33000,652,29,1,1,4.90E-05,883414,0.996406497
33001,514,342,1,1,4.90E-05,883415,0.996407625
33040,202,398,1,1,4.90E-05,883416,0.996408753
31334,105,717,1,1,4.90E-05,883417,0.99640988
31333,12,332,1,1,4.90E-05,883418,0.996411008
33074,699,439,1,1,4.90E-05,883419,0.996412136
33077,178,84,1,1,4.90E-05,883420,0.996413264
33080,5,683,1,1,4.90E-05,883421,0.996414392
31294,313,202,1,1,4.90E-05,883422,0.99641552
31291,624,328,1,1,4.90E-05,883423,0.996416648
33081,84,699,1,1,4.90E-05,883424,0.996417776
31289,269,114,1,1,4.90E-05,883425,0.996418904
33083,23,196,1,1,4.90E-05,883426,0.996420032
31287,175,219,1,1,4.90E-05,883427,0.996421159
31286,236,124,1,1,4.90E-05,883428,0.996422287
33085,23,6,1,1,4.90E-05,883429,0.996423415
33088,246,409,1,1,4.90E-05,883430,0.996424543
33090,164,717,1,1,4.90E-05,883431,0.996425671
33096,371,443,1,1,4.90E-05,883432,0.996426799
33097,708,593,1,1,4.90E-05,883433,0.996427927
33098,175,12,1,1,4.90E-05,883434,0.996429055
31276,458,596,1,1,4.90E-05,883435,0.996430183
31274,588,160,1,1,4.90E-05,883436,0.996431311
31273,204,568,1,1,4.90E-05,883437,0.996432439
33099,274,492,1,1,4.90E-05,883438,0.996433566
31296,193,242,1,1,4.90E-05,883439,0.996434694
33073,626,311,1,1,4.90E-05,883440,0.996435822
33041,280,458,1,1,4.90E-05,883441,0.99643695
31300,342,674,1,1,4.90E-05,883442,0.996438078
31328,414,175,1,1,4.90E-05,883443,0.996439206
33042,689,23,1,1,4.90E-05,883444,0.996440334
31327,683,264,1,1,4.90E-05,883445,0.996441462
33046,721,193,1,1,4.90E-05,883446,0.99644259
31325,29,701,1,1,4.90E-05,883447,0.996443718
33047,178,609,1,1,4.90E-05,883448,0.996444845
33049,170,439,1,1,4.90E-05,883449,0.996445973
31322,193,56,1,1,4.90E-05,883450,0.996447101
33051,624,242,1,1,4.90E-05,883451,0.996448229
31320,718,708,1,1,4.90E-05,883452,0.996449357
31316,294,193,1,1,4.90E-05,883453,0.996450485
33057,140,175,1,1,4.90E-05,883454,0.996451613
33059,12,371,1,1,4.90E-05,883455,0.996452741
33060,562,720,1,1,4.90E-05,883456,0.996453869
31311,246,475,1,1,4.90E-05,883457,0.996454997
33063,178,626,1,1,4.90E-05,883458,0.996456125
33067,385,720,1,1,4.90E-05,883459,0.996457252
31308,290,701,1,1,4.90E-05,883460,0.99645838
31301,31,202,1,1,4.90E-05,883461,0.996459508
32687,392,2,1,1,4.90E-05,883462,0.996460636
32685,1,503,1,1,4.90E-05,883463,0.996461764
30111,11,160,1,1,4.90E-05,883464,0.996462892
32008,290,646,1,1,4.90E-05,883465,0.99646402
32016,614,43,1,1,4.90E-05,883466,0.996465148
32015,593,717,1,1,4.90E-05,883467,0.996466276
32012,507,576,1,1,4.90E-05,883468,0.996467404
32325,494,385,1,1,4.90E-05,883469,0.996468531
32010,683,605,1,1,4.90E-05,883470,0.996469659
32329,544,124,1,1,4.90E-05,883471,0.996470787
32009,224,492,1,1,4.90E-05,883472,0.996471915
32332,114,494,1,1,4.90E-05,883473,0.996473043
32334,175,130,1,1,4.90E-05,883474,0.996474171
32335,26,720,1,1,4.90E-05,883475,0.996475299
31984,618,494,1,1,4.90E-05,883476,0.996476427
32336,683,493,1,1,4.90E-05,883477,0.996477555
32339,568,15,1,1,4.90E-05,883478,0.996478683
32340,492,250,1,1,4.90E-05,883479,0.996479811
32003,138,167,1,1,4.90E-05,883480,0.996480938
32341,174,646,1,1,4.90E-05,883481,0.996482066
32344,145,137,1,1,4.90E-05,883482,0.996483194
32002,492,371,1,1,4.90E-05,883483,0.996484322
31991,295,138,1,1,4.90E-05,883484,0.99648545
31988,618,433,1,1,4.90E-05,883485,0.996486578
32017,458,12,1,1,4.90E-05,883486,0.996487706
32018,718,30,1,1,4.90E-05,883487,0.996488834
32324,482,646,1,1,4.90E-05,883488,0.996489962
32021,193,4,1,1,4.90E-05,883489,0.99649109
32292,646,12,1,1,4.90E-05,883490,0.996492217
32043,673,319,1,1,4.90E-05,883491,0.996493345
32294,560,64,1,1,4.90E-05,883492,0.996494473
32295,618,624,1,1,4.90E-05,883493,0.996495601
32301,294,646,1,1,4.90E-05,883494,0.996496729
32038,19,261,1,1,4.90E-05,883495,0.996497857
32035,507,618,1,1,4.90E-05,883496,0.996498985
32305,178,682,1,1,4.90E-05,883497,0.996500113
32033,492,652,1,1,4.90E-05,883498,0.996501241
32309,525,569,1,1,4.90E-05,883499,0.996502369
32032,720,448,1,1,4.90E-05,883500,0.996503497
32031,364,682,1,1,4.90E-05,883501,0.996504624
32313,332,543,1,1,4.90E-05,883502,0.996505752
32030,525,195,1,1,4.90E-05,883503,0.99650688
32320,160,682,1,1,4.90E-05,883504,0.996508008
32026,23,50,1,1,4.90E-05,883505,0.996509136
32321,195,328,1,1,4.90E-05,883506,0.996510264
32023,1,717,1,1,4.90E-05,883507,0.996511392
32323,5,684,1,1,4.90E-05,883508,0.99651252
31985,613,673,1,1,4.90E-05,883509,0.996513648
32347,528,661,1,1,4.90E-05,883510,0.996514776
32044,719,156,1,1,4.90E-05,883511,0.996515903
32410,701,193,1,1,4.90E-05,883512,0.996517031
32397,13,383,1,1,4.90E-05,883513,0.996518159
31943,175,4,1,1,4.90E-05,883514,0.996519287
31941,560,535,1,1,4.90E-05,883515,0.996520415
32399,181,517,1,1,4.90E-05,883516,0.996521543
31938,265,684,1,1,4.90E-05,883517,0.996522671
32401,160,174,1,1,4.90E-05,883518,0.996523799
31934,618,328,1,1,4.90E-05,883519,0.996524927
32406,126,701,1,1,4.90E-05,883520,0.996526055
32408,494,25,1,1,4.90E-05,883521,0.996527182
32411,13,43,1,1,4.90E-05,883522,0.99652831
32358,19,13,1,1,4.90E-05,883523,0.996529438
31931,721,569,1,1,4.90E-05,883524,0.996530566
32412,181,171,1,1,4.90E-05,883525,0.996531694
32413,347,576,1,1,4.90E-05,883526,0.996532822
32415,145,613,1,1,4.90E-05,883527,0.99653395
31929,529,525,1,1,4.90E-05,883528,0.996535078
32416,174,328,1,1,4.90E-05,883529,0.996536206
32417,5,332,1,1,4.90E-05,883530,0.996537334
31928,126,588,1,1,4.90E-05,883531,0.996538462
32418,514,103,1,1,4.90E-05,883532,0.996539589
31950,290,502,1,1,4.90E-05,883533,0.996540717
28717,103,242,1,1,4.90E-05,883534,0.996541845
32395,64,242,1,1,4.90E-05,883535,0.996542973
31952,6,626,1,1,4.90E-05,883536,0.996544101
32359,718,11,1,1,4.90E-05,883537,0.996545229
32360,517,593,1,1,4.90E-05,883538,0.996546357
32361,347,23,1,1,4.90E-05,883539,0.996547485
31972,10,458,1,1,4.90E-05,883540,0.996548613
32368,11,103,1,1,4.90E-05,883541,0.996549741
32370,90,4,1,1,4.90E-05,883542,0.996550868
31971,332,4,1,1,4.90E-05,883543,0.996551996
31970,22,56,1,1,4.90E-05,883544,0.996553124
32372,124,624,1,1,4.90E-05,883545,0.996554252
31966,507,133,1,1,4.90E-05,883546,0.99655538
32377,13,290,1,1,4.90E-05,883547,0.996556508
32383,571,126,1,1,4.90E-05,883548,0.996557636
31961,334,138,1,1,4.90E-05,883549,0.996558764
31957,347,319,1,1,4.90E-05,883550,0.996559892
32385,721,560,1,1,4.90E-05,883551,0.99656102
32391,503,593,1,1,4.90E-05,883552,0.996562148
31956,202,141,1,1,4.90E-05,883553,0.996563275
31955,155,404,1,1,4.90E-05,883554,0.996564403
31954,364,22,1,1,4.90E-05,883555,0.996565531
32291,246,133,1,1,4.90E-05,883556,0.996566659
32285,668,385,1,1,4.90E-05,883557,0.996567787
32684,250,174,1,1,4.90E-05,883558,0.996568915
32116,269,503,1,1,4.90E-05,883559,0.996570043
32184,202,393,1,1,4.90E-05,883560,0.996571171
32132,497,569,1,1,4.90E-05,883561,0.996572299
32186,124,517,1,1,4.90E-05,883562,0.996573427
32187,703,95,1,1,4.90E-05,883563,0.996574554
32188,181,27,1,1,4.90E-05,883564,0.996575682
32130,121,30,1,1,4.90E-05,883565,0.99657681
32129,684,439,1,1,4.90E-05,883566,0.996577938
32122,626,230,1,1,4.90E-05,883567,0.996579066
32118,141,126,1,1,4.90E-05,883568,0.996580194
32192,503,708,1,1,4.90E-05,883569,0.996581322
32219,385,587,1,1,4.90E-05,883570,0.99658245
32196,269,20,1,1,4.90E-05,883571,0.996583578
32110,174,701,1,1,4.90E-05,883572,0.996584706
32199,718,64,1,1,4.90E-05,883573,0.996585834
32205,80,626,1,1,4.90E-05,883574,0.996586961
32209,507,661,1,1,4.90E-05,883575,0.996588089
32210,528,195,1,1,4.90E-05,883576,0.996589217
32107,560,517,1,1,4.90E-05,883577,0.996590345
32213,10,717,1,1,4.90E-05,883578,0.996591473
32215,503,528,1,1,4.90E-05,883579,0.996592601
32183,493,167,1,1,4.90E-05,883580,0.996593729
32134,90,544,1,1,4.90E-05,883581,0.996594857
32181,684,246,1,1,4.90E-05,883582,0.996595985
32135,269,632,1,1,4.90E-05,883583,0.996597113
32153,532,720,1,1,4.90E-05,883584,0.99659824
32148,721,439,1,1,4.90E-05,883585,0.996599368
32147,446,394,1,1,4.90E-05,883586,0.996600496
32158,114,13,1,1,4.90E-05,883587,0.996601624
32159,171,613,1,1,4.90E-05,883588,0.996602752
32161,652,16,1,1,4.90E-05,883589,0.99660388
32164,204,721,1,1,4.90E-05,883590,0.996605008
32143,202,714,1,1,4.90E-05,883591,0.996606136
32142,156,133,1,1,4.90E-05,883592,0.996607264
32141,494,427,1,1,4.90E-05,883593,0.996608392
32168,661,141,1,1,4.90E-05,883594,0.99660952
32170,646,29,1,1,4.90E-05,883595,0.996610647
32174,683,503,1,1,4.90E-05,883596,0.996611775
32140,117,126,1,1,4.90E-05,883597,0.996612903
32136,624,207,1,1,4.90E-05,883598,0.996614031
32175,661,552,1,1,4.90E-05,883599,0.996615159
32177,1,646,1,1,4.90E-05,883600,0.996616287
32178,560,632,1,1,4.90E-05,883601,0.996617415
32179,124,552,1,1,4.90E-05,883602,0.996618543
32217,103,544,1,1,4.90E-05,883603,0.996619671
32220,661,398,1,1,4.90E-05,883604,0.996620799
32284,124,103,1,1,4.90E-05,883605,0.996621926
32065,50,720,1,1,4.90E-05,883606,0.996623054
32256,64,562,1,1,4.90E-05,883607,0.996624182
32073,140,156,1,1,4.90E-05,883608,0.99662531
32258,80,178,1,1,4.90E-05,883609,0.996626438
32259,23,48,1,1,4.90E-05,883610,0.996627566
32068,137,84,1,1,4.90E-05,883611,0.996628694
32260,302,160,1,1,4.90E-05,883612,0.996629822
32261,367,684,1,1,4.90E-05,883613,0.99663095
32262,126,193,1,1,4.90E-05,883614,0.996632078
32263,95,175,1,1,4.90E-05,883615,0.996633206
32060,701,562,1,1,4.90E-05,883616,0.996634333
32099,494,348,1,1,4.90E-05,883617,0.996635461
32270,605,195,1,1,4.90E-05,883618,0.996636589
32058,20,668,1,1,4.90E-05,883619,0.996637717
32272,294,246,1,1,4.90E-05,883620,0.996638845
32057,528,371,1,1,4.90E-05,883621,0.996639973
32055,20,137,1,1,4.90E-05,883622,0.996641101
32049,717,353,1,1,4.90E-05,883623,0.996642229
32276,2,261,1,1,4.90E-05,883624,0.996643357
32281,178,307,1,1,4.90E-05,883625,0.996644485
32047,193,482,1,1,4.90E-05,883626,0.996645612
32253,163,560,1,1,4.90E-05,883627,0.99664674
32250,475,90,1,1,4.90E-05,883628,0.996647868
32249,443,433,1,1,4.90E-05,883629,0.996648996
32248,3,576,1,1,4.90E-05,883630,0.996650124
32096,224,717,1,1,4.90E-05,883631,0.996651252
32224,720,265,1,1,4.90E-05,883632,0.99665238
32091,26,202,1,1,4.90E-05,883633,0.996653508
32226,646,560,1,1,4.90E-05,883634,0.996654636
32227,170,618,1,1,4.90E-05,883635,0.996655764
32229,626,164,1,1,4.90E-05,883636,0.996656891
32090,23,558,1,1,4.90E-05,883637,0.996658019
32089,19,274,1,1,4.90E-05,883638,0.996659147
32088,683,517,1,1,4.90E-05,883639,0.996660275
32087,181,64,1,1,4.90E-05,883640,0.996661403
32235,427,195,1,1,4.90E-05,883641,0.996662531
32237,689,409,1,1,4.90E-05,883642,0.996663659
32081,720,140,1,1,4.90E-05,883643,0.996664787
32079,15,124,1,1,4.90E-05,883644,0.996665915
32238,723,380,1,1,4.90E-05,883645,0.996667043
32239,174,160,1,1,4.90E-05,883646,0.996668171
32241,626,310,1,1,4.90E-05,883647,0.996669298
32243,124,571,1,1,4.90E-05,883648,0.996670426
32245,160,34,1,1,4.90E-05,883649,0.996671554
32419,626,9,1,1,4.90E-05,883650,0.996672682
31926,347,668,1,1,4.90E-05,883651,0.99667381
31925,224,626,1,1,4.90E-05,883652,0.996674938
32540,392,195,1,1,4.90E-05,883653,0.996676066
31748,314,699,1,1,4.90E-05,883654,0.996677194
32534,576,167,1,1,4.90E-05,883655,0.996678322
32535,331,19,1,1,4.90E-05,883656,0.99667945
32536,613,155,1,1,4.90E-05,883657,0.996680577
32537,494,30,1,1,4.90E-05,883658,0.996681705
32538,446,130,1,1,4.90E-05,883659,0.996682833
32539,367,433,1,1,4.90E-05,883660,0.996683961
31742,280,492,1,1,4.90E-05,883661,0.996685089
31741,587,26,1,1,4.90E-05,883662,0.996686217
32541,640,720,1,1,4.90E-05,883663,0.996687345
32554,661,463,1,1,4.90E-05,883664,0.996688473
32542,50,319,1,1,4.90E-05,883665,0.996689601
32544,552,261,1,1,4.90E-05,883666,0.996690729
32546,392,502,1,1,4.90E-05,883667,0.996691857
31738,494,614,1,1,4.90E-05,883668,0.996692984
32548,717,433,1,1,4.90E-05,883669,0.996694112
32550,19,364,1,1,4.90E-05,883670,0.99669524
32551,593,124,1,1,4.90E-05,883671,0.996696368
32552,265,482,1,1,4.90E-05,883672,0.996697496
32553,714,85,1,1,4.90E-05,883673,0.996698624
31750,19,178,1,1,4.90E-05,883674,0.996699752
32533,661,508,1,1,4.90E-05,883675,0.99670088
31752,684,175,1,1,4.90E-05,883676,0.996702008
31754,9,433,1,1,4.90E-05,883677,0.996703136
31784,723,11,1,1,4.90E-05,883678,0.996704263
31783,307,493,1,1,4.90E-05,883679,0.996705391
32521,661,674,1,1,4.90E-05,883680,0.996706519
32522,195,364,1,1,4.90E-05,883681,0.996707647
31777,613,507,1,1,4.90E-05,883682,0.996708775
32523,29,503,1,1,4.90E-05,883683,0.996709903
31772,50,23,1,1,4.90E-05,883684,0.996711031
31769,145,568,1,1,4.90E-05,883685,0.996712159
32525,720,528,1,1,4.90E-05,883686,0.996713287
32526,684,195,1,1,4.90E-05,883687,0.996714415
31762,385,20,1,1,4.90E-05,883688,0.996715543
32527,614,290,1,1,4.90E-05,883689,0.99671667
32528,560,14,1,1,4.90E-05,883690,0.996717798
32529,586,124,1,1,4.90E-05,883691,0.996718926
31759,64,85,1,1,4.90E-05,883692,0.996720054
32530,54,13,1,1,4.90E-05,883693,0.996721182
32531,12,721,1,1,4.90E-05,883694,0.99672231
32532,64,661,1,1,4.90E-05,883695,0.996723438
31757,364,673,1,1,4.90E-05,883696,0.996724566
31732,124,23,1,1,4.90E-05,883697,0.996725694
31731,684,503,1,1,4.90E-05,883698,0.996726822
32420,708,342,1,1,4.90E-05,883699,0.996727949
32651,404,652,1,1,4.90E-05,883700,0.996729077
31707,448,117,1,1,4.90E-05,883701,0.996730205
32621,626,246,1,1,4.90E-05,883702,0.996731333
32625,19,409,1,1,4.90E-05,883703,0.996732461
32628,202,528,1,1,4.90E-05,883704,0.996733589
31706,117,661,1,1,4.90E-05,883705,0.996734717
31705,511,54,1,1,4.90E-05,883706,0.996735845
32637,85,6,1,1,4.90E-05,883707,0.996736973
32642,290,294,1,1,4.90E-05,883708,0.996738101
32643,605,701,1,1,4.90E-05,883709,0.996739229
32654,314,568,1,1,4.90E-05,883710,0.996740356
32555,178,269,1,1,4.90E-05,883711,0.996741484
32656,703,354,1,1,4.90E-05,883712,0.996742612
31698,569,32,1,1,4.90E-05,883713,0.99674374
32660,392,140,1,1,4.90E-05,883714,0.996744868
31697,348,319,1,1,4.90E-05,883715,0.996745996
32662,160,1,1,1,4.90E-05,883716,0.996747124
32676,170,332,1,1,4.90E-05,883717,0.996748252
32677,714,155,1,1,4.90E-05,883718,0.99674938
31694,160,29,1,1,4.90E-05,883719,0.996750508
32683,503,535,1,1,4.90E-05,883720,0.996751635
32619,613,624,1,1,4.90E-05,883721,0.996752763
31708,673,668,1,1,4.90E-05,883722,0.996753891
31709,295,202,1,1,4.90E-05,883723,0.996755019
32615,123,458,1,1,4.90E-05,883724,0.996756147
32557,718,367,1,1,4.90E-05,883725,0.996757275
32558,528,508,1,1,4.90E-05,883726,0.996758403
31728,195,178,1,1,4.90E-05,883727,0.996759531
32559,560,347,1,1,4.90E-05,883728,0.996760659
32560,195,529,1,1,4.90E-05,883729,0.996761787
31725,328,494,1,1,4.90E-05,883730,0.996762915
31723,409,507,1,1,4.90E-05,883731,0.996764042
32561,85,473,1,1,4.90E-05,883732,0.99676517
32563,392,371,1,1,4.90E-05,883733,0.996766298
32564,433,463,1,1,4.90E-05,883734,0.996767426
32565,414,652,1,1,4.90E-05,883735,0.996768554
32566,511,494,1,1,4.90E-05,883736,0.996769682
32586,124,458,1,1,4.90E-05,883737,0.99677081
32587,202,294,1,1,4.90E-05,883738,0.996771938
32613,475,719,1,1,4.90E-05,883739,0.996773066
31712,171,207,1,1,4.90E-05,883740,0.996774194
32614,174,383,1,1,4.90E-05,883741,0.996775321
31711,626,174,1,1,4.90E-05,883742,0.996776449
31710,294,517,1,1,4.90E-05,883743,0.996777577
31789,720,640,1,1,4.90E-05,883744,0.996778705
32519,721,392,1,1,4.90E-05,883745,0.996779833
31790,171,90,1,1,4.90E-05,883746,0.996780961
32445,204,409,1,1,4.90E-05,883747,0.996782089
32440,163,673,1,1,4.90E-05,883748,0.996783217
31899,202,507,1,1,4.90E-05,883749,0.996784345
32441,394,193,1,1,4.90E-05,883750,0.996785473
32442,393,19,1,1,4.90E-05,883751,0.9967866
31898,2,571,1,1,4.90E-05,883752,0.996787728
31889,494,164,1,1,4.90E-05,883753,0.996788856
32444,30,576,1,1,4.90E-05,883754,0.996789984
31888,19,517,1,1,4.90E-05,883755,0.996791112
31887,5,371,1,1,4.90E-05,883756,0.99679224
32447,19,175,1,1,4.90E-05,883757,0.996793368
31791,723,367,1,1,4.90E-05,883758,0.996794496
31882,613,246,1,1,4.90E-05,883759,0.996795624
31875,68,492,1,1,4.90E-05,883760,0.996796752
31874,503,348,1,1,4.90E-05,883761,0.99679788
31871,471,290,1,1,4.90E-05,883762,0.996799007
32448,43,684,1,1,4.90E-05,883763,0.996800135
31870,609,23,1,1,4.90E-05,883764,0.996801263
31868,207,409,1,1,4.90E-05,883765,0.996802391
31864,661,683,1,1,4.90E-05,883766,0.996803519
31863,204,482,1,1,4.90E-05,883767,0.996804647
32439,131,717,1,1,4.90E-05,883768,0.996805775
31901,699,393,1,1,4.90E-05,883769,0.996806903
32438,392,511,1,1,4.90E-05,883770,0.996808031
32436,718,443,1,1,4.90E-05,883771,0.996809159
32422,652,443,1,1,4.90E-05,883772,0.996810286
32423,409,562,1,1,4.90E-05,883773,0.996811414
32424,683,525,1,1,4.90E-05,883774,0.996812542
31923,497,178,1,1,4.90E-05,883775,0.99681367
32425,137,398,1,1,4.90E-05,883776,0.996814798
32426,448,535,1,1,4.90E-05,883777,0.996815926
31920,652,394,1,1,4.90E-05,883778,0.996817054
31919,720,562,1,1,4.90E-05,883779,0.996818182
32428,54,126,1,1,4.90E-05,883780,0.99681931
31910,493,605,1,1,4.90E-05,883781,0.996820438
32429,682,494,1,1,4.90E-05,883782,0.996821566
32430,699,503,1,1,4.90E-05,883783,0.996822693
31909,719,544,1,1,4.90E-05,883784,0.996823821
32432,525,493,1,1,4.90E-05,883785,0.996824949
31906,257,25,1,1,4.90E-05,883786,0.996826077
32433,448,54,1,1,4.90E-05,883787,0.996827205
32434,155,54,1,1,4.90E-05,883788,0.996828333
31905,174,525,1,1,4.90E-05,883789,0.996829461
31903,332,167,1,1,4.90E-05,883790,0.996830589
31860,290,4,1,1,4.90E-05,883791,0.996831717
32449,385,202,1,1,4.90E-05,883792,0.996832845
32450,103,13,1,1,4.90E-05,883793,0.996833972
32467,714,587,1,1,4.90E-05,883794,0.9968351
31823,207,508,1,1,4.90E-05,883795,0.996836228
32468,294,242,1,1,4.90E-05,883796,0.996837356
31819,68,699,1,1,4.90E-05,883797,0.996838484
31817,668,54,1,1,4.90E-05,883798,0.996839612
32470,140,290,1,1,4.90E-05,883799,0.99684074
32473,560,348,1,1,4.90E-05,883800,0.996841868
32474,14,137,1,1,4.90E-05,883801,0.996842996
31816,313,626,1,1,4.90E-05,883802,0.996844124
32475,404,701,1,1,4.90E-05,883803,0.996845252
31813,332,618,1,1,4.90E-05,883804,0.996846379
31811,4,137,1,1,4.90E-05,883805,0.996847507
32494,207,4,1,1,4.90E-05,883806,0.996848635
32499,328,721,1,1,4.90E-05,883807,0.996849763
31805,29,12,1,1,4.90E-05,883808,0.996850891
32508,433,54,1,1,4.90E-05,883809,0.996852019
31798,507,5,1,1,4.90E-05,883810,0.996853147
32511,701,19,1,1,4.90E-05,883811,0.996854275
32514,181,507,1,1,4.90E-05,883812,0.996855403
32515,661,507,1,1,4.90E-05,883813,0.996856531
31827,4,571,1,1,4.90E-05,883814,0.996857658
31832,33,433,1,1,4.90E-05,883815,0.996858786
31853,64,175,1,1,4.90E-05,883816,0.996859914
32465,334,43,1,1,4.90E-05,883817,0.996861042
31851,718,663,1,1,4.90E-05,883818,0.99686217
32451,511,137,1,1,4.90E-05,883819,0.996863298
32452,501,446,1,1,4.90E-05,883820,0.996864426
31850,699,708,1,1,4.90E-05,883821,0.996865554
32454,167,133,1,1,4.90E-05,883822,0.996866682
31849,626,397,1,1,4.90E-05,883823,0.99686781
31847,195,502,1,1,4.90E-05,883824,0.996868938
32455,560,544,1,1,4.90E-05,883825,0.996870065
32456,155,319,1,1,4.90E-05,883826,0.996871193
32458,23,56,1,1,4.90E-05,883827,0.996872321
32459,14,85,1,1,4.90E-05,883828,0.996873449
31845,471,492,1,1,4.90E-05,883829,0.996874577
31838,640,319,1,1,4.90E-05,883830,0.996875705
32461,95,646,1,1,4.90E-05,883831,0.996876833
31837,137,394,1,1,4.90E-05,883832,0.996877961
32462,498,613,1,1,4.90E-05,883833,0.996879089
32463,124,385,1,1,4.90E-05,883834,0.996880217
32464,124,121,1,1,4.90E-05,883835,0.996881344
31836,532,175,1,1,4.90E-05,883836,0.996882472
31149,409,439,1,1,4.90E-05,883837,0.9968836
33221,525,175,1,1,4.90E-05,883838,0.996884728
31143,560,479,1,1,4.90E-05,883839,0.996885856
33826,85,307,1,1,4.90E-05,883840,0.996886984
30441,193,514,1,1,4.90E-05,883841,0.996888112
30440,236,458,1,1,4.90E-05,883842,0.99688924
30433,571,84,1,1,4.90E-05,883843,0.996890368
30431,145,433,1,1,4.90E-05,883844,0.996891496
30429,261,1,1,1,4.90E-05,883845,0.996892624
30427,414,492,1,1,4.90E-05,883846,0.996893751
30426,347,383,1,1,4.90E-05,883847,0.996894879
30418,54,482,1,1,4.90E-05,883848,0.996896007
33824,448,175,1,1,4.90E-05,883849,0.996897135
33828,571,9,1,1,4.90E-05,883850,0.996898263
33839,167,56,1,1,4.90E-05,883851,0.996899391
33830,624,528,1,1,4.90E-05,883852,0.996900519
30413,97,90,1,1,4.90E-05,883853,0.996901647
33835,158,371,1,1,4.90E-05,883854,0.996902775
30412,64,586,1,1,4.90E-05,883855,0.996903903
30410,178,439,1,1,4.90E-05,883856,0.99690503
33837,141,652,1,1,4.90E-05,883857,0.996906158
30408,121,638,1,1,4.90E-05,883858,0.996907286
30407,498,719,1,1,4.90E-05,883859,0.996908414
33838,720,439,1,1,4.90E-05,883860,0.996909542
33820,655,178,1,1,4.90E-05,883861,0.99691067
30443,174,141,1,1,4.90E-05,883862,0.996911798
30444,85,310,1,1,4.90E-05,883863,0.996912926
30447,133,174,1,1,4.90E-05,883864,0.996914054
33806,137,56,1,1,4.90E-05,883865,0.996915182
30480,54,609,1,1,4.90E-05,883866,0.996916309
30478,576,280,1,1,4.90E-05,883867,0.996917437
30477,502,202,1,1,4.90E-05,883868,0.996918565
30476,257,16,1,1,4.90E-05,883869,0.996919693
30474,673,446,1,1,4.90E-05,883870,0.996920821
33808,721,571,1,1,4.90E-05,883871,0.996921949
33810,175,473,1,1,4.90E-05,883872,0.996923077
30471,181,522,1,1,4.90E-05,883873,0.996924205
30467,392,689,1,1,4.90E-05,883874,0.996925333
33811,175,29,1,1,4.90E-05,883875,0.996926461
30466,50,624,1,1,4.90E-05,883876,0.996927589
30463,443,624,1,1,4.90E-05,883877,0.996928716
32151,124,13,1,1,4.90E-05,883878,0.996929844
30458,269,68,1,1,4.90E-05,883879,0.996930972
30456,175,393,1,1,4.90E-05,883880,0.9969321
30454,397,571,1,1,4.90E-05,883881,0.996933228
30452,170,498,1,1,4.90E-05,883882,0.996934356
30451,141,328,1,1,4.90E-05,883883,0.996935484
30405,723,331,1,1,4.90E-05,883884,0.996936612
33842,250,178,1,1,4.90E-05,883885,0.99693774
30483,482,414,1,1,4.90E-05,883886,0.996938868
30340,353,178,1,1,4.90E-05,883887,0.996939995
30352,295,409,1,1,4.90E-05,883888,0.996941123
33850,29,482,1,1,4.90E-05,883889,0.996942251
30349,6,409,1,1,4.90E-05,883890,0.996943379
33853,290,156,1,1,4.90E-05,883891,0.996944507
33857,655,684,1,1,4.90E-05,883892,0.996945635
30348,655,652,1,1,4.90E-05,883893,0.996946763
30347,543,269,1,1,4.90E-05,883894,0.996947891
30344,632,383,1,1,4.90E-05,883895,0.996949019
30341,85,250,1,1,4.90E-05,883896,0.996950147
33858,250,202,1,1,4.90E-05,883897,0.996951275
30402,475,503,1,1,4.90E-05,883898,0.996952402
33862,54,5,1,1,4.90E-05,883899,0.99695353
30338,473,137,1,1,4.90E-05,883900,0.996954658
30337,160,701,1,1,4.90E-05,883901,0.996955786
30336,439,171,1,1,4.90E-05,883902,0.996956914
33873,507,719,1,1,4.90E-05,883903,0.996958042
30335,207,385,1,1,4.90E-05,883904,0.99695917
30334,103,195,1,1,4.90E-05,883905,0.996960298
33874,138,4,1,1,4.90E-05,883906,0.996961426
33877,342,14,1,1,4.90E-05,883907,0.996962554
30353,30,160,1,1,4.90E-05,883908,0.996963681
33849,458,682,1,1,4.90E-05,883909,0.996964809
30359,124,398,1,1,4.90E-05,883910,0.996965937
30360,703,171,1,1,4.90E-05,883911,0.996967065
30401,114,668,1,1,4.90E-05,883912,0.996968193
30399,668,265,1,1,4.90E-05,883913,0.996969321
30397,514,571,1,1,4.90E-05,883914,0.996970449
30395,145,19,1,1,4.90E-05,883915,0.996971577
30394,219,719,1,1,4.90E-05,883916,0.996972705
30393,446,393,1,1,4.90E-05,883917,0.996973833
30386,12,482,1,1,4.90E-05,883918,0.996974961
30385,409,265,1,1,4.90E-05,883919,0.996976088
33845,699,640,1,1,4.90E-05,883920,0.996977216
33847,121,22,1,1,4.90E-05,883921,0.996978344
30382,427,342,1,1,4.90E-05,883922,0.996979472
30376,15,409,1,1,4.90E-05,883923,0.9969806
30372,393,178,1,1,4.90E-05,883924,0.996981728
30371,571,609,1,1,4.90E-05,883925,0.996982856
30370,64,652,1,1,4.90E-05,883926,0.996983984
30369,364,448,1,1,4.90E-05,883927,0.996985112
30368,31,493,1,1,4.90E-05,883928,0.99698624
33848,668,646,1,1,4.90E-05,883929,0.996987367
30362,103,502,1,1,4.90E-05,883930,0.996988495
30482,448,164,1,1,4.90E-05,883931,0.996989623
30484,626,689,1,1,4.90E-05,883932,0.996990751
31142,4,371,1,1,4.90E-05,883933,0.996991879
33728,140,701,1,1,4.90E-05,883934,0.996993007
30583,269,14,1,1,4.90E-05,883935,0.996994135
30578,29,632,1,1,4.90E-05,883936,0.996995263
30570,167,4,1,1,4.90E-05,883937,0.996996391
30569,701,130,1,1,4.90E-05,883938,0.996997519
30566,571,204,1,1,4.90E-05,883939,0.996998647
30565,131,319,1,1,4.90E-05,883940,0.996999774
30562,1,576,1,1,4.90E-05,883941,0.997000902
33723,331,257,1,1,4.90E-05,883942,0.99700203
30559,576,224,1,1,4.90E-05,883943,0.997003158
33731,202,652,1,1,4.90E-05,883944,0.997004286
30540,463,103,1,1,4.90E-05,883945,0.997005414
33732,50,202,1,1,4.90E-05,883946,0.997006542
30552,683,2,1,1,4.90E-05,883947,0.99700767
30551,6,133,1,1,4.90E-05,883948,0.997008798
30550,64,560,1,1,4.90E-05,883949,0.997009926
30548,90,348,1,1,4.90E-05,883950,0.997011053
30546,638,319,1,1,4.90E-05,883951,0.997012181
33734,493,181,1,1,4.90E-05,883952,0.997013309
30545,646,618,1,1,4.90E-05,883953,0.997014437
33735,181,552,1,1,4.90E-05,883954,0.997015565
30587,243,624,1,1,4.90E-05,883955,0.997016693
30588,507,409,1,1,4.90E-05,883956,0.997017821
33718,133,90,1,1,4.90E-05,883957,0.997018949
30593,560,609,1,1,4.90E-05,883958,0.997020077
33677,614,624,1,1,4.90E-05,883959,0.997021205
30626,178,404,1,1,4.90E-05,883960,0.997022333
30621,163,383,1,1,4.90E-05,883961,0.99702346
30615,164,29,1,1,4.90E-05,883962,0.997024588
33681,507,494,1,1,4.90E-05,883963,0.997025716
30613,562,668,1,1,4.90E-05,883964,0.997026844
33697,646,517,1,1,4.90E-05,883965,0.997027972
30605,195,54,1,1,4.90E-05,883966,0.9970291
33700,85,475,1,1,4.90E-05,883967,0.997030228
30604,701,243,1,1,4.90E-05,883968,0.997031356
30602,246,195,1,1,4.90E-05,883969,0.997032484
33701,178,493,1,1,4.90E-05,883970,0.997033612
33703,683,587,1,1,4.90E-05,883971,0.997034739
33706,131,342,1,1,4.90E-05,883972,0.997035867
33707,29,392,1,1,4.90E-05,883973,0.997036995
33709,568,145,1,1,4.90E-05,883974,0.997038123
33711,593,138,1,1,4.90E-05,883975,0.997039251
33713,202,673,1,1,4.90E-05,883976,0.997040379
33716,269,479,1,1,4.90E-05,883977,0.997041507
33737,587,364,1,1,4.90E-05,883978,0.997042635
33744,501,568,1,1,4.90E-05,883979,0.997043763
30485,117,207,1,1,4.90E-05,883980,0.997044891
30495,661,126,1,1,4.90E-05,883981,0.997046018
33778,652,32,1,1,4.90E-05,883982,0.997047146
33779,140,525,1,1,4.90E-05,883983,0.997048274
30511,458,404,1,1,4.90E-05,883984,0.997049402
33781,163,439,1,1,4.90E-05,883985,0.99705053
30507,587,596,1,1,4.90E-05,883986,0.997051658
33782,175,663,1,1,4.90E-05,883987,0.997052786
30503,178,397,1,1,4.90E-05,883988,0.997053914
30498,195,126,1,1,4.90E-05,883989,0.997055042
30497,175,674,1,1,4.90E-05,883990,0.99705617
33784,294,618,1,1,4.90E-05,883991,0.997057298
33746,156,448,1,1,4.90E-05,883992,0.997058425
33787,714,668,1,1,4.90E-05,883993,0.997059553
33793,609,124,1,1,4.90E-05,883994,0.997060681
33795,498,290,1,1,4.90E-05,883995,0.997061809
33797,269,294,1,1,4.90E-05,883996,0.997062937
30492,371,609,1,1,4.90E-05,883997,0.997064065
30491,261,23,1,1,4.90E-05,883998,0.997065193
33800,576,204,1,1,4.90E-05,883999,0.997066321
30487,571,532,1,1,4.90E-05,884000,0.997067449
33803,11,178,1,1,4.90E-05,884001,0.997068577
30512,613,552,1,1,4.90E-05,884002,0.997069704
30516,646,137,1,1,4.90E-05,884003,0.997070832
30519,5,571,1,1,4.90E-05,884004,0.99707196
30520,5,364,1,1,4.90E-05,884005,0.997073088
30539,195,280,1,1,4.90E-05,884006,0.997074216
33748,379,668,1,1,4.90E-05,884007,0.997075344
30537,493,683,1,1,4.90E-05,884008,0.997076472
33754,167,12,1,1,4.90E-05,884009,0.9970776
33762,614,371,1,1,4.90E-05,884010,0.997078728
30536,23,674,1,1,4.90E-05,884011,0.997079856
33763,593,90,1,1,4.90E-05,884012,0.997080984
30534,202,171,1,1,4.90E-05,884013,0.997082111
30531,394,178,1,1,4.90E-05,884014,0.997083239
33764,571,443,1,1,4.90E-05,884015,0.997084367
33766,342,613,1,1,4.90E-05,884016,0.997085495
30529,103,414,1,1,4.90E-05,884017,0.997086623
33767,224,576,1,1,4.90E-05,884018,0.997087751
30525,701,640,1,1,4.90E-05,884019,0.997088879
33770,646,714,1,1,4.90E-05,884020,0.997090007
30524,525,196,1,1,4.90E-05,884021,0.997091135
33775,16,701,1,1,4.90E-05,884022,0.997092263
30522,371,10,1,1,4.90E-05,884023,0.99709339
33777,85,385,1,1,4.90E-05,884024,0.997094518
33878,682,124,1,1,4.90E-05,884025,0.997095646
30333,586,195,1,1,4.90E-05,884026,0.997096774
30332,723,614,1,1,4.90E-05,884027,0.997097902
30173,699,394,1,1,4.90E-05,884028,0.99709903
34072,494,507,1,1,4.90E-05,884029,0.997100158
34084,544,446,1,1,4.90E-05,884030,0.997101286
30182,64,609,1,1,4.90E-05,884031,0.997102414
34085,718,126,1,1,4.90E-05,884032,0.997103542
34086,138,446,1,1,4.90E-05,884033,0.99710467
34088,714,126,1,1,4.90E-05,884034,0.997105797
30181,261,2,1,1,4.90E-05,884035,0.997106925
34089,683,543,1,1,4.90E-05,884036,0.997108053
30174,714,302,1,1,4.90E-05,884037,0.997109181
30171,568,10,1,1,4.90E-05,884038,0.997110309
34127,571,294,1,1,4.90E-05,884039,0.997111437
34090,371,26,1,1,4.90E-05,884040,0.997112565
30169,614,124,1,1,4.90E-05,884041,0.997113693
34091,587,398,1,1,4.90E-05,884042,0.997114821
30166,560,723,1,1,4.90E-05,884043,0.997115949
34096,511,684,1,1,4.90E-05,884044,0.997117076
30164,560,334,1,1,4.90E-05,884045,0.997118204
30163,719,2,1,1,4.90E-05,884046,0.997119332
34099,138,204,1,1,4.90E-05,884047,0.99712046
34124,529,290,1,1,4.90E-05,884048,0.997121588
34070,23,4,1,1,4.90E-05,884049,0.997122716
30188,646,708,1,1,4.90E-05,884050,0.997123844
34069,560,34,1,1,4.90E-05,884051,0.997124972
34068,682,569,1,1,4.90E-05,884052,0.9971261
34036,652,588,1,1,4.90E-05,884053,0.997127228
34037,652,439,1,1,4.90E-05,884054,0.997128356
34045,342,124,1,1,4.90E-05,884055,0.997129483
30203,3,684,1,1,4.90E-05,884056,0.997130611
34046,446,164,1,1,4.90E-05,884057,0.997131739
30201,448,156,1,1,4.90E-05,884058,0.997132867
30200,699,181,1,1,4.90E-05,884059,0.997133995
30198,347,593,1,1,4.90E-05,884060,0.997135123
34047,482,5,1,1,4.90E-05,884061,0.997136251
30197,141,517,1,1,4.90E-05,884062,0.997137379
34048,181,121,1,1,4.90E-05,884063,0.997138507
30192,714,398,1,1,4.90E-05,884064,0.997139635
30190,5,482,1,1,4.90E-05,884065,0.997140762
34052,124,328,1,1,4.90E-05,884066,0.99714189
34053,175,646,1,1,4.90E-05,884067,0.997143018
34054,543,319,1,1,4.90E-05,884068,0.997144146
34057,385,294,1,1,4.90E-05,884069,0.997145274
30189,64,701,1,1,4.90E-05,884070,0.997146402
34064,332,29,1,1,4.90E-05,884071,0.99714753
34125,493,511,1,1,4.90E-05,884072,0.997148658
34128,718,508,1,1,4.90E-05,884073,0.997149786
30331,90,593,1,1,4.90E-05,884074,0.997150914
34184,714,22,1,1,4.90E-05,884075,0.997152042
30133,721,126,1,1,4.90E-05,884076,0.997153169
30132,613,655,1,1,4.90E-05,884077,0.997154297
30130,138,31,1,1,4.90E-05,884078,0.997155425
34173,141,64,1,1,4.90E-05,884079,0.997156553
34175,525,181,1,1,4.90E-05,884080,0.997157681
34176,475,494,1,1,4.90E-05,884081,0.997158809
30123,613,544,1,1,4.90E-05,884082,0.997159937
34177,85,242,1,1,4.90E-05,884083,0.997161065
34180,353,43,1,1,4.90E-05,884084,0.997162193
34185,517,342,1,1,4.90E-05,884085,0.997163321
30156,443,342,1,1,4.90E-05,884086,0.997164448
30114,674,409,1,1,4.90E-05,884087,0.997165576
34186,596,257,1,1,4.90E-05,884088,0.997166704
34189,529,492,1,1,4.90E-05,884089,0.997167832
34190,409,137,1,1,4.90E-05,884090,0.99716896
34192,511,448,1,1,4.90E-05,884091,0.997170088
34195,701,393,1,1,4.90E-05,884092,0.997171216
34196,446,684,1,1,4.90E-05,884093,0.997172344
34197,409,269,1,1,4.90E-05,884094,0.997173472
30112,364,20,1,1,4.90E-05,884095,0.9971746
34171,126,97,1,1,4.90E-05,884096,0.997175727
34170,568,167,1,1,4.90E-05,884097,0.997176855
34169,170,394,1,1,4.90E-05,884098,0.997177983
34167,618,719,1,1,4.90E-05,884099,0.997179111
30155,295,494,1,1,4.90E-05,884100,0.997180239
34129,503,54,1,1,4.90E-05,884101,0.997181367
30154,708,371,1,1,4.90E-05,884102,0.997182495
34130,446,34,1,1,4.90E-05,884103,0.997183623
34131,714,31,1,1,4.90E-05,884104,0.997184751
30152,175,50,1,1,4.90E-05,884105,0.997185879
30148,646,427,1,1,4.90E-05,884106,0.997187007
34134,314,718,1,1,4.90E-05,884107,0.997188134
34151,342,250,1,1,4.90E-05,884108,0.997189262
34153,348,371,1,1,4.90E-05,884109,0.99719039
34154,54,25,1,1,4.90E-05,884110,0.997191518
30139,493,482,1,1,4.90E-05,884111,0.997192646
34155,626,121,1,1,4.90E-05,884112,0.997193774
34156,571,30,1,1,4.90E-05,884113,0.997194902
34157,404,195,1,1,4.90E-05,884114,0.99719603
34159,587,689,1,1,4.90E-05,884115,0.997197158
34160,138,126,1,1,4.90E-05,884116,0.997198286
30137,503,15,1,1,4.90E-05,884117,0.997199413
34162,552,181,1,1,4.90E-05,884118,0.997200541
30206,30,626,1,1,4.90E-05,884119,0.997201669
30209,196,23,1,1,4.90E-05,884120,0.997202797
30210,131,668,1,1,4.90E-05,884121,0.997203925
30290,568,126,1,1,4.90E-05,884122,0.997205053
33936,207,170,1,1,4.90E-05,884123,0.997206181
30304,392,475,1,1,4.90E-05,884124,0.997207309
33937,571,5,1,1,4.90E-05,884125,0.997208437
30300,114,124,1,1,4.90E-05,884126,0.997209565
30299,264,14,1,1,4.90E-05,884127,0.997210693
30297,543,626,1,1,4.90E-05,884128,0.99721182
30296,392,364,1,1,4.90E-05,884129,0.997212948
33942,26,178,1,1,4.90E-05,884130,0.997214076
30294,494,34,1,1,4.90E-05,884131,0.997215204
33945,269,552,1,1,4.90E-05,884132,0.997216332
34034,682,446,1,1,4.90E-05,884133,0.99721746
33947,19,207,1,1,4.90E-05,884134,0.997218588
30289,170,353,1,1,4.90E-05,884135,0.997219716
33949,683,167,1,1,4.90E-05,884136,0.997220844
30287,181,475,1,1,4.90E-05,884137,0.997221972
30286,342,64,1,1,4.90E-05,884138,0.997223099
33959,22,124,1,1,4.90E-05,884139,0.997224227
30282,433,77,1,1,4.90E-05,884140,0.997225355
30281,107,433,1,1,4.90E-05,884141,0.997226483
33967,181,77,1,1,4.90E-05,884142,0.997227611
30305,332,163,1,1,4.90E-05,884143,0.997228739
30308,571,97,1,1,4.90E-05,884144,0.997229867
30310,482,552,1,1,4.90E-05,884145,0.997230995
30313,393,701,1,1,4.90E-05,884146,0.997232123
33888,689,137,1,1,4.90E-05,884147,0.997233251
30330,5,124,1,1,4.90E-05,884148,0.997234379
33889,427,12,1,1,4.90E-05,884149,0.997235506
33902,335,699,1,1,4.90E-05,884150,0.997236634
30329,535,492,1,1,4.90E-05,884151,0.997237762
30328,397,90,1,1,4.90E-05,884152,0.99723889
30326,482,64,1,1,4.90E-05,884153,0.997240018
30323,265,448,1,1,4.90E-05,884154,0.997241146
30321,562,294,1,1,4.90E-05,884155,0.997242274
30319,137,269,1,1,4.90E-05,884156,0.997243402
30317,699,265,1,1,4.90E-05,884157,0.99724453
33914,207,332,1,1,4.90E-05,884158,0.997245658
33917,2,576,1,1,4.90E-05,884159,0.997246785
30316,364,652,1,1,4.90E-05,884160,0.997247913
33918,90,532,1,1,4.90E-05,884161,0.997249041
30315,463,269,1,1,4.90E-05,884162,0.997250169
33920,348,717,1,1,4.90E-05,884163,0.997251297
30314,9,721,1,1,4.90E-05,884164,0.997252425
33930,10,371,1,1,4.90E-05,884165,0.997253553
30278,156,605,1,1,4.90E-05,884166,0.997254681
30277,414,19,1,1,4.90E-05,884167,0.997255809
30272,701,236,1,1,4.90E-05,884168,0.997256937
33997,85,2,1,1,4.90E-05,884169,0.997258065
30240,367,124,1,1,4.90E-05,884170,0.997259192
34004,261,85,1,1,4.90E-05,884171,0.99726032
30239,64,439,1,1,4.90E-05,884172,0.997261448
34014,448,571,1,1,4.90E-05,884173,0.997262576
30237,568,353,1,1,4.90E-05,884174,0.997263704
30236,85,314,1,1,4.90E-05,884175,0.997264832
34018,433,230,1,1,4.90E-05,884176,0.99726596
30234,507,646,1,1,4.90E-05,884177,0.997267088
30230,274,624,1,1,4.90E-05,884178,0.997268216
30229,482,155,1,1,4.90E-05,884179,0.997269344
30227,543,202,1,1,4.90E-05,884180,0.997270471
30226,458,181,1,1,4.90E-05,884181,0.997271599
30224,571,473,1,1,4.90E-05,884182,0.997272727
34023,164,721,1,1,4.90E-05,884183,0.997273855
30223,160,246,1,1,4.90E-05,884184,0.997274983
34025,482,264,1,1,4.90E-05,884185,0.997276111
34030,141,640,1,1,4.90E-05,884186,0.997277239
30218,448,130,1,1,4.90E-05,884187,0.997278367
30216,193,714,1,1,4.90E-05,884188,0.997279495
30241,261,544,1,1,4.90E-05,884189,0.997280623
30245,85,11,1,1,4.90E-05,884190,0.997281751
33968,294,274,1,1,4.90E-05,884191,0.997282878
30246,335,19,1,1,4.90E-05,884192,0.997284006
30269,558,409,1,1,4.90E-05,884193,0.997285134
30268,719,427,1,1,4.90E-05,884194,0.997286262
30267,576,27,1,1,4.90E-05,884195,0.99728739
30264,613,181,1,1,4.90E-05,884196,0.997288518
30258,54,385,1,1,4.90E-05,884197,0.997289646
33972,155,482,1,1,4.90E-05,884198,0.997290774
33973,124,514,1,1,4.90E-05,884199,0.997291902
30257,638,433,1,1,4.90E-05,884200,0.99729303
33974,264,195,1,1,4.90E-05,884201,0.997294157
33975,13,364,1,1,4.90E-05,884202,0.997295285
33976,264,482,1,1,4.90E-05,884203,0.997296413
30254,371,379,1,1,4.90E-05,884204,0.997297541
30252,446,427,1,1,4.90E-05,884205,0.997298669
33977,64,43,1,1,4.90E-05,884206,0.997299797
33982,433,274,1,1,4.90E-05,884207,0.997300925
30251,347,261,1,1,4.90E-05,884208,0.997302053
30249,409,689,1,1,4.90E-05,884209,0.997303181
30248,269,121,1,1,4.90E-05,884210,0.997304309
30247,138,171,1,1,4.90E-05,884211,0.997305436
30628,250,342,1,1,4.90E-05,884212,0.997306564
30629,683,56,1,1,4.90E-05,884213,0.997307692
33675,371,367,1,1,4.90E-05,884214,0.99730882
30995,719,404,1,1,4.90E-05,884215,0.997309948
31008,414,23,1,1,4.90E-05,884216,0.997311076
31007,174,4,1,1,4.90E-05,884217,0.997312204
33468,433,10,1,1,4.90E-05,884218,0.997313332
33469,492,475,1,1,4.90E-05,884219,0.99731446
31001,167,463,1,1,4.90E-05,884220,0.997315588
33470,394,684,1,1,4.90E-05,884221,0.997316716
30999,347,503,1,1,4.90E-05,884222,0.997317843
30998,155,414,1,1,4.90E-05,884223,0.997318971
33476,160,414,1,1,4.90E-05,884224,0.997320099
30994,141,475,1,1,4.90E-05,884225,0.997321227
30980,624,586,1,1,4.90E-05,884226,0.997322355
33477,124,576,1,1,4.90E-05,884227,0.997323483
30991,274,90,1,1,4.90E-05,884228,0.997324611
33480,85,367,1,1,4.90E-05,884229,0.997325739
33481,243,701,1,1,4.90E-05,884230,0.997326867
33482,175,80,1,1,4.90E-05,884231,0.997327995
30987,334,163,1,1,4.90E-05,884232,0.997329122
33483,543,718,1,1,4.90E-05,884233,0.99733025
30986,353,138,1,1,4.90E-05,884234,0.997331378
30983,587,427,1,1,4.90E-05,884235,0.997332506
31009,723,219,1,1,4.90E-05,884236,0.997333634
31011,167,265,1,1,4.90E-05,884237,0.997334762
31012,367,160,1,1,4.90E-05,884238,0.99733589
31013,514,196,1,1,4.90E-05,884239,0.997337018
31038,307,409,1,1,4.90E-05,884240,0.997338146
33412,683,22,1,1,4.90E-05,884241,0.997339274
33413,613,668,1,1,4.90E-05,884242,0.997340402
33416,624,576,1,1,4.90E-05,884243,0.997341529
33422,720,414,1,1,4.90E-05,884244,0.997342657
31031,446,723,1,1,4.90E-05,884245,0.997343785
33426,6,568,1,1,4.90E-05,884246,0.997344913
31030,458,56,1,1,4.90E-05,884247,0.997346041
33436,160,332,1,1,4.90E-05,884248,0.997347169
33439,181,204,1,1,4.90E-05,884249,0.997348297
33441,652,502,1,1,4.90E-05,884250,0.997349425
33443,269,348,1,1,4.90E-05,884251,0.997350553
33451,29,458,1,1,4.90E-05,884252,0.997351681
31027,652,638,1,1,4.90E-05,884253,0.997352808
33452,85,493,1,1,4.90E-05,884254,0.997353936
31022,586,294,1,1,4.90E-05,884255,0.997355064
31015,493,29,1,1,4.90E-05,884256,0.997356192
33453,145,576,1,1,4.90E-05,884257,0.99735732
33464,448,167,1,1,4.90E-05,884258,0.997358448
30982,718,331,1,1,4.90E-05,884259,0.997359576
30976,219,721,1,1,4.90E-05,884260,0.997360704
33519,4,124,1,1,4.90E-05,884261,0.997361832
30922,663,269,1,1,4.90E-05,884262,0.99736296
30945,126,439,1,1,4.90E-05,884263,0.997364088
30941,463,646,1,1,4.90E-05,884264,0.997365215
30939,265,160,1,1,4.90E-05,884265,0.997366343
33514,124,482,1,1,4.90E-05,884266,0.997367471
30932,193,385,1,1,4.90E-05,884267,0.997368599
30931,5,414,1,1,4.90E-05,884268,0.997369727
30925,3,342,1,1,4.90E-05,884269,0.997370855
30924,1,269,1,1,4.90E-05,884270,0.997371983
30923,54,164,1,1,4.90E-05,884271,0.997373111
33515,105,568,1,1,4.90E-05,884272,0.997374239
33486,397,319,1,1,4.90E-05,884273,0.997375367
33516,613,646,1,1,4.90E-05,884274,0.997376494
30921,560,167,1,1,4.90E-05,884275,0.997377622
30920,502,195,1,1,4.90E-05,884276,0.99737875
30919,310,124,1,1,4.90E-05,884277,0.997379878
33517,178,164,1,1,4.90E-05,884278,0.997381006
30917,535,342,1,1,4.90E-05,884279,0.997382134
30916,15,593,1,1,4.90E-05,884280,0.997383262
30913,242,294,1,1,4.90E-05,884281,0.99738439
30912,250,371,1,1,4.90E-05,884282,0.997385518
30948,26,371,1,1,4.90E-05,884283,0.997386646
33511,397,569,1,1,4.90E-05,884284,0.997387774
33506,503,204,1,1,4.90E-05,884285,0.997388901
30950,195,569,1,1,4.90E-05,884286,0.997390029
33491,535,571,1,1,4.90E-05,884287,0.997391157
33492,683,571,1,1,4.90E-05,884288,0.997392285
30974,294,655,1,1,4.90E-05,884289,0.997393413
30972,397,342,1,1,4.90E-05,884290,0.997394541
33493,552,133,1,1,4.90E-05,884291,0.997395669
30971,181,708,1,1,4.90E-05,884292,0.997396797
30969,439,371,1,1,4.90E-05,884293,0.997397925
30966,353,371,1,1,4.90E-05,884294,0.997399053
30964,175,77,1,1,4.90E-05,884295,0.99740018
33495,494,14,1,1,4.90E-05,884296,0.997401308
30963,439,90,1,1,4.90E-05,884297,0.997402436
30960,175,48,1,1,4.90E-05,884298,0.997403564
33501,446,195,1,1,4.90E-05,884299,0.997404692
30955,50,571,1,1,4.90E-05,884300,0.99740582
33503,571,10,1,1,4.90E-05,884301,0.997406948
30954,178,170,1,1,4.90E-05,884302,0.997408076
33504,167,684,1,1,4.90E-05,884303,0.997409204
30953,64,364,1,1,4.90E-05,884304,0.997410332
30951,207,614,1,1,4.90E-05,884305,0.99741146
33411,508,463,1,1,4.90E-05,884306,0.997412587
33409,626,202,1,1,4.90E-05,884307,0.997413715
33408,568,471,1,1,4.90E-05,884308,0.997414843
33265,85,313,1,1,4.90E-05,884309,0.997415971
33250,64,683,1,1,4.90E-05,884310,0.997417099
33253,626,242,1,1,4.90E-05,884311,0.997418227
31114,170,295,1,1,4.90E-05,884312,0.997419355
33255,497,294,1,1,4.90E-05,884313,0.997420483
33258,156,493,1,1,4.90E-05,884314,0.997421611
33261,328,138,1,1,4.90E-05,884315,0.997422739
33262,528,175,1,1,4.90E-05,884316,0.997423866
31110,494,95,1,1,4.90E-05,884317,0.997424994
33263,202,682,1,1,4.90E-05,884318,0.997426122
31108,5,593,1,1,4.90E-05,884319,0.99742725
31040,443,684,1,1,4.90E-05,884320,0.997428378
31106,126,130,1,1,4.90E-05,884321,0.997429506
31105,588,371,1,1,4.90E-05,884322,0.997430634
33268,114,195,1,1,4.90E-05,884323,0.997431762
31104,458,439,1,1,4.90E-05,884324,0.99743289
31103,494,482,1,1,4.90E-05,884325,0.997434018
31098,503,64,1,1,4.90E-05,884326,0.997435145
33271,141,155,1,1,4.90E-05,884327,0.997436273
31094,393,174,1,1,4.90E-05,884328,0.997437401
31087,31,720,1,1,4.90E-05,884329,0.997438529
33247,703,427,1,1,4.90E-05,884330,0.997439657
33246,31,138,1,1,4.90E-05,884331,0.997440785
31117,25,126,1,1,4.90E-05,884332,0.997441913
31118,195,265,1,1,4.90E-05,884333,0.997443041
33232,342,544,1,1,4.90E-05,884334,0.997444169
31140,126,498,1,1,4.90E-05,884335,0.997445297
33233,720,569,1,1,4.90E-05,884336,0.997446425
33239,562,494,1,1,4.90E-05,884337,0.997447552
31137,501,613,1,1,4.90E-05,884338,0.99744868
31135,126,178,1,1,4.90E-05,884339,0.997449808
31134,137,562,1,1,4.90E-05,884340,0.997450936
31133,663,576,1,1,4.90E-05,884341,0.997452064
31130,2,502,1,1,4.90E-05,884342,0.997453192
31128,640,290,1,1,4.90E-05,884343,0.99745432
33240,652,193,1,1,4.90E-05,884344,0.997455448
31127,392,20,1,1,4.90E-05,884345,0.997456576
31126,718,48,1,1,4.90E-05,884346,0.997457704
31124,560,353,1,1,4.90E-05,884347,0.997458831
33243,596,717,1,1,4.90E-05,884348,0.997459959
31121,174,246,1,1,4.90E-05,884349,0.997461087
33245,605,569,1,1,4.90E-05,884350,0.997462215
31120,596,684,1,1,4.90E-05,884351,0.997463343
31119,160,64,1,1,4.90E-05,884352,0.997464471
33272,43,668,1,1,4.90E-05,884353,0.997465599
33279,458,84,1,1,4.90E-05,884354,0.997466727
31083,593,155,1,1,4.90E-05,884355,0.997467855
31068,269,33,1,1,4.90E-05,884356,0.997468983
31066,479,137,1,1,4.90E-05,884357,0.997470111
31065,596,178,1,1,4.90E-05,884358,0.997471238
33343,90,97,1,1,4.90E-05,884359,0.997472366
33344,64,528,1,1,4.90E-05,884360,0.997473494
33363,250,668,1,1,4.90E-05,884361,0.997474622
31062,364,1,1,1,4.90E-05,884362,0.99747575
33370,626,562,1,1,4.90E-05,884363,0.997476878
31060,29,265,1,1,4.90E-05,884364,0.997478006
33376,230,568,1,1,4.90E-05,884365,0.997479134
31055,243,448,1,1,4.90E-05,884366,0.997480262
33384,90,30,1,1,4.90E-05,884367,0.99748139
31054,632,525,1,1,4.90E-05,884368,0.997482517
31052,155,250,1,1,4.90E-05,884369,0.997483645
33398,178,367,1,1,4.90E-05,884370,0.997484773
31047,141,682,1,1,4.90E-05,884371,0.997485901
33402,463,668,1,1,4.90E-05,884372,0.997487029
31045,141,20,1,1,4.90E-05,884373,0.997488157
33406,178,683,1,1,4.90E-05,884374,0.997489285
33407,708,668,1,1,4.90E-05,884375,0.997490413
31067,265,174,1,1,4.90E-05,884376,0.997491541
31069,181,328,1,1,4.90E-05,884377,0.997492669
33281,175,117,1,1,4.90E-05,884378,0.997493797
31070,175,311,1,1,4.90E-05,884379,0.997494924
33284,568,48,1,1,4.90E-05,884380,0.997496052
33290,492,155,1,1,4.90E-05,884381,0.99749718
33292,48,492,1,1,4.90E-05,884382,0.997498308
31079,385,319,1,1,4.90E-05,884383,0.997499436
31078,529,195,1,1,4.90E-05,884384,0.997500564
31075,404,103,1,1,4.90E-05,884385,0.997501692
33296,618,525,1,1,4.90E-05,884386,0.99750282
33298,103,1,1,1,4.90E-05,884387,0.997503948
33299,264,684,1,1,4.90E-05,884388,0.997505076
33302,569,331,1,1,4.90E-05,884389,0.997506203
33311,714,160,1,1,4.90E-05,884390,0.997507331
33312,56,175,1,1,4.90E-05,884391,0.997508459
31074,50,290,1,1,4.90E-05,884392,0.997509587
33330,334,682,1,1,4.90E-05,884393,0.997510715
31073,156,593,1,1,4.90E-05,884394,0.997511843
31072,207,155,1,1,4.90E-05,884395,0.997512971
33332,543,19,1,1,4.90E-05,884396,0.997514099
33336,723,242,1,1,4.90E-05,884397,0.997515227
31071,353,202,1,1,4.90E-05,884398,0.997516355
33518,90,514,1,1,4.90E-05,884399,0.997517483
33520,571,673,1,1,4.90E-05,884400,0.99751861
30637,502,494,1,1,4.90E-05,884401,0.997519738
30720,498,181,1,1,4.90E-05,884402,0.997520866
33609,170,328,1,1,4.90E-05,884403,0.997521994
30742,493,517,1,1,4.90E-05,884404,0.997523122
33610,501,103,1,1,4.90E-05,884405,0.99752425
30741,439,155,1,1,4.90E-05,884406,0.997525378
30729,508,236,1,1,4.90E-05,884407,0.997526506
30727,175,156,1,1,4.90E-05,884408,0.997527634
30722,155,160,1,1,4.90E-05,884409,0.997528762
30721,126,114,1,1,4.90E-05,884410,0.997529889
33611,568,427,1,1,4.90E-05,884411,0.997531017
30716,689,433,1,1,4.90E-05,884412,0.997532145
30704,701,11,1,1,4.90E-05,884413,0.997533273
30715,392,130,1,1,4.90E-05,884414,0.997534401
33614,5,269,1,1,4.90E-05,884415,0.997535529
30714,609,371,1,1,4.90E-05,884416,0.997536657
33622,392,613,1,1,4.90E-05,884417,0.997537785
33623,586,175,1,1,4.90E-05,884418,0.997538913
30711,571,498,1,1,4.90E-05,884419,0.997540041
30709,618,714,1,1,4.90E-05,884420,0.997541169
30706,568,310,1,1,4.90E-05,884421,0.997542296
33625,257,170,1,1,4.90E-05,884422,0.997543424
30744,433,27,1,1,4.90E-05,884423,0.997544552
30745,29,414,1,1,4.90E-05,884424,0.99754568
30747,126,294,1,1,4.90E-05,884425,0.997546808
30748,701,117,1,1,4.90E-05,884426,0.997547936
30763,90,663,1,1,4.90E-05,884427,0.997549064
33591,529,448,1,1,4.90E-05,884428,0.997550192
33592,626,170,1,1,4.90E-05,884429,0.99755132
30761,202,394,1,1,4.90E-05,884430,0.997552448
33593,503,261,1,1,4.90E-05,884431,0.997553575
30760,163,140,1,1,4.90E-05,884432,0.997554703
33594,15,613,1,1,4.90E-05,884433,0.997555831
30758,503,196,1,1,4.90E-05,884434,0.997556959
30756,6,160,1,1,4.90E-05,884435,0.997558087
33595,4,207,1,1,4.90E-05,884436,0.997559215
30755,443,576,1,1,4.90E-05,884437,0.997560343
30754,2,383,1,1,4.90E-05,884438,0.997561471
33596,720,103,1,1,4.90E-05,884439,0.997562599
30752,497,138,1,1,4.90E-05,884440,0.997563727
33597,290,193,1,1,4.90E-05,884441,0.997564855
30750,11,181,1,1,4.90E-05,884442,0.997565982
33598,721,103,1,1,4.90E-05,884443,0.99756711
33600,290,181,1,1,4.90E-05,884444,0.997568238
33602,568,596,1,1,4.90E-05,884445,0.997569366
30705,613,269,1,1,4.90E-05,884446,0.997570494
33626,313,568,1,1,4.90E-05,884447,0.997571622
33521,383,446,1,1,4.90E-05,884448,0.99757275
30658,264,167,1,1,4.90E-05,884449,0.997573878
30674,332,196,1,1,4.90E-05,884450,0.997575006
30672,493,689,1,1,4.90E-05,884451,0.997576134
33643,626,95,1,1,4.90E-05,884452,0.997577261
33644,638,668,1,1,4.90E-05,884453,0.997578389
30668,618,163,1,1,4.90E-05,884454,0.997579517
33646,23,508,1,1,4.90E-05,884455,0.997580645
30664,342,48,1,1,4.90E-05,884456,0.997581773
30660,246,552,1,1,4.90E-05,884457,0.997582901
33647,85,502,1,1,4.90E-05,884458,0.997584029
30656,517,155,1,1,4.90E-05,884459,0.997585157
30701,409,708,1,1,4.90E-05,884460,0.997586285
33648,257,26,1,1,4.90E-05,884461,0.997587413
33649,103,170,1,1,4.90E-05,884462,0.99758854
30654,155,117,1,1,4.90E-05,884463,0.997589668
33671,646,511,1,1,4.90E-05,884464,0.997590796
33672,85,632,1,1,4.90E-05,884465,0.997591924
33674,171,448,1,1,4.90E-05,884466,0.997593052
30650,126,29,1,1,4.90E-05,884467,0.99759418
30648,613,708,1,1,4.90E-05,884468,0.997595308
30640,126,224,1,1,4.90E-05,884469,0.997596436
30675,242,13,1,1,4.90E-05,884470,0.997597564
30676,471,332,1,1,4.90E-05,884471,0.997598692
30677,178,19,1,1,4.90E-05,884472,0.99759982
30678,511,133,1,1,4.90E-05,884473,0.997600947
30700,525,632,1,1,4.90E-05,884474,0.997602075
30699,614,175,1,1,4.90E-05,884475,0.997603203
33627,23,682,1,1,4.90E-05,884476,0.997604331
33628,562,684,1,1,4.90E-05,884477,0.997605459
33630,103,701,1,1,4.90E-05,884478,0.997606587
30693,720,655,1,1,4.90E-05,884479,0.997607715
30689,64,646,1,1,4.90E-05,884480,0.997608843
30688,269,34,1,1,4.90E-05,884481,0.997609971
33631,193,502,1,1,4.90E-05,884482,0.997611099
33634,164,683,1,1,4.90E-05,884483,0.997612226
30685,511,364,1,1,4.90E-05,884484,0.997613354
33636,246,5,1,1,4.90E-05,884485,0.997614482
30681,9,568,1,1,4.90E-05,884486,0.99761561
30680,529,85,1,1,4.90E-05,884487,0.997616738
30679,130,668,1,1,4.90E-05,884488,0.997617866
33637,334,160,1,1,4.90E-05,884489,0.997618994
33638,718,23,1,1,4.90E-05,884490,0.997620122
33639,181,463,1,1,4.90E-05,884491,0.99762125
33640,446,609,1,1,4.90E-05,884492,0.997622378
33590,409,319,1,1,4.90E-05,884493,0.997623506
30767,290,264,1,1,4.90E-05,884494,0.997624633
30768,160,196,1,1,4.90E-05,884495,0.997625761
30856,414,569,1,1,4.90E-05,884496,0.997626889
33546,535,371,1,1,4.90E-05,884497,0.997628017
30874,558,137,1,1,4.90E-05,884498,0.997629145
33547,708,202,1,1,4.90E-05,884499,0.997630273
33550,689,626,1,1,4.90E-05,884500,0.997631401
30871,632,163,1,1,4.90E-05,884501,0.997632529
30870,156,684,1,1,4.90E-05,884502,0.997633657
30869,243,290,1,1,4.90E-05,884503,0.997634785
30868,170,596,1,1,4.90E-05,884504,0.997635912
30862,701,535,1,1,4.90E-05,884505,0.99763704
30855,397,448,1,1,4.90E-05,884506,0.997638168
30769,90,14,1,1,4.90E-05,884507,0.997639296
30853,294,383,1,1,4.90E-05,884508,0.997640424
33551,569,475,1,1,4.90E-05,884509,0.997641552
33552,609,160,1,1,4.90E-05,884510,0.99764268
30852,269,133,1,1,4.90E-05,884511,0.997643808
30850,207,446,1,1,4.90E-05,884512,0.997644936
33554,721,684,1,1,4.90E-05,884513,0.997646064
30846,718,15,1,1,4.90E-05,884514,0.997647192
33555,160,544,1,1,4.90E-05,884515,0.997648319
30845,14,714,1,1,4.90E-05,884516,0.997649447
30876,196,138,1,1,4.90E-05,884517,0.997650575
33544,367,448,1,1,4.90E-05,884518,0.997651703
30877,27,626,1,1,4.90E-05,884519,0.997652831
30880,560,471,1,1,4.90E-05,884520,0.997653959
30909,64,618,1,1,4.90E-05,884521,0.997655087
30908,714,242,1,1,4.90E-05,884522,0.997656215
33522,85,10,1,1,4.90E-05,884523,0.997657343
30906,294,141,1,1,4.90E-05,884524,0.997658471
33526,133,160,1,1,4.90E-05,884525,0.997659598
30904,64,552,1,1,4.90E-05,884526,0.997660726
33527,178,605,1,1,4.90E-05,884527,0.997661854
30903,596,43,1,1,4.90E-05,884528,0.997662982
30902,23,367,1,1,4.90E-05,884529,0.99766411
30894,371,475,1,1,4.90E-05,884530,0.997665238
30892,170,107,1,1,4.90E-05,884531,0.997666366
30886,124,528,1,1,4.90E-05,884532,0.997667494
30885,708,319,1,1,4.90E-05,884533,0.997668622
33530,64,25,1,1,4.90E-05,884534,0.99766975
30884,97,494,1,1,4.90E-05,884535,0.997670878
33537,335,626,1,1,4.90E-05,884536,0.997672005
30883,383,294,1,1,4.90E-05,884537,0.997673133
33540,433,558,1,1,4.90E-05,884538,0.997674261
33541,334,525,1,1,4.90E-05,884539,0.997675389
30837,25,2,1,1,4.90E-05,884540,0.997676517
30832,532,446,1,1,4.90E-05,884541,0.997677645
33557,433,302,1,1,4.90E-05,884542,0.997678773
33571,85,33,1,1,4.90E-05,884543,0.997679901
30793,31,163,1,1,4.90E-05,884544,0.997681029
30792,3,175,1,1,4.90E-05,884545,0.997682157
30791,661,264,1,1,4.90E-05,884546,0.997683284
33577,31,290,1,1,4.90E-05,884547,0.997684412
33583,397,720,1,1,4.90E-05,884548,0.99768554
30785,236,19,1,1,4.90E-05,884549,0.997686668
33584,54,124,1,1,4.90E-05,884550,0.997687796
30783,439,269,1,1,4.90E-05,884551,0.997688924
30782,560,6,1,1,4.90E-05,884552,0.997690052
33586,640,371,1,1,4.90E-05,884553,0.99769118
30777,494,562,1,1,4.90E-05,884554,0.997692308
30776,699,178,1,1,4.90E-05,884555,0.997693436
30775,195,398,1,1,4.90E-05,884556,0.997694564
30774,294,77,1,1,4.90E-05,884557,0.997695691
33588,626,156,1,1,4.90E-05,884558,0.997696819
30772,175,535,1,1,4.90E-05,884559,0.997697947
33589,193,528,1,1,4.90E-05,884560,0.997699075
30771,170,250,1,1,4.90E-05,884561,0.997700203
30770,195,587,1,1,4.90E-05,884562,0.997701331
33576,250,160,1,1,4.90E-05,884563,0.997702459
30796,164,632,1,1,4.90E-05,884564,0.997703587
33558,90,427,1,1,4.90E-05,884565,0.997704715
30798,124,242,1,1,4.90E-05,884566,0.997705843
33559,626,80,1,1,4.90E-05,884567,0.99770697
33560,230,576,1,1,4.90E-05,884568,0.997708098
30828,714,48,1,1,4.90E-05,884569,0.997709226
30827,138,385,1,1,4.90E-05,884570,0.997710354
30825,544,493,1,1,4.90E-05,884571,0.997711482
33561,380,19,1,1,4.90E-05,884572,0.99771261
33564,121,195,1,1,4.90E-05,884573,0.997713738
33565,587,605,1,1,4.90E-05,884574,0.997714866
30817,493,204,1,1,4.90E-05,884575,0.997715994
30815,23,552,1,1,4.90E-05,884576,0.997717122
33566,246,493,1,1,4.90E-05,884577,0.997718249
30810,632,684,1,1,4.90E-05,884578,0.997719377
30809,121,141,1,1,4.90E-05,884579,0.997720505
33567,19,668,1,1,4.90E-05,884580,0.997721633
30806,117,269,1,1,4.90E-05,884581,0.997722761
30802,703,582,1,1,4.90E-05,884582,0.997723889
30801,20,482,1,1,4.90E-05,884583,0.997725017
33570,497,12,1,1,4.90E-05,884584,0.997726145
30799,586,446,1,1,4.90E-05,884585,0.997727273
28718,23,242,1,1,4.90E-05,884586,0.997728401
28100,195,10,1,1,4.90E-05,884587,0.997729529
22359,560,473,1,1,4.90E-05,884588,0.997730656
26342,525,54,1,1,4.90E-05,884589,0.997731784
26334,699,141,1,1,4.90E-05,884590,0.997732912
13713,638,20,1,1,4.90E-05,884591,0.99773404
22576,720,331,1,1,4.90E-05,884592,0.997735168
26330,26,193,1,1,4.90E-05,884593,0.997736296
26326,261,97,1,1,4.90E-05,884594,0.997737424
26324,593,12,1,1,4.90E-05,884595,0.997738552
22580,30,502,1,1,4.90E-05,884596,0.99773968
18579,29,479,1,1,4.90E-05,884597,0.997740808
26319,448,121,1,1,4.90E-05,884598,0.997741935
26317,502,290,1,1,4.90E-05,884599,0.997743063
22592,43,560,1,1,4.90E-05,884600,0.997744191
26315,114,294,1,1,4.90E-05,884601,0.997745319
26314,195,586,1,1,4.90E-05,884602,0.997746447
26311,717,1,1,1,4.90E-05,884603,0.997747575
26309,618,683,1,1,4.90E-05,884604,0.997748703
22600,609,482,1,1,4.90E-05,884605,0.997749831
26308,514,632,1,1,4.90E-05,884606,0.997750959
26339,295,261,1,1,4.90E-05,884607,0.997752087
26343,219,446,1,1,4.90E-05,884608,0.997753215
26183,80,138,1,1,4.90E-05,884609,0.997754342
26347,20,433,1,1,4.90E-05,884610,0.99775547
26381,684,507,1,1,4.90E-05,884611,0.997756598
22511,207,77,1,1,4.90E-05,884612,0.997757726
18613,493,313,1,1,4.90E-05,884613,0.997758854
22529,394,383,1,1,4.90E-05,884614,0.997759982
22533,25,64,1,1,4.90E-05,884615,0.99776111
26377,33,137,1,1,4.90E-05,884616,0.997762238
26375,624,562,1,1,4.90E-05,884617,0.997763366
22535,699,348,1,1,4.90E-05,884618,0.997764494
22543,274,587,1,1,4.90E-05,884619,0.997765621
22548,701,448,1,1,4.90E-05,884620,0.997766749
26366,29,50,1,1,4.90E-05,884621,0.997767877
22549,34,23,1,1,4.90E-05,884622,0.997769005
26361,458,655,1,1,4.90E-05,884623,0.997770133
22555,383,23,1,1,4.90E-05,884624,0.997771261
22560,673,174,1,1,4.90E-05,884625,0.997772389
26350,19,12,1,1,4.90E-05,884626,0.997773517
26349,640,332,1,1,4.90E-05,884627,0.997774645
26307,246,682,1,1,4.90E-05,884628,0.997775773
26303,353,13,1,1,4.90E-05,884629,0.997776901
26302,503,33,1,1,4.90E-05,884630,0.997778028
26295,717,596,1,1,4.90E-05,884631,0.997779156
22630,593,1,1,1,4.90E-05,884632,0.997780284
26234,427,2,1,1,4.90E-05,884633,0.997781412
22631,576,174,1,1,4.90E-05,884634,0.99778254
26232,9,342,1,1,4.90E-05,884635,0.997783668
13851,4,674,1,1,4.90E-05,884636,0.997784796
26228,269,12,1,1,4.90E-05,884637,0.997785924
22636,618,103,1,1,4.90E-05,884638,0.997787052
26225,482,640,1,1,4.90E-05,884639,0.99778818
26222,493,502,1,1,4.90E-05,884640,0.997789307
26221,367,103,1,1,4.90E-05,884641,0.997790435
18501,392,84,1,1,4.90E-05,884642,0.997791563
26216,250,332,1,1,4.90E-05,884643,0.997792691
26214,508,105,1,1,4.90E-05,884644,0.997793819
26205,31,178,1,1,4.90E-05,884645,0.997794947
26192,364,97,1,1,4.90E-05,884646,0.997796075
26191,246,614,1,1,4.90E-05,884647,0.997797203
26190,609,511,1,1,4.90E-05,884648,0.997798331
22622,458,334,1,1,4.90E-05,884649,0.997799459
22617,718,20,1,1,4.90E-05,884650,0.997800587
22614,719,224,1,1,4.90E-05,884651,0.997801714
26265,701,618,1,1,4.90E-05,884652,0.997802842
26290,117,1,1,1,4.90E-05,884653,0.99780397
26289,443,90,1,1,4.90E-05,884654,0.997805098
26284,708,683,1,1,4.90E-05,884655,0.997806226
26281,511,174,1,1,4.90E-05,884656,0.997807354
26274,12,5,1,1,4.90E-05,884657,0.997808482
26271,427,20,1,1,4.90E-05,884658,0.99780961
26269,202,586,1,1,4.90E-05,884659,0.997810738
26261,720,334,1,1,4.90E-05,884660,0.997811866
26239,84,673,1,1,4.90E-05,884661,0.997812993
26258,264,56,1,1,4.90E-05,884662,0.997814121
26255,163,156,1,1,4.90E-05,884663,0.997815249
22601,552,482,1,1,4.90E-05,884664,0.997816377
26248,525,614,1,1,4.90E-05,884665,0.997817505
26247,140,328,1,1,4.90E-05,884666,0.997818633
26244,439,552,1,1,4.90E-05,884667,0.997819761
26243,242,5,1,1,4.90E-05,884668,0.997820889
22502,29,427,1,1,4.90E-05,884669,0.997822017
18632,1,167,1,1,4.90E-05,884670,0.997823145
26385,414,493,1,1,4.90E-05,884671,0.997824273
22416,640,605,1,1,4.90E-05,884672,0.9978254
22362,174,265,1,1,4.90E-05,884673,0.997826528
26505,511,4,1,1,4.90E-05,884674,0.997827656
18775,708,77,1,1,4.90E-05,884675,0.997828784
26503,242,54,1,1,4.90E-05,884676,0.997829912
26501,269,528,1,1,4.90E-05,884677,0.99783104
26500,613,121,1,1,4.90E-05,884678,0.997832168
26496,13,507,1,1,4.90E-05,884679,0.997833296
18770,624,479,1,1,4.90E-05,884680,0.997834424
26492,294,3,1,1,4.90E-05,884681,0.997835552
26491,54,364,1,1,4.90E-05,884682,0.997836679
26475,124,334,1,1,4.90E-05,884683,0.997837807
22400,663,569,1,1,4.90E-05,884684,0.997838935
18748,517,20,1,1,4.90E-05,884685,0.997840063
22406,605,156,1,1,4.90E-05,884686,0.997841191
26470,195,535,1,1,4.90E-05,884687,0.997842319
26469,535,494,1,1,4.90E-05,884688,0.997843447
26468,175,348,1,1,4.90E-05,884689,0.997844575
26506,721,174,1,1,4.90E-05,884690,0.997845703
26508,560,68,1,1,4.90E-05,884691,0.997846831
26509,718,68,1,1,4.90E-05,884692,0.997847958
26536,348,43,1,1,4.90E-05,884693,0.997849086
26550,718,295,1,1,4.90E-05,884694,0.997850214
26547,721,544,1,1,4.90E-05,884695,0.997851342
26546,163,689,1,1,4.90E-05,884696,0.99785247
26543,364,117,1,1,4.90E-05,884697,0.997853598
26541,164,2,1,1,4.90E-05,884698,0.997854726
26539,30,646,1,1,4.90E-05,884699,0.997855854
26538,552,12,1,1,4.90E-05,884700,0.997856982
26533,20,661,1,1,4.90E-05,884701,0.99785811
26511,50,383,1,1,4.90E-05,884702,0.997859238
26530,50,714,1,1,4.90E-05,884703,0.997860365
26527,624,560,1,1,4.90E-05,884704,0.997861493
26525,334,29,1,1,4.90E-05,884705,0.997862621
26521,588,202,1,1,4.90E-05,884706,0.997863749
26520,560,397,1,1,4.90E-05,884707,0.997864877
26519,525,170,1,1,4.90E-05,884708,0.997866005
26517,174,175,1,1,4.90E-05,884709,0.997867133
18741,618,394,1,1,4.90E-05,884710,0.997868261
26456,219,569,1,1,4.90E-05,884711,0.997869389
26387,638,175,1,1,4.90E-05,884712,0.997870517
26454,156,290,1,1,4.90E-05,884713,0.997871644
22463,138,242,1,1,4.90E-05,884714,0.997872772
26424,107,202,1,1,4.90E-05,884715,0.9978739
22481,302,503,1,1,4.90E-05,884716,0.997875028
22483,638,392,1,1,4.90E-05,884717,0.997876156
18653,32,503,1,1,4.90E-05,884718,0.997877284
22488,117,383,1,1,4.90E-05,884719,0.997878412
26422,141,609,1,1,4.90E-05,884720,0.99787954
26419,414,371,1,1,4.90E-05,884721,0.997880668
26415,12,492,1,1,4.90E-05,884722,0.997881796
26413,652,311,1,1,4.90E-05,884723,0.997882924
26403,497,332,1,1,4.90E-05,884724,0.997884051
26402,310,138,1,1,4.90E-05,884725,0.997885179
18639,15,385,1,1,4.90E-05,884726,0.997886307
22495,175,34,1,1,4.90E-05,884727,0.997887435
26399,257,439,1,1,4.90E-05,884728,0.997888563
22500,23,562,1,1,4.90E-05,884729,0.997889691
26391,398,133,1,1,4.90E-05,884730,0.997890819
22459,385,158,1,1,4.90E-05,884731,0.997891947
26428,492,97,1,1,4.90E-05,884732,0.997893075
26429,618,202,1,1,4.90E-05,884733,0.997894203
26450,107,13,1,1,4.90E-05,884734,0.99789533
18728,307,507,1,1,4.90E-05,884735,0.997896458
22424,380,624,1,1,4.90E-05,884736,0.997897586
18722,207,195,1,1,4.90E-05,884737,0.997898714
26452,482,204,1,1,4.90E-05,884738,0.997899842
22427,25,196,1,1,4.90E-05,884739,0.99790097
18707,383,97,1,1,4.90E-05,884740,0.997902098
26451,29,54,1,1,4.90E-05,884741,0.997903226
26448,68,90,1,1,4.90E-05,884742,0.997904354
26432,158,652,1,1,4.90E-05,884743,0.997905482
26447,33,43,1,1,4.90E-05,884744,0.99790661
22442,257,353,1,1,4.90E-05,884745,0.997907737
26443,543,195,1,1,4.90E-05,884746,0.997908865
26440,307,448,1,1,4.90E-05,884747,0.997909993
26438,720,84,1,1,4.90E-05,884748,0.997911121
18695,193,562,1,1,4.90E-05,884749,0.997912249
22450,265,4,1,1,4.90E-05,884750,0.997913377
26187,409,404,1,1,4.90E-05,884751,0.997914505
22640,525,398,1,1,4.90E-05,884752,0.997915633
26553,158,12,1,1,4.90E-05,884753,0.997916761
25934,246,640,1,1,4.90E-05,884754,0.997917889
25925,156,294,1,1,4.90E-05,884755,0.997919016
25924,196,507,1,1,4.90E-05,884756,0.997920144
25923,133,646,1,1,4.90E-05,884757,0.997921272
25921,613,294,1,1,4.90E-05,884758,0.9979224
25920,632,646,1,1,4.90E-05,884759,0.997923528
25914,721,543,1,1,4.90E-05,884760,0.997924656
25912,29,164,1,1,4.90E-05,884761,0.997925784
25907,507,383,1,1,4.90E-05,884762,0.997926912
25900,493,54,1,1,4.90E-05,884763,0.99792804
25891,170,463,1,1,4.90E-05,884764,0.997929168
22783,167,668,1,1,4.90E-05,884765,0.997930296
25888,568,33,1,1,4.90E-05,884766,0.997931423
22784,202,196,1,1,4.90E-05,884767,0.997932551
25885,19,394,1,1,4.90E-05,884768,0.997933679
14561,673,683,1,1,4.90E-05,884769,0.997934807
25882,473,178,1,1,4.90E-05,884770,0.997935935
25879,137,609,1,1,4.90E-05,884771,0.997937063
25932,133,383,1,1,4.90E-05,884772,0.997938191
25939,332,15,1,1,4.90E-05,884773,0.997939319
22642,133,121,1,1,4.90E-05,884774,0.997940447
18332,385,85,1,1,4.90E-05,884775,0.997941575
25983,246,6,1,1,4.90E-05,884776,0.997942702
25982,718,348,1,1,4.90E-05,884777,0.99794383
25980,307,624,1,1,4.90E-05,884778,0.997944958
18351,529,427,1,1,4.90E-05,884779,0.997946086
25979,236,290,1,1,4.90E-05,884780,0.997947214
22761,614,319,1,1,4.90E-05,884781,0.997948342
25972,682,503,1,1,4.90E-05,884782,0.99794947
25964,383,503,1,1,4.90E-05,884783,0.997950598
25959,661,295,1,1,4.90E-05,884784,0.997951726
25957,525,655,1,1,4.90E-05,884785,0.997952854
18340,640,587,1,1,4.90E-05,884786,0.997953982
14419,196,121,1,1,4.90E-05,884787,0.997955109
14446,673,511,1,1,4.90E-05,884788,0.997956237
22772,497,508,1,1,4.90E-05,884789,0.997957365
25947,448,290,1,1,4.90E-05,884790,0.997958493
22777,448,723,1,1,4.90E-05,884791,0.997959621
25940,131,492,1,1,4.90E-05,884792,0.997960749
25878,613,167,1,1,4.90E-05,884793,0.997961877
25874,50,193,1,1,4.90E-05,884794,0.997963005
22793,141,280,1,1,4.90E-05,884795,0.997964133
22796,302,668,1,1,4.90E-05,884796,0.997965261
25838,204,414,1,1,4.90E-05,884797,0.997966388
25837,137,498,1,1,4.90E-05,884798,0.997967516
25836,26,175,1,1,4.90E-05,884799,0.997968644
25834,294,156,1,1,4.90E-05,884800,0.997969772
22846,160,32,1,1,4.90E-05,884801,0.9979709
22852,310,202,1,1,4.90E-05,884802,0.997972028
22861,552,1,1,1,4.90E-05,884803,0.997973156
22863,140,638,1,1,4.90E-05,884804,0.997974284
25830,605,133,1,1,4.90E-05,884805,0.997975412
22869,614,661,1,1,4.90E-05,884806,0.99797654
25828,311,525,1,1,4.90E-05,884807,0.997977667
25827,494,114,1,1,4.90E-05,884808,0.997978795
25826,689,482,1,1,4.90E-05,884809,0.997979923
25813,19,560,1,1,4.90E-05,884810,0.997981051
22874,720,48,1,1,4.90E-05,884811,0.997982179
25812,160,3,1,1,4.90E-05,884812,0.997983307
22881,409,141,1,1,4.90E-05,884813,0.997984435
25843,624,19,1,1,4.90E-05,884814,0.997985563
25844,12,126,1,1,4.90E-05,884815,0.997986691
22837,107,138,1,1,4.90E-05,884816,0.997987819
22805,525,497,1,1,4.90E-05,884817,0.997988947
25872,103,307,1,1,4.90E-05,884818,0.997990074
25871,97,4,1,1,4.90E-05,884819,0.997991202
22797,193,393,1,1,4.90E-05,884820,0.99799233
22798,427,683,1,1,4.90E-05,884821,0.997993458
25868,689,140,1,1,4.90E-05,884822,0.997994586
25865,163,682,1,1,4.90E-05,884823,0.997995714
25864,15,178,1,1,4.90E-05,884824,0.997996842
22816,646,535,1,1,4.90E-05,884825,0.99799797
22829,193,11,1,1,4.90E-05,884826,0.997999098
25858,364,475,1,1,4.90E-05,884827,0.998000226
25856,528,605,1,1,4.90E-05,884828,0.998001353
25850,385,508,1,1,4.90E-05,884829,0.998002481
22818,261,674,1,1,4.90E-05,884830,0.998003609
22819,385,23,1,1,4.90E-05,884831,0.998004737
18284,138,219,1,1,4.90E-05,884832,0.998005865
25848,398,174,1,1,4.90E-05,884833,0.998006993
25986,719,501,1,1,4.90E-05,884834,0.998008121
25988,543,673,1,1,4.90E-05,884835,0.998009249
25993,25,661,1,1,4.90E-05,884836,0.998010377
26105,588,525,1,1,4.90E-05,884837,0.998011505
26141,141,25,1,1,4.90E-05,884838,0.998012633
26140,10,684,1,1,4.90E-05,884839,0.99801376
26138,588,684,1,1,4.90E-05,884840,0.998014888
22659,133,117,1,1,4.90E-05,884841,0.998016016
18476,265,3,1,1,4.90E-05,884842,0.998017144
22668,394,613,1,1,4.90E-05,884843,0.998018272
22676,684,397,1,1,4.90E-05,884844,0.9980194
26129,528,560,1,1,4.90E-05,884845,0.998020528
26125,23,264,1,1,4.90E-05,884846,0.998021656
26124,517,328,1,1,4.90E-05,884847,0.998022784
26123,1,164,1,1,4.90E-05,884848,0.998023912
26120,673,43,1,1,4.90E-05,884849,0.998025039
26119,655,54,1,1,4.90E-05,884850,0.998026167
26118,334,170,1,1,4.90E-05,884851,0.998027295
18446,701,313,1,1,4.90E-05,884852,0.998028423
18444,138,123,1,1,4.90E-05,884853,0.998029551
26113,141,274,1,1,4.90E-05,884854,0.998030679
22657,507,250,1,1,4.90E-05,884855,0.998031807
22653,43,264,1,1,4.90E-05,884856,0.998032935
26147,170,114,1,1,4.90E-05,884857,0.998034063
13982,494,80,1,1,4.90E-05,884858,0.998035191
26182,64,26,1,1,4.90E-05,884859,0.998036319
18497,618,689,1,1,4.90E-05,884860,0.998037446
22644,16,133,1,1,4.90E-05,884861,0.998038574
26180,103,130,1,1,4.90E-05,884862,0.998039702
22646,596,103,1,1,4.90E-05,884863,0.99804083
26178,397,525,1,1,4.90E-05,884864,0.998041958
26171,661,498,1,1,4.90E-05,884865,0.998043086
26168,158,294,1,1,4.90E-05,884866,0.998044214
26150,12,174,1,1,4.90E-05,884867,0.998045342
26166,475,448,1,1,4.90E-05,884868,0.99804647
26162,502,160,1,1,4.90E-05,884869,0.998047598
26161,720,508,1,1,4.90E-05,884870,0.998048725
26159,528,167,1,1,4.90E-05,884871,0.998049853
22650,332,264,1,1,4.90E-05,884872,0.998050981
26152,12,43,1,1,4.90E-05,884873,0.998052109
26151,12,1,1,1,4.90E-05,884874,0.998053237
26109,720,30,1,1,4.90E-05,884875,0.998054365
22695,719,48,1,1,4.90E-05,884876,0.998055493
26001,95,246,1,1,4.90E-05,884877,0.998056621
26100,331,202,1,1,4.90E-05,884878,0.998057749
26033,683,501,1,1,4.90E-05,884879,0.998058877
26028,552,605,1,1,4.90E-05,884880,0.998060005
22727,482,31,1,1,4.90E-05,884881,0.998061132
22730,140,33,1,1,4.90E-05,884882,0.99806226
26026,723,335,1,1,4.90E-05,884883,0.998063388
22731,140,383,1,1,4.90E-05,884884,0.998064516
22733,689,392,1,1,4.90E-05,884885,0.998065644
18375,394,714,1,1,4.90E-05,884886,0.998066772
22737,511,3,1,1,4.90E-05,884887,0.9980679
22747,508,204,1,1,4.90E-05,884888,0.998069028
22749,31,446,1,1,4.90E-05,884889,0.998070156
26019,160,130,1,1,4.90E-05,884890,0.998071284
22751,160,311,1,1,4.90E-05,884891,0.998072411
26015,394,618,1,1,4.90E-05,884892,0.998073539
26008,294,29,1,1,4.90E-05,884893,0.998074667
26007,458,463,1,1,4.90E-05,884894,0.998075795
26003,632,673,1,1,4.90E-05,884895,0.998076923
22725,4,652,1,1,4.90E-05,884896,0.998078051
26035,261,632,1,1,4.90E-05,884897,0.998079179
26037,163,34,1,1,4.90E-05,884898,0.998080307
26073,723,638,1,1,4.90E-05,884899,0.998081435
26099,668,661,1,1,4.90E-05,884900,0.998082563
22697,493,295,1,1,4.90E-05,884901,0.998083691
26092,624,507,1,1,4.90E-05,884902,0.998084818
14036,246,3,1,1,4.90E-05,884903,0.998085946
18419,682,85,1,1,4.90E-05,884904,0.998087074
18402,682,307,1,1,4.90E-05,884905,0.998088202
26074,246,295,1,1,4.90E-05,884906,0.99808933
26065,331,684,1,1,4.90E-05,884907,0.998090458
26040,160,302,1,1,4.90E-05,884908,0.998091586
26060,683,479,1,1,4.90E-05,884909,0.998092714
26053,126,174,1,1,4.90E-05,884910,0.998093842
18395,26,684,1,1,4.90E-05,884911,0.99809497
26045,178,280,1,1,4.90E-05,884912,0.998096097
26044,528,170,1,1,4.90E-05,884913,0.998097225
26043,458,22,1,1,4.90E-05,884914,0.998098353
26042,16,13,1,1,4.90E-05,884915,0.998099481
26552,332,145,1,1,4.90E-05,884916,0.998100609
22347,683,156,1,1,4.90E-05,884917,0.998101737
27290,446,640,1,1,4.90E-05,884918,0.998102865
27036,29,236,1,1,4.90E-05,884919,0.998103993
27032,126,367,1,1,4.90E-05,884920,0.998105121
27029,97,714,1,1,4.90E-05,884921,0.998106249
27028,261,646,1,1,4.90E-05,884922,0.998107376
27023,511,56,1,1,4.90E-05,884923,0.998108504
27019,708,502,1,1,4.90E-05,884924,0.998109632
19315,511,587,1,1,4.90E-05,884925,0.99811076
27018,140,56,1,1,4.90E-05,884926,0.998111888
21932,264,15,1,1,4.90E-05,884927,0.998113016
27017,661,158,1,1,4.90E-05,884928,0.998114144
19313,719,3,1,1,4.90E-05,884929,0.998115272
21941,178,522,1,1,4.90E-05,884930,0.9981164
21946,638,569,1,1,4.90E-05,884931,0.998117528
21957,2,501,1,1,4.90E-05,884932,0.998118656
27002,328,13,1,1,4.90E-05,884933,0.998119783
21958,482,84,1,1,4.90E-05,884934,0.998120911
26997,64,689,1,1,4.90E-05,884935,0.998122039
26994,43,156,1,1,4.90E-05,884936,0.998123167
27034,90,50,1,1,4.90E-05,884937,0.998124295
27039,246,479,1,1,4.90E-05,884938,0.998125423
26895,501,133,1,1,4.90E-05,884939,0.998126551
27040,123,124,1,1,4.90E-05,884940,0.998127679
21902,23,397,1,1,4.90E-05,884941,0.998128807
21906,30,181,1,1,4.90E-05,884942,0.998129935
21908,586,632,1,1,4.90E-05,884943,0.998131062
27072,385,493,1,1,4.90E-05,884944,0.99813219
27071,178,335,1,1,4.90E-05,884945,0.998133318
21911,479,12,1,1,4.90E-05,884946,0.998134446
27070,331,571,1,1,4.90E-05,884947,0.998135574
27069,126,335,1,1,4.90E-05,884948,0.998136702
27066,5,171,1,1,4.90E-05,884949,0.99813783
27061,3,319,1,1,4.90E-05,884950,0.998138958
19319,246,123,1,1,4.90E-05,884951,0.998140086
27059,16,43,1,1,4.90E-05,884952,0.998141214
27054,138,562,1,1,4.90E-05,884953,0.998142342
27049,701,522,1,1,4.90E-05,884954,0.998143469
21919,332,335,1,1,4.90E-05,884955,0.998144597
27043,383,34,1,1,4.90E-05,884956,0.998145725
21926,174,586,1,1,4.90E-05,884957,0.998146853
21959,160,558,1,1,4.90E-05,884958,0.998147981
19291,701,9,1,1,4.90E-05,884959,0.998149109
26991,5,562,1,1,4.90E-05,884960,0.998150237
26988,718,123,1,1,4.90E-05,884961,0.998151365
26930,493,265,1,1,4.90E-05,884962,0.998152493
26929,138,307,1,1,4.90E-05,884963,0.998153621
26928,528,587,1,1,4.90E-05,884964,0.998154748
26925,427,673,1,1,4.90E-05,884965,0.998155876
26924,307,502,1,1,4.90E-05,884966,0.998157004
22001,4,170,1,1,4.90E-05,884967,0.998158132
22006,19,80,1,1,4.90E-05,884968,0.99815926
26918,265,140,1,1,4.90E-05,884969,0.998160388
19222,236,613,1,1,4.90E-05,884970,0.998161516
26912,508,68,1,1,4.90E-05,884971,0.998162644
26909,404,85,1,1,4.90E-05,884972,0.998163772
26906,138,95,1,1,4.90E-05,884973,0.9981649
26905,507,482,1,1,4.90E-05,884974,0.998166028
26904,684,265,1,1,4.90E-05,884975,0.998167155
22028,719,311,1,1,4.90E-05,884976,0.998168283
26903,684,475,1,1,4.90E-05,884977,0.998169411
19209,90,48,1,1,4.90E-05,884978,0.998170539
26931,20,593,1,1,4.90E-05,884979,0.998171667
26934,543,605,1,1,4.90E-05,884980,0.998172795
26936,543,4,1,1,4.90E-05,884981,0.998173923
26968,511,624,1,1,4.90E-05,884982,0.998175051
26985,15,290,1,1,4.90E-05,884983,0.998176179
21974,50,34,1,1,4.90E-05,884984,0.998177307
19264,568,723,1,1,4.90E-05,884985,0.998178434
26981,494,353,1,1,4.90E-05,884986,0.998179562
26977,193,446,1,1,4.90E-05,884987,0.99818069
26975,684,25,1,1,4.90E-05,884988,0.998181818
21983,334,543,1,1,4.90E-05,884989,0.998182946
26967,26,624,1,1,4.90E-05,884990,0.998184074
26937,689,13,1,1,4.90E-05,884991,0.998185202
26966,347,673,1,1,4.90E-05,884992,0.99818633
26965,398,507,1,1,4.90E-05,884993,0.998187458
21992,689,25,1,1,4.90E-05,884994,0.998188586
26962,246,2,1,1,4.90E-05,884995,0.998189714
26959,522,494,1,1,4.90E-05,884996,0.998190841
26956,264,708,1,1,4.90E-05,884997,0.998191969
26945,528,543,1,1,4.90E-05,884998,0.998193097
27083,383,5,1,1,4.90E-05,884999,0.998194225
19341,624,10,1,1,4.90E-05,885000,0.998195353
27085,124,77,1,1,4.90E-05,885001,0.998196481
21843,393,193,1,1,4.90E-05,885002,0.998197609
27243,683,6,1,1,4.90E-05,885003,0.998198737
27241,511,683,1,1,4.90E-05,885004,0.998199865
27239,123,133,1,1,4.90E-05,885005,0.998200993
27238,64,532,1,1,4.90E-05,885006,0.99820212
27237,250,207,1,1,4.90E-05,885007,0.998203248
27234,479,433,1,1,4.90E-05,885008,0.998204376
27231,243,195,1,1,4.90E-05,885009,0.998205504
27227,458,130,1,1,4.90E-05,885010,0.998206632
27225,126,3,1,1,4.90E-05,885011,0.99820776
21780,12,196,1,1,4.90E-05,885012,0.998208888
27221,497,5,1,1,4.90E-05,885013,0.998210016
27219,243,571,1,1,4.90E-05,885014,0.998211144
21784,497,479,1,1,4.90E-05,885015,0.998212272
27216,264,714,1,1,4.90E-05,885016,0.9982134
19440,494,77,1,1,4.90E-05,885017,0.998214527
19408,383,141,1,1,4.90E-05,885018,0.998215655
21834,414,22,1,1,4.90E-05,885019,0.998216783
27246,682,493,1,1,4.90E-05,885020,0.998217911
27248,170,311,1,1,4.90E-05,885021,0.998219039
27251,107,124,1,1,4.90E-05,885022,0.998220167
27269,471,392,1,1,4.90E-05,885023,0.998221295
27288,294,522,1,1,4.90E-05,885024,0.998222423
27286,280,624,1,1,4.90E-05,885025,0.998223551
27284,160,638,1,1,4.90E-05,885026,0.998224679
21770,364,145,1,1,4.90E-05,885027,0.998225806
27281,181,31,1,1,4.90E-05,885028,0.998226934
27280,178,50,1,1,4.90E-05,885029,0.998228062
27276,508,6,1,1,4.90E-05,885030,0.99822919
27268,668,609,1,1,4.90E-05,885031,0.998230318
27253,19,528,1,1,4.90E-05,885032,0.998231446
27264,517,22,1,1,4.90E-05,885033,0.998232574
27263,178,543,1,1,4.90E-05,885034,0.998233702
27261,160,33,1,1,4.90E-05,885035,0.99823483
27260,614,446,1,1,4.90E-05,885036,0.998235958
27259,503,242,1,1,4.90E-05,885037,0.998237085
27256,661,243,1,1,4.90E-05,885038,0.998238213
27254,1,514,1,1,4.90E-05,885039,0.998239341
27211,385,507,1,1,4.90E-05,885040,0.998240469
19398,26,85,1,1,4.90E-05,885041,0.998241597
27088,13,682,1,1,4.90E-05,885042,0.998242725
27200,458,243,1,1,4.90E-05,885043,0.998243853
21890,334,265,1,1,4.90E-05,885044,0.998244981
27144,493,15,1,1,4.90E-05,885045,0.998246109
27142,714,25,1,1,4.90E-05,885046,0.998247237
27140,175,475,1,1,4.90E-05,885047,0.998248365
27139,443,103,1,1,4.90E-05,885048,0.998249492
27130,683,708,1,1,4.90E-05,885049,0.99825062
27129,646,544,1,1,4.90E-05,885050,0.998251748
27128,10,202,1,1,4.90E-05,885051,0.998252876
27123,328,652,1,1,4.90E-05,885052,0.998254004
27121,236,684,1,1,4.90E-05,885053,0.998255132
27118,458,250,1,1,4.90E-05,885054,0.99825626
27117,4,140,1,1,4.90E-05,885055,0.998257388
27107,332,114,1,1,4.90E-05,885056,0.998258516
27102,718,379,1,1,4.90E-05,885057,0.998259644
27095,458,15,1,1,4.90E-05,885058,0.998260771
27094,196,593,1,1,4.90E-05,885059,0.998261899
27090,717,48,1,1,4.90E-05,885060,0.998263027
27150,458,97,1,1,4.90E-05,885061,0.998264155
21887,97,398,1,1,4.90E-05,885062,0.998265283
27151,167,107,1,1,4.90E-05,885063,0.998266411
27185,404,632,1,1,4.90E-05,885064,0.998267539
19391,138,230,1,1,4.90E-05,885065,0.998268667
21856,682,614,1,1,4.90E-05,885066,0.998269795
27191,294,543,1,1,4.90E-05,885067,0.998270923
19387,409,85,1,1,4.90E-05,885068,0.998272051
21867,511,501,1,1,4.90E-05,885069,0.998273178
21868,302,493,1,1,4.90E-05,885070,0.998274306
21870,242,156,1,1,4.90E-05,885071,0.998275434
27183,624,84,1,1,4.90E-05,885072,0.998276562
21878,195,723,1,1,4.90E-05,885073,0.99827769
19365,103,50,1,1,4.90E-05,885074,0.998278818
27179,638,503,1,1,4.90E-05,885075,0.998279946
27175,443,446,1,1,4.90E-05,885076,0.998281074
27162,310,160,1,1,4.90E-05,885077,0.998282202
19364,501,652,1,1,4.90E-05,885078,0.99828333
27157,646,723,1,1,4.90E-05,885079,0.998284457
27154,414,155,1,1,4.90E-05,885080,0.998285585
22032,302,701,1,1,4.90E-05,885081,0.998286713
26894,596,290,1,1,4.90E-05,885082,0.998287841
26557,138,22,1,1,4.90E-05,885083,0.998288969
26695,723,20,1,1,4.90E-05,885084,0.998290097
22236,471,503,1,1,4.90E-05,885085,0.998291225
26691,379,319,1,1,4.90E-05,885086,0.998292353
26690,3,701,1,1,4.90E-05,885087,0.998293481
26688,717,50,1,1,4.90E-05,885088,0.998294609
22237,392,414,1,1,4.90E-05,885089,0.998295737
22238,609,493,1,1,4.90E-05,885090,0.998296864
26682,503,22,1,1,4.90E-05,885091,0.998297992
26680,507,174,1,1,4.90E-05,885092,0.99829912
26677,13,265,1,1,4.90E-05,885093,0.998300248
22249,701,131,1,1,4.90E-05,885094,0.998301376
26676,138,140,1,1,4.90E-05,885095,0.998302504
26667,448,661,1,1,4.90E-05,885096,0.998303632
26665,193,124,1,1,4.90E-05,885097,0.99830476
26664,195,624,1,1,4.90E-05,885098,0.998305888
26661,167,560,1,1,4.90E-05,885099,0.998307016
26652,133,517,1,1,4.90E-05,885100,0.998308143
26650,54,121,1,1,4.90E-05,885101,0.998309271
26693,140,332,1,1,4.90E-05,885102,0.998310399
22221,274,12,1,1,4.90E-05,885103,0.998311527
26892,175,158,1,1,4.90E-05,885104,0.998312655
26700,482,535,1,1,4.90E-05,885105,0.998313783
26727,4,332,1,1,4.90E-05,885106,0.998314911
26726,12,2,1,1,4.90E-05,885107,0.998316039
26725,398,332,1,1,4.90E-05,885108,0.998317167
26723,393,156,1,1,4.90E-05,885109,0.998318295
26722,682,392,1,1,4.90E-05,885110,0.998319423
26721,353,319,1,1,4.90E-05,885111,0.99832055
22200,302,569,1,1,4.90E-05,885112,0.998321678
26720,397,719,1,1,4.90E-05,885113,0.998322806
22201,174,588,1,1,4.90E-05,885114,0.998323934
26719,446,497,1,1,4.90E-05,885115,0.998325062
26718,207,204,1,1,4.90E-05,885116,0.99832619
22204,448,84,1,1,4.90E-05,885117,0.998327318
26716,614,138,1,1,4.90E-05,885118,0.998328446
22211,397,1,1,1,4.90E-05,885119,0.998329574
26715,588,178,1,1,4.90E-05,885120,0.998330702
26710,502,97,1,1,4.90E-05,885121,0.998331829
18941,243,207,1,1,4.90E-05,885122,0.998332957
26649,130,719,1,1,4.90E-05,885123,0.998334085
22255,721,511,1,1,4.90E-05,885124,0.998335213
22263,582,178,1,1,4.90E-05,885125,0.998336341
22265,529,721,1,1,4.90E-05,885126,0.998337469
26594,140,560,1,1,4.90E-05,885127,0.998338597
22301,117,246,1,1,4.90E-05,885128,0.998339725
26590,668,174,1,1,4.90E-05,885129,0.998340853
18827,246,609,1,1,4.90E-05,885130,0.998341981
26589,507,54,1,1,4.90E-05,885131,0.998343109
26588,140,163,1,1,4.90E-05,885132,0.998344236
22327,613,6,1,1,4.90E-05,885133,0.998345364
18807,269,77,1,1,4.90E-05,885134,0.998346492
26587,682,507,1,1,4.90E-05,885135,0.99834762
26583,720,121,1,1,4.90E-05,885136,0.998348748
26580,624,13,1,1,4.90E-05,885137,0.998349876
26577,164,126,1,1,4.90E-05,885138,0.998351004
26570,43,701,1,1,4.90E-05,885139,0.998352132
18792,274,54,1,1,4.90E-05,885140,0.99835326
26563,684,196,1,1,4.90E-05,885141,0.998354388
18786,529,528,1,1,4.90E-05,885142,0.998355515
26561,717,204,1,1,4.90E-05,885143,0.998356643
18837,394,587,1,1,4.90E-05,885144,0.998357771
26596,494,131,1,1,4.90E-05,885145,0.998358899
26597,720,723,1,1,4.90E-05,885146,0.998360027
18847,156,250,1,1,4.90E-05,885147,0.998361155
26643,383,714,1,1,4.90E-05,885148,0.998362283
26637,661,33,1,1,4.90E-05,885149,0.998363411
26636,718,9,1,1,4.90E-05,885150,0.998364539
26631,103,193,1,1,4.90E-05,885151,0.998365667
26628,624,26,1,1,4.90E-05,885152,0.998366794
26627,618,117,1,1,4.90E-05,885153,0.998367922
26626,103,532,1,1,4.90E-05,885154,0.99836905
26618,475,246,1,1,4.90E-05,885155,0.998370178
26600,20,609,1,1,4.90E-05,885156,0.998371306
26616,15,684,1,1,4.90E-05,885157,0.998372434
26612,13,274,1,1,4.90E-05,885158,0.998373562
26610,295,332,1,1,4.90E-05,885159,0.99837469
22287,290,674,1,1,4.90E-05,885160,0.998375818
26605,29,13,1,1,4.90E-05,885161,0.998376946
22289,471,514,1,1,4.90E-05,885162,0.998378074
26602,175,543,1,1,4.90E-05,885163,0.998379201
26728,463,319,1,1,4.90E-05,885164,0.998380329
26729,246,196,1,1,4.90E-05,885165,0.998381457
26730,367,701,1,1,4.90E-05,885166,0.998382585
26833,392,32,1,1,4.90E-05,885167,0.998383713
19150,501,261,1,1,4.90E-05,885168,0.998384841
22062,5,529,1,1,4.90E-05,885169,0.998385969
26853,34,392,1,1,4.90E-05,885170,0.998387097
22083,207,158,1,1,4.90E-05,885171,0.998388225
26851,10,494,1,1,4.90E-05,885172,0.998389353
22088,158,56,1,1,4.90E-05,885173,0.99839048
26848,43,193,1,1,4.90E-05,885174,0.998391608
26847,224,43,1,1,4.90E-05,885175,0.998392736
26846,458,367,1,1,4.90E-05,885176,0.998393864
26845,4,319,1,1,4.90E-05,885177,0.998394992
26844,661,353,1,1,4.90E-05,885178,0.99839612
22102,397,207,1,1,4.90E-05,885179,0.998397248
26843,364,34,1,1,4.90E-05,885180,0.998398376
26841,145,383,1,1,4.90E-05,885181,0.998399504
22108,383,517,1,1,4.90E-05,885182,0.998400632
26839,492,471,1,1,4.90E-05,885183,0.99840176
19076,121,236,1,1,4.90E-05,885184,0.998402887
22059,475,4,1,1,4.90E-05,885185,0.998404015
26859,3,332,1,1,4.90E-05,885186,0.998405143
26861,25,479,1,1,4.90E-05,885187,0.998406271
26875,501,448,1,1,4.90E-05,885188,0.998407399
22035,708,569,1,1,4.90E-05,885189,0.998408527
26887,160,609,1,1,4.90E-05,885190,0.998409655
26884,246,535,1,1,4.90E-05,885191,0.998410783
26883,446,535,1,1,4.90E-05,885192,0.998411911
26882,331,160,1,1,4.90E-05,885193,0.998413039
13034,269,80,1,1,4.90E-05,885194,0.998414166
22036,307,646,1,1,4.90E-05,885195,0.998415294
19184,385,15,1,1,4.90E-05,885196,0.998416422
26862,335,720,1,1,4.90E-05,885197,0.99841755
26868,718,353,1,1,4.90E-05,885198,0.998418678
19173,290,582,1,1,4.90E-05,885199,0.998419806
22056,514,683,1,1,4.90E-05,885200,0.998420934
26867,609,492,1,1,4.90E-05,885201,0.998422062
26866,379,701,1,1,4.90E-05,885202,0.99842319
26865,243,525,1,1,4.90E-05,885203,0.998424318
26863,334,2,1,1,4.90E-05,885204,0.998425446
26834,714,614,1,1,4.90E-05,885205,0.998426573
26832,64,56,1,1,4.90E-05,885206,0.998427701
26731,409,131,1,1,4.90E-05,885207,0.998428829
26830,124,354,1,1,4.90E-05,885208,0.998429957
22165,335,569,1,1,4.90E-05,885209,0.998431085
26786,409,638,1,1,4.90E-05,885210,0.998432213
26784,701,77,1,1,4.90E-05,885211,0.998433341
26783,571,307,1,1,4.90E-05,885212,0.998434469
26778,562,528,1,1,4.90E-05,885213,0.998435597
26777,613,114,1,1,4.90E-05,885214,0.998436725
26773,257,394,1,1,4.90E-05,885215,0.998437852
26769,31,652,1,1,4.90E-05,885216,0.99843898
26766,145,246,1,1,4.90E-05,885217,0.998440108
26759,257,84,1,1,4.90E-05,885218,0.998441236
26758,482,498,1,1,4.90E-05,885219,0.998442364
26753,171,576,1,1,4.90E-05,885220,0.998443492
18968,171,673,1,1,4.90E-05,885221,0.99844462
26743,80,137,1,1,4.90E-05,885222,0.998445748
26741,103,439,1,1,4.90E-05,885223,0.998446876
22191,230,290,1,1,4.90E-05,885224,0.998448004
22192,529,133,1,1,4.90E-05,885225,0.998449132
26788,714,224,1,1,4.90E-05,885226,0.998450259
22164,11,133,1,1,4.90E-05,885227,0.998451387
26790,493,652,1,1,4.90E-05,885228,0.998452515
22122,170,473,1,1,4.90E-05,885229,0.998453643
26824,178,181,1,1,4.90E-05,885230,0.998454771
26822,701,95,1,1,4.90E-05,885231,0.998455899
26819,471,174,1,1,4.90E-05,885232,0.998457027
26818,723,9,1,1,4.90E-05,885233,0.998458155
22118,684,11,1,1,4.90E-05,885234,0.998459283
26813,514,482,1,1,4.90E-05,885235,0.998460411
19061,714,393,1,1,4.90E-05,885236,0.998461538
19031,204,609,1,1,4.90E-05,885237,0.998462666
26792,14,195,1,1,4.90E-05,885238,0.998463794
22142,14,502,1,1,4.90E-05,885239,0.998464922
19024,646,302,1,1,4.90E-05,885240,0.99846605
22146,64,54,1,1,4.90E-05,885241,0.998467178
19018,596,155,1,1,4.90E-05,885242,0.998468306
22155,525,33,1,1,4.90E-05,885243,0.998469434
22160,646,638,1,1,4.90E-05,885244,0.998470562
26793,668,171,1,1,4.90E-05,885245,0.99847169
25809,397,5,1,1,4.90E-05,885246,0.998472818
25807,618,54,1,1,4.90E-05,885247,0.998473945
22899,64,114,1,1,4.90E-05,885248,0.998475073
24718,721,632,1,1,4.90E-05,885249,0.998476201
24717,514,383,1,1,4.90E-05,885250,0.998477329
24709,494,280,1,1,4.90E-05,885251,0.998478457
23676,638,446,1,1,4.90E-05,885252,0.998479585
24704,193,84,1,1,4.90E-05,885253,0.998480713
16076,613,354,1,1,4.90E-05,885254,0.998481841
23679,261,652,1,1,4.90E-05,885255,0.998482969
24694,646,674,1,1,4.90E-05,885256,0.998484097
23684,409,328,1,1,4.90E-05,885257,0.998485224
24693,219,103,1,1,4.90E-05,885258,0.998486352
23685,714,638,1,1,4.90E-05,885259,0.99848748
24692,141,562,1,1,4.90E-05,885260,0.998488608
23687,311,571,1,1,4.90E-05,885261,0.998489736
24686,246,392,1,1,4.90E-05,885262,0.998490864
23690,473,332,1,1,4.90E-05,885263,0.998491992
24679,593,2,1,1,4.90E-05,885264,0.99849312
24660,123,137,1,1,4.90E-05,885265,0.998494248
24658,178,22,1,1,4.90E-05,885266,0.998495376
23674,334,632,1,1,4.90E-05,885267,0.998496503
24720,404,246,1,1,4.90E-05,885268,0.998497631
24522,13,614,1,1,4.90E-05,885269,0.998498759
24721,97,414,1,1,4.90E-05,885270,0.998499887
24768,661,6,1,1,4.90E-05,885271,0.998501015
23645,265,14,1,1,4.90E-05,885272,0.998502143
17373,25,121,1,1,4.90E-05,885273,0.998503271
23649,673,137,1,1,4.90E-05,885274,0.998504399
23650,458,522,1,1,4.90E-05,885275,0.998505527
23654,207,398,1,1,4.90E-05,885276,0.998506655
24760,596,701,1,1,4.90E-05,885277,0.998507783
24757,155,29,1,1,4.90E-05,885278,0.99850891
24748,242,613,1,1,4.90E-05,885279,0.998510038
24746,463,181,1,1,4.90E-05,885280,0.998511166
24745,170,354,1,1,4.90E-05,885281,0.998512294
24744,332,723,1,1,4.90E-05,885282,0.998513422
17304,31,193,1,1,4.90E-05,885283,0.99851455
24735,684,141,1,1,4.90E-05,885284,0.998515678
24731,624,307,1,1,4.90E-05,885285,0.998516806
24726,290,367,1,1,4.90E-05,885286,0.998517934
24724,613,364,1,1,4.90E-05,885287,0.998519062
24653,174,624,1,1,4.90E-05,885288,0.998520189
23701,624,280,1,1,4.90E-05,885289,0.998521317
24652,448,443,1,1,4.90E-05,885290,0.998522445
24650,347,682,1,1,4.90E-05,885291,0.998523573
23740,493,663,1,1,4.90E-05,885292,0.998524701
16203,4,196,1,1,4.90E-05,885293,0.998525829
24573,202,145,1,1,4.90E-05,885294,0.998526957
24569,32,43,1,1,4.90E-05,885295,0.998528085
24568,12,140,1,1,4.90E-05,885296,0.998529213
24560,409,392,1,1,4.90E-05,885297,0.998530341
24559,721,646,1,1,4.90E-05,885298,0.998531469
24556,195,11,1,1,4.90E-05,885299,0.998532596
24552,230,178,1,1,4.90E-05,885300,0.998533724
24547,274,493,1,1,4.90E-05,885301,0.998534852
24544,699,528,1,1,4.90E-05,885302,0.99853598
17249,4,164,1,1,4.90E-05,885303,0.998537108
23747,265,689,1,1,4.90E-05,885304,0.998538236
24541,497,328,1,1,4.90E-05,885305,0.998539364
24538,265,155,1,1,4.90E-05,885306,0.998540492
24537,503,522,1,1,4.90E-05,885307,0.99854162
17238,475,280,1,1,4.90E-05,885308,0.998542748
24581,385,682,1,1,4.90E-05,885309,0.998543875
23720,160,497,1,1,4.90E-05,885310,0.998545003
24590,684,674,1,1,4.90E-05,885311,0.998546131
24636,250,5,1,1,4.90E-05,885312,0.998547259
24649,398,613,1,1,4.90E-05,885313,0.998548387
24648,493,638,1,1,4.90E-05,885314,0.998549515
23705,23,230,1,1,4.90E-05,885315,0.998550643
23709,242,30,1,1,4.90E-05,885316,0.998551771
24642,497,605,1,1,4.90E-05,885317,0.998552899
16130,307,264,1,1,4.90E-05,885318,0.998554027
16139,54,32,1,1,4.90E-05,885319,0.998555155
24634,121,274,1,1,4.90E-05,885320,0.998556282
24595,23,379,1,1,4.90E-05,885321,0.99855741
24629,525,295,1,1,4.90E-05,885322,0.998558538
23713,605,2,1,1,4.90E-05,885323,0.998559666
24622,613,398,1,1,4.90E-05,885324,0.998560794
17261,163,85,1,1,4.90E-05,885325,0.998561922
23715,439,5,1,1,4.90E-05,885326,0.99856305
23716,609,708,1,1,4.90E-05,885327,0.998564178
24597,503,145,1,1,4.90E-05,885328,0.998565306
24769,140,689,1,1,4.90E-05,885329,0.998566434
23632,34,103,1,1,4.90E-05,885330,0.998567561
24771,121,164,1,1,4.90E-05,885331,0.998568689
24880,514,171,1,1,4.90E-05,885332,0.998569817
24947,31,4,1,1,4.90E-05,885333,0.998570945
23568,6,332,1,1,4.90E-05,885334,0.998572073
24934,544,508,1,1,4.90E-05,885335,0.998573201
24933,473,202,1,1,4.90E-05,885336,0.998574329
24931,720,77,1,1,4.90E-05,885337,0.998575457
24930,586,661,1,1,4.90E-05,885338,0.998576585
24927,714,10,1,1,4.90E-05,885339,0.998577713
24918,4,294,1,1,4.90E-05,885340,0.998578841
24917,196,12,1,1,4.90E-05,885341,0.998579968
24911,156,202,1,1,4.90E-05,885342,0.998581096
15928,307,25,1,1,4.90E-05,885343,0.998582224
24906,295,12,1,1,4.90E-05,885344,0.998583352
24902,404,503,1,1,4.90E-05,885345,0.99858448
24900,117,265,1,1,4.90E-05,885346,0.998585608
24893,246,427,1,1,4.90E-05,885347,0.998586736
24892,683,130,1,1,4.90E-05,885348,0.998587864
17427,448,9,1,1,4.90E-05,885349,0.998588992
24963,257,498,1,1,4.90E-05,885350,0.99859012
24967,48,261,1,1,4.90E-05,885351,0.998591247
24968,471,25,1,1,4.90E-05,885352,0.998592375
25025,392,313,1,1,4.90E-05,885353,0.998593503
25057,242,528,1,1,4.90E-05,885354,0.998594631
25050,446,596,1,1,4.90E-05,885355,0.998595759
25047,265,682,1,1,4.90E-05,885356,0.998596887
25030,668,107,1,1,4.90E-05,885357,0.998598015
23556,156,54,1,1,4.90E-05,885358,0.998599143
15717,433,663,1,1,4.90E-05,885359,0.998600271
25027,170,471,1,1,4.90E-05,885360,0.998601399
25019,202,170,1,1,4.90E-05,885361,0.998602527
24972,714,311,1,1,4.90E-05,885362,0.998603654
25005,257,236,1,1,4.90E-05,885363,0.998604782
25003,332,640,1,1,4.90E-05,885364,0.99860591
24994,347,156,1,1,4.90E-05,885365,0.998607038
24993,175,131,1,1,4.90E-05,885366,0.998608166
24991,593,364,1,1,4.90E-05,885367,0.998609294
24982,535,137,1,1,4.90E-05,885368,0.998610422
24978,294,640,1,1,4.90E-05,885369,0.99861155
24881,562,1,1,1,4.90E-05,885370,0.998612678
24879,97,560,1,1,4.90E-05,885371,0.998613806
23631,720,379,1,1,4.90E-05,885372,0.998614933
24875,714,529,1,1,4.90E-05,885373,0.998616061
24804,646,14,1,1,4.90E-05,885374,0.998617189
23603,354,181,1,1,4.90E-05,885375,0.998618317
23614,171,398,1,1,4.90E-05,885376,0.998619445
24801,14,701,1,1,4.90E-05,885377,0.998620573
24800,123,569,1,1,4.90E-05,885378,0.998621701
24798,311,90,1,1,4.90E-05,885379,0.998622829
24797,379,494,1,1,4.90E-05,885380,0.998623957
24793,195,3,1,1,4.90E-05,885381,0.998625085
24792,290,295,1,1,4.90E-05,885382,0.998626212
23615,30,117,1,1,4.90E-05,885383,0.99862734
24791,202,9,1,1,4.90E-05,885384,0.998628468
23618,646,32,1,1,4.90E-05,885385,0.998629596
24787,25,246,1,1,4.90E-05,885386,0.998630724
24783,717,367,1,1,4.90E-05,885387,0.998631852
24781,448,328,1,1,4.90E-05,885388,0.99863298
24775,80,433,1,1,4.90E-05,885389,0.998634108
23625,409,158,1,1,4.90E-05,885390,0.998635236
23602,335,202,1,1,4.90E-05,885391,0.998636364
24808,723,123,1,1,4.90E-05,885392,0.998637492
24810,689,661,1,1,4.90E-05,885393,0.998638619
15945,280,332,1,1,4.90E-05,885394,0.998639747
24872,409,264,1,1,4.90E-05,885395,0.998640875
24865,265,64,1,1,4.90E-05,885396,0.998642003
24864,721,507,1,1,4.90E-05,885397,0.998643131
23578,50,682,1,1,4.90E-05,885398,0.998644259
24861,175,640,1,1,4.90E-05,885399,0.998645387
24859,684,596,1,1,4.90E-05,885400,0.998646515
24858,511,193,1,1,4.90E-05,885401,0.998647643
24845,167,141,1,1,4.90E-05,885402,0.998648771
15966,379,294,1,1,4.90E-05,885403,0.998649898
24841,394,503,1,1,4.90E-05,885404,0.998651026
24833,529,613,1,1,4.90E-05,885405,0.998652154
24825,32,133,1,1,4.90E-05,885406,0.998653282
24824,342,224,1,1,4.90E-05,885407,0.99865441
24822,196,175,1,1,4.90E-05,885408,0.998655538
24818,683,638,1,1,4.90E-05,885409,0.998656666
24812,586,133,1,1,4.90E-05,885410,0.998657794
24524,95,319,1,1,4.90E-05,885411,0.998658922
24520,448,141,1,1,4.90E-05,885412,0.99866005
22900,103,56,1,1,4.90E-05,885413,0.998661178
24028,720,532,1,1,4.90E-05,885414,0.998662305
24267,364,385,1,1,4.90E-05,885415,0.998663433
24266,689,605,1,1,4.90E-05,885416,0.998664561
24265,133,195,1,1,4.90E-05,885417,0.998665689
24035,29,181,1,1,4.90E-05,885418,0.998666817
24039,43,4,1,1,4.90E-05,885419,0.998667945
24040,124,588,1,1,4.90E-05,885420,0.998669073
24043,193,443,1,1,4.90E-05,885421,0.998670201
24044,33,332,1,1,4.90E-05,885422,0.998671329
24046,43,587,1,1,4.90E-05,885423,0.998672457
24050,269,265,1,1,4.90E-05,885424,0.998673584
24052,307,652,1,1,4.90E-05,885425,0.998674712
24060,614,613,1,1,4.90E-05,885426,0.99867584
24071,163,246,1,1,4.90E-05,885427,0.998676968
24261,379,493,1,1,4.90E-05,885428,0.998678096
24080,265,646,1,1,4.90E-05,885429,0.998679224
24092,655,392,1,1,4.90E-05,885430,0.998680352
24101,699,479,1,1,4.90E-05,885431,0.99868148
16885,163,473,1,1,4.90E-05,885432,0.998682608
16899,609,562,1,1,4.90E-05,885433,0.998683736
24518,174,587,1,1,4.90E-05,885434,0.998684864
16914,514,385,1,1,4.90E-05,885435,0.998685991
23976,334,34,1,1,4.90E-05,885436,0.998687119
23984,43,364,1,1,4.90E-05,885437,0.998688247
23985,164,507,1,1,4.90E-05,885438,0.998689375
23997,511,328,1,1,4.90E-05,885439,0.998690503
24335,31,404,1,1,4.90E-05,885440,0.998691631
16589,568,562,1,1,4.90E-05,885441,0.998692759
24316,14,19,1,1,4.90E-05,885442,0.998693887
24308,668,392,1,1,4.90E-05,885443,0.998695015
24002,689,569,1,1,4.90E-05,885444,0.998696143
24305,54,723,1,1,4.90E-05,885445,0.99869727
24300,264,95,1,1,4.90E-05,885446,0.998698398
24298,133,708,1,1,4.90E-05,885447,0.998699526
24297,720,158,1,1,4.90E-05,885448,0.998700654
24005,719,158,1,1,4.90E-05,885449,0.998701782
24286,25,528,1,1,4.90E-05,885450,0.99870291
24284,123,175,1,1,4.90E-05,885451,0.998704038
24271,178,463,1,1,4.90E-05,885452,0.998705166
24105,90,529,1,1,4.90E-05,885453,0.998706294
16817,689,393,1,1,4.90E-05,885454,0.998707422
24113,458,280,1,1,4.90E-05,885455,0.99870855
24122,719,196,1,1,4.90E-05,885456,0.998709677
16704,124,502,1,1,4.90E-05,885457,0.998710805
24200,458,353,1,1,4.90E-05,885458,0.998711933
24199,404,12,1,1,4.90E-05,885459,0.998713061
24196,528,503,1,1,4.90E-05,885460,0.998714189
16715,448,80,1,1,4.90E-05,885461,0.998715317
24188,4,126,1,1,4.90E-05,885462,0.998716445
24184,502,140,1,1,4.90E-05,885463,0.998717573
24182,193,544,1,1,4.90E-05,885464,0.998718701
24179,596,193,1,1,4.90E-05,885465,0.998719829
24139,290,2,1,1,4.90E-05,885466,0.998720956
24150,646,265,1,1,4.90E-05,885467,0.998722084
24151,246,471,1,1,4.90E-05,885468,0.998723212
24171,246,242,1,1,4.90E-05,885469,0.99872434
24154,689,683,1,1,4.90E-05,885470,0.998725468
24158,446,638,1,1,4.90E-05,885471,0.998726596
24167,663,133,1,1,4.90E-05,885472,0.998727724
24162,138,264,1,1,4.90E-05,885473,0.998728852
24206,682,170,1,1,4.90E-05,885474,0.99872998
24210,588,652,1,1,4.90E-05,885475,0.998731108
24216,439,117,1,1,4.90E-05,885476,0.998732236
24243,332,535,1,1,4.90E-05,885477,0.998733363
24123,714,532,1,1,4.90E-05,885478,0.998734491
24127,54,331,1,1,4.90E-05,885479,0.998735619
24259,242,12,1,1,4.90E-05,885480,0.998736747
24255,689,85,1,1,4.90E-05,885481,0.998737875
24132,117,5,1,1,4.90E-05,885482,0.998739003
24247,29,141,1,1,4.90E-05,885483,0.998740131
24245,458,331,1,1,4.90E-05,885484,0.998741259
16658,494,314,1,1,4.90E-05,885485,0.998742387
24224,68,626,1,1,4.90E-05,885486,0.998743515
24241,503,394,1,1,4.90E-05,885487,0.998744642
24239,586,137,1,1,4.90E-05,885488,0.99874577
24234,532,721,1,1,4.90E-05,885489,0.998746898
24134,290,522,1,1,4.90E-05,885490,0.998748026
24229,103,638,1,1,4.90E-05,885491,0.998749154
24228,307,593,1,1,4.90E-05,885492,0.998750282
24226,494,15,1,1,4.90E-05,885493,0.99875141
24339,699,56,1,1,4.90E-05,885494,0.998752538
24340,397,494,1,1,4.90E-05,885495,0.998753666
23969,501,503,1,1,4.90E-05,885496,0.998754794
24438,689,448,1,1,4.90E-05,885497,0.998755921
23810,332,674,1,1,4.90E-05,885498,0.998757049
23815,409,471,1,1,4.90E-05,885499,0.998758177
23824,33,720,1,1,4.90E-05,885500,0.998759305
23835,14,140,1,1,4.90E-05,885501,0.998760433
24473,261,64,1,1,4.90E-05,885502,0.998761561
24470,31,19,1,1,4.90E-05,885503,0.998762689
24469,404,682,1,1,4.90E-05,885504,0.998763817
24467,448,171,1,1,4.90E-05,885505,0.998764945
24456,719,463,1,1,4.90E-05,885506,0.998766073
24455,652,379,1,1,4.90E-05,885507,0.998767201
24454,379,290,1,1,4.90E-05,885508,0.998768328
16377,493,123,1,1,4.90E-05,885509,0.998769456
24448,64,522,1,1,4.90E-05,885510,0.998770584
24447,133,661,1,1,4.90E-05,885511,0.998771712
24446,719,558,1,1,4.90E-05,885512,0.99877284
24442,328,167,1,1,4.90E-05,885513,0.998773968
16399,640,22,1,1,4.90E-05,885514,0.998775096
24491,264,409,1,1,4.90E-05,885515,0.998776224
24492,682,618,1,1,4.90E-05,885516,0.998777352
23807,427,140,1,1,4.90E-05,885517,0.99877848
23784,14,181,1,1,4.90E-05,885518,0.998779607
23757,280,202,1,1,4.90E-05,885519,0.998780735
23760,683,32,1,1,4.90E-05,885520,0.998781863
23761,689,624,1,1,4.90E-05,885521,0.998782991
23762,23,32,1,1,4.90E-05,885522,0.998784119
23765,404,562,1,1,4.90E-05,885523,0.998785247
23766,141,522,1,1,4.90E-05,885524,0.998786375
23769,164,13,1,1,4.90E-05,885525,0.998787503
17208,721,605,1,1,4.90E-05,885526,0.998788631
24498,313,458,1,1,4.90E-05,885527,0.998789759
17197,446,588,1,1,4.90E-05,885528,0.998790887
17195,265,562,1,1,4.90E-05,885529,0.998792014
23793,682,56,1,1,4.90E-05,885530,0.998793142
24511,5,508,1,1,4.90E-05,885531,0.99879427
23800,624,236,1,1,4.90E-05,885532,0.998795398
23805,56,528,1,1,4.90E-05,885533,0.998796526
24500,701,50,1,1,4.90E-05,885534,0.998797654
24439,498,85,1,1,4.90E-05,885535,0.998798782
24431,64,463,1,1,4.90E-05,885536,0.99879991
24343,32,137,1,1,4.90E-05,885537,0.998801038
24423,404,661,1,1,4.90E-05,885538,0.998802166
23899,624,22,1,1,4.90E-05,885539,0.998803293
23900,493,158,1,1,4.90E-05,885540,0.998804421
23901,64,131,1,1,4.90E-05,885541,0.998805549
23902,19,5,1,1,4.90E-05,885542,0.998806677
23908,196,683,1,1,4.90E-05,885543,0.998807805
24373,250,613,1,1,4.90E-05,885544,0.998808933
24369,334,439,1,1,4.90E-05,885545,0.998810061
23927,175,15,1,1,4.90E-05,885546,0.998811189
23949,668,532,1,1,4.90E-05,885547,0.998812317
23952,22,507,1,1,4.90E-05,885548,0.998813445
23953,439,164,1,1,4.90E-05,885549,0.998814573
24347,342,331,1,1,4.90E-05,885550,0.9988157
24346,243,652,1,1,4.90E-05,885551,0.998816828
23957,624,80,1,1,4.90E-05,885552,0.998817956
23966,138,535,1,1,4.90E-05,885553,0.998819084
23967,257,393,1,1,4.90E-05,885554,0.998820212
24344,638,155,1,1,4.90E-05,885555,0.99882134
23896,29,243,1,1,4.90E-05,885556,0.998822468
23882,492,246,1,1,4.90E-05,885557,0.998823596
23879,243,137,1,1,4.90E-05,885558,0.998824724
24384,130,133,1,1,4.90E-05,885559,0.998825852
24422,294,632,1,1,4.90E-05,885560,0.998826979
23841,90,6,1,1,4.90E-05,885561,0.998828107
24416,56,525,1,1,4.90E-05,885562,0.998829235
24410,392,264,1,1,4.90E-05,885563,0.998830363
24398,302,269,1,1,4.90E-05,885564,0.998831491
23845,427,264,1,1,4.90E-05,885565,0.998832619
24389,23,114,1,1,4.90E-05,885566,0.998833747
23853,196,85,1,1,4.90E-05,885567,0.998834875
23877,133,130,1,1,4.90E-05,885568,0.998836003
23856,379,138,1,1,4.90E-05,885569,0.998837131
23862,717,34,1,1,4.90E-05,885570,0.998838259
23867,427,250,1,1,4.90E-05,885571,0.998839386
23872,174,507,1,1,4.90E-05,885572,0.998840514
23875,332,311,1,1,4.90E-05,885573,0.998841642
24376,618,364,1,1,4.90E-05,885574,0.99884277
24375,367,181,1,1,4.90E-05,885575,0.998843898
25060,12,508,1,1,4.90E-05,885576,0.998845026
25061,195,236,1,1,4.90E-05,885577,0.998846154
25062,31,175,1,1,4.90E-05,885578,0.998847282
25547,294,145,1,1,4.90E-05,885579,0.99884841
25542,673,448,1,1,4.90E-05,885580,0.998849538
25541,492,529,1,1,4.90E-05,885581,0.998850665
23114,332,638,1,1,4.90E-05,885582,0.998851793
25534,50,587,1,1,4.90E-05,885583,0.998852921
23118,138,15,1,1,4.90E-05,885584,0.998854049
23129,2,22,1,1,4.90E-05,885585,0.998855177
25529,196,714,1,1,4.90E-05,885586,0.998856305
25527,207,655,1,1,4.90E-05,885587,0.998857433
23141,719,723,1,1,4.90E-05,885588,0.998858561
15120,586,85,1,1,4.90E-05,885589,0.998859689
25515,684,311,1,1,4.90E-05,885590,0.998860817
25514,20,54,1,1,4.90E-05,885591,0.998861945
25512,544,140,1,1,4.90E-05,885592,0.998863072
25511,332,50,1,1,4.90E-05,885593,0.9988642
25501,332,663,1,1,4.90E-05,885594,0.998865328
23143,302,155,1,1,4.90E-05,885595,0.998866456
17930,544,207,1,1,4.90E-05,885596,0.998867584
17964,708,529,1,1,4.90E-05,885597,0.998868712
23109,624,156,1,1,4.90E-05,885598,0.99886984
25063,164,508,1,1,4.90E-05,885599,0.998870968
25559,683,475,1,1,4.90E-05,885600,0.998872096
23086,682,689,1,1,4.90E-05,885601,0.998873224
25598,661,529,1,1,4.90E-05,885602,0.998874351
25597,202,379,1,1,4.90E-05,885603,0.998875479
25596,502,507,1,1,4.90E-05,885604,0.998876607
25593,310,569,1,1,4.90E-05,885605,0.998877735
23103,503,334,1,1,4.90E-05,885606,0.998878863
25591,605,246,1,1,4.90E-05,885607,0.998879991
25587,196,124,1,1,4.90E-05,885608,0.998881119
15043,171,569,1,1,4.90E-05,885609,0.998882247
25578,661,11,1,1,4.90E-05,885610,0.998883375
25576,331,371,1,1,4.90E-05,885611,0.998884503
25574,632,246,1,1,4.90E-05,885612,0.99888563
25572,158,646,1,1,4.90E-05,885613,0.998886758
25569,661,439,1,1,4.90E-05,885614,0.998887886
25568,332,140,1,1,4.90E-05,885615,0.998889014
25566,29,544,1,1,4.90E-05,885616,0.998890142
25563,684,10,1,1,4.90E-05,885617,0.99889127
23150,392,280,1,1,4.90E-05,885618,0.998892398
25496,114,90,1,1,4.90E-05,885619,0.998893526
25494,138,409,1,1,4.90E-05,885620,0.998894654
25493,141,663,1,1,4.90E-05,885621,0.998895782
25442,5,497,1,1,4.90E-05,885622,0.99889691
25440,117,543,1,1,4.90E-05,885623,0.998898037
23201,593,503,1,1,4.90E-05,885624,0.998899165
23206,145,178,1,1,4.90E-05,885625,0.998900293
25429,393,618,1,1,4.90E-05,885626,0.998901421
23217,25,174,1,1,4.90E-05,885627,0.998902549
23218,19,95,1,1,4.90E-05,885628,0.998903677
25426,668,511,1,1,4.90E-05,885629,0.998904805
25425,721,48,1,1,4.90E-05,885630,0.998905933
23221,124,158,1,1,4.90E-05,885631,0.998907061
25423,646,307,1,1,4.90E-05,885632,0.998908189
17859,138,443,1,1,4.90E-05,885633,0.998909316
23236,224,525,1,1,4.90E-05,885634,0.998910444
15340,138,394,1,1,4.90E-05,885635,0.998911572
25419,663,103,1,1,4.90E-05,885636,0.9989127
23239,699,32,1,1,4.90E-05,885637,0.998913828
23241,181,196,1,1,4.90E-05,885638,0.998914956
25444,446,50,1,1,4.90E-05,885639,0.998916084
23199,668,264,1,1,4.90E-05,885640,0.998917212
15280,332,123,1,1,4.90E-05,885641,0.99891834
23190,609,140,1,1,4.90E-05,885642,0.998919468
25490,4,246,1,1,4.90E-05,885643,0.998920596
25487,646,196,1,1,4.90E-05,885644,0.998921723
17905,242,414,1,1,4.90E-05,885645,0.998922851
23172,261,158,1,1,4.90E-05,885646,0.998923979
25477,195,264,1,1,4.90E-05,885647,0.998925107
23181,30,682,1,1,4.90E-05,885648,0.998926235
25473,655,482,1,1,4.90E-05,885649,0.998927363
25470,562,137,1,1,4.90E-05,885650,0.998928491
25451,514,246,1,1,4.90E-05,885651,0.998929619
25468,668,689,1,1,4.90E-05,885652,0.998930747
23192,193,25,1,1,4.90E-05,885653,0.998931875
25461,463,383,1,1,4.90E-05,885654,0.998933002
17886,593,130,1,1,4.90E-05,885655,0.99893413
25456,138,313,1,1,4.90E-05,885656,0.998935258
25453,719,243,1,1,4.90E-05,885657,0.998936386
25452,525,130,1,1,4.90E-05,885658,0.998937514
23071,646,33,1,1,4.90E-05,885659,0.998938642
25602,294,126,1,1,4.90E-05,885660,0.99893977
23069,587,95,1,1,4.90E-05,885661,0.998940898
22969,43,164,1,1,4.90E-05,885662,0.998942026
18189,458,295,1,1,4.90E-05,885663,0.998943154
25760,155,2,1,1,4.90E-05,885664,0.998944282
22938,174,84,1,1,4.90E-05,885665,0.998945409
22939,174,532,1,1,4.90E-05,885666,0.998946537
25759,85,613,1,1,4.90E-05,885667,0.998947665
25758,141,347,1,1,4.90E-05,885668,0.998948793
25755,674,43,1,1,4.90E-05,885669,0.998949921
25753,719,614,1,1,4.90E-05,885670,0.998951049
25752,404,587,1,1,4.90E-05,885671,0.998952177
25750,663,178,1,1,4.90E-05,885672,0.998953305
25743,493,246,1,1,4.90E-05,885673,0.998954433
25740,507,117,1,1,4.90E-05,885674,0.998955561
25739,265,29,1,1,4.90E-05,885675,0.998956688
25736,673,195,1,1,4.90E-05,885676,0.998957816
14755,586,503,1,1,4.90E-05,885677,0.998958944
18177,473,383,1,1,4.90E-05,885678,0.998960072
18169,720,230,1,1,4.90E-05,885679,0.9989612
14685,274,4,1,1,4.90E-05,885680,0.998962328
25766,562,673,1,1,4.90E-05,885681,0.998963456
25767,409,302,1,1,4.90E-05,885682,0.998964584
22920,295,178,1,1,4.90E-05,885683,0.998965712
22914,30,683,1,1,4.90E-05,885684,0.99896684
25804,95,140,1,1,4.90E-05,885685,0.998967968
22918,22,528,1,1,4.90E-05,885686,0.998969095
25799,655,493,1,1,4.90E-05,885687,0.998970223
25796,508,230,1,1,4.90E-05,885688,0.998971351
25791,383,593,1,1,4.90E-05,885689,0.998972479
25789,90,313,1,1,4.90E-05,885690,0.998973607
22921,618,414,1,1,4.90E-05,885691,0.998974735
25772,290,354,1,1,4.90E-05,885692,0.998975863
25788,525,544,1,1,4.90E-05,885693,0.998976991
25787,95,701,1,1,4.90E-05,885694,0.998978119
25783,689,682,1,1,4.90E-05,885695,0.998979247
25780,265,156,1,1,4.90E-05,885696,0.998980374
22929,683,204,1,1,4.90E-05,885697,0.998981502
18193,50,404,1,1,4.90E-05,885698,0.99898263
25776,719,448,1,1,4.90E-05,885699,0.998983758
18166,141,498,1,1,4.90E-05,885700,0.998984886
22981,632,54,1,1,4.90E-05,885701,0.998986014
25608,494,130,1,1,4.90E-05,885702,0.998987142
25729,507,364,1,1,4.90E-05,885703,0.99898827
25675,126,502,1,1,4.90E-05,885704,0.998989398
18045,532,174,1,1,4.90E-05,885705,0.998990526
25668,482,56,1,1,4.90E-05,885706,0.998991654
23053,4,587,1,1,4.90E-05,885707,0.998992781
14967,332,314,1,1,4.90E-05,885708,0.998993909
23059,482,117,1,1,4.90E-05,885709,0.998995037
23060,261,95,1,1,4.90E-05,885710,0.998996165
23061,511,479,1,1,4.90E-05,885711,0.998997293
18031,529,261,1,1,4.90E-05,885712,0.998998421
25649,56,137,1,1,4.90E-05,885713,0.998999549
25645,409,246,1,1,4.90E-05,885714,0.999000677
25641,717,80,1,1,4.90E-05,885715,0.999001805
25633,605,170,1,1,4.90E-05,885716,0.999002933
25628,568,27,1,1,4.90E-05,885717,0.99900406
25621,141,497,1,1,4.90E-05,885718,0.999005188
25620,332,404,1,1,4.90E-05,885719,0.999006316
25615,720,632,1,1,4.90E-05,885720,0.999007444
25676,385,552,1,1,4.90E-05,885721,0.999008572
23031,9,178,1,1,4.90E-05,885722,0.9990097
25680,19,682,1,1,4.90E-05,885723,0.999010828
22994,646,219,1,1,4.90E-05,885724,0.999011956
22989,163,3,1,1,4.90E-05,885725,0.999013084
25727,562,503,1,1,4.90E-05,885726,0.999014212
22990,503,68,1,1,4.90E-05,885727,0.999015339
25722,482,250,1,1,4.90E-05,885728,0.999016467
22993,123,269,1,1,4.90E-05,885729,0.999017595
25710,3,571,1,1,4.90E-05,885730,0.999018723
25706,246,414,1,1,4.90E-05,885731,0.999019851
22998,274,193,1,1,4.90E-05,885732,0.999020979
25689,501,571,1,1,4.90E-05,885733,0.999022107
25704,97,507,1,1,4.90E-05,885734,0.999023235
23009,367,492,1,1,4.90E-05,885735,0.999024363
23013,609,5,1,1,4.90E-05,885736,0.999025491
25694,123,492,1,1,4.90E-05,885737,0.999026619
25693,243,64,1,1,4.90E-05,885738,0.999027746
23018,204,163,1,1,4.90E-05,885739,0.999028874
25692,178,26,1,1,4.90E-05,885740,0.999030002
23242,22,196,1,1,4.90E-05,885741,0.99903113
23243,494,224,1,1,4.90E-05,885742,0.999032258
25417,195,463,1,1,4.90E-05,885743,0.999033386
25172,511,507,1,1,4.90E-05,885744,0.999034514
25227,398,2,1,1,4.90E-05,885745,0.999035642
25225,163,48,1,1,4.90E-05,885746,0.99903677
23450,310,23,1,1,4.90E-05,885747,0.999037898
25221,174,535,1,1,4.90E-05,885748,0.999039025
23456,404,618,1,1,4.90E-05,885749,0.999040153
25218,364,25,1,1,4.90E-05,885750,0.999041281
23460,307,714,1,1,4.90E-05,885751,0.999042409
25210,511,404,1,1,4.90E-05,885752,0.999043537
23470,202,311,1,1,4.90E-05,885753,0.999044665
25206,721,269,1,1,4.90E-05,885754,0.999045793
23471,170,663,1,1,4.90E-05,885755,0.999046921
23488,19,367,1,1,4.90E-05,885756,0.999048049
23490,498,137,1,1,4.90E-05,885757,0.999049177
25201,543,294,1,1,4.90E-05,885758,0.999050305
25194,302,163,1,1,4.90E-05,885759,0.999051432
25188,392,532,1,1,4.90E-05,885760,0.99905256
25178,64,117,1,1,4.90E-05,885761,0.999053688
17565,501,30,1,1,4.90E-05,885762,0.999054816
23438,5,398,1,1,4.90E-05,885763,0.999055944
25231,178,2,1,1,4.90E-05,885764,0.999057072
25250,708,605,1,1,4.90E-05,885765,0.9990582
25262,517,171,1,1,4.90E-05,885766,0.999059328
25259,367,195,1,1,4.90E-05,885767,0.999060456
25258,33,684,1,1,4.90E-05,885768,0.999061584
23416,661,471,1,1,4.90E-05,885769,0.999062711
23419,158,117,1,1,4.90E-05,885770,0.999063839
25253,25,652,1,1,4.90E-05,885771,0.999064967
25252,385,30,1,1,4.90E-05,885772,0.999066095
25249,708,448,1,1,4.90E-05,885773,0.999067223
23434,511,632,1,1,4.90E-05,885774,0.999068351
17598,532,246,1,1,4.90E-05,885775,0.999069479
25246,29,11,1,1,4.90E-05,885776,0.999070607
23423,123,23,1,1,4.90E-05,885777,0.999071735
23427,196,626,1,1,4.90E-05,885778,0.999072863
23433,446,77,1,1,4.90E-05,885779,0.999073991
25237,528,511,1,1,4.90E-05,885780,0.999075118
25232,682,155,1,1,4.90E-05,885781,0.999076246
25174,114,103,1,1,4.90E-05,885782,0.999077374
25170,482,655,1,1,4.90E-05,885783,0.999078502
23415,294,95,1,1,4.90E-05,885784,0.99907963
25169,661,586,1,1,4.90E-05,885785,0.999080758
15592,114,85,1,1,4.90E-05,885786,0.999081886
23517,684,313,1,1,4.90E-05,885787,0.999083014
25112,4,155,1,1,4.90E-05,885788,0.999084142
25111,50,103,1,1,4.90E-05,885789,0.99908527
23526,682,195,1,1,4.90E-05,885790,0.999086397
25105,64,367,1,1,4.90E-05,885791,0.999087525
23536,514,14,1,1,4.90E-05,885792,0.999088653
25101,261,427,1,1,4.90E-05,885793,0.999089781
23539,103,618,1,1,4.90E-05,885794,0.999090909
25089,632,502,1,1,4.90E-05,885795,0.999092037
25079,294,174,1,1,4.90E-05,885796,0.999093165
23549,448,126,1,1,4.90E-05,885797,0.999094293
25076,525,31,1,1,4.90E-05,885798,0.999095421
25074,32,202,1,1,4.90E-05,885799,0.999096549
23550,20,714,1,1,4.90E-05,885800,0.999097677
25071,404,294,1,1,4.90E-05,885801,0.999098804
25064,32,568,1,1,4.90E-05,885802,0.999099932
25115,393,508,1,1,4.90E-05,885803,0.99910106
25122,195,511,1,1,4.90E-05,885804,0.999102188
25123,54,529,1,1,4.90E-05,885805,0.999103316
25159,123,571,1,1,4.90E-05,885806,0.999104444
23494,682,261,1,1,4.90E-05,885807,0.999105572
25168,50,507,1,1,4.90E-05,885808,0.9991067
25166,501,5,1,1,4.90E-05,885809,0.999107828
25164,723,313,1,1,4.90E-05,885810,0.999108956
25163,501,195,1,1,4.90E-05,885811,0.999110083
25161,250,2,1,1,4.90E-05,885812,0.999111211
23503,202,532,1,1,4.90E-05,885813,0.999112339
15556,674,714,1,1,4.90E-05,885814,0.999113467
23515,497,383,1,1,4.90E-05,885815,0.999114595
25152,646,414,1,1,4.90E-05,885816,0.999115723
25150,141,398,1,1,4.90E-05,885817,0.999116851
25149,22,609,1,1,4.90E-05,885818,0.999117979
25145,717,123,1,1,4.90E-05,885819,0.999119107
25141,242,682,1,1,4.90E-05,885820,0.999120235
25129,364,54,1,1,4.90E-05,885821,0.999121363
25128,80,43,1,1,4.90E-05,885822,0.99912249
25264,195,141,1,1,4.90E-05,885823,0.999123618
25268,16,626,1,1,4.90E-05,885824,0.999124746
25415,31,503,1,1,4.90E-05,885825,0.999125874
25346,167,367,1,1,4.90E-05,885826,0.999127002
25383,638,409,1,1,4.90E-05,885827,0.99912813
23284,458,508,1,1,4.90E-05,885828,0.999129258
25382,502,64,1,1,4.90E-05,885829,0.999130386
25378,140,632,1,1,4.90E-05,885830,0.999131514
25377,141,48,1,1,4.90E-05,885831,0.999132642
25376,195,307,1,1,4.90E-05,885832,0.999133769
23291,171,364,1,1,4.90E-05,885833,0.999134897
25367,380,290,1,1,4.90E-05,885834,0.999136025
17764,414,683,1,1,4.90E-05,885835,0.999137153
23300,10,137,1,1,4.90E-05,885836,0.999138281
17745,673,126,1,1,4.90E-05,885837,0.999139409
25365,280,90,1,1,4.90E-05,885838,0.999140537
23316,493,646,1,1,4.90E-05,885839,0.999141665
25357,409,498,1,1,4.90E-05,885840,0.999142793
25354,502,133,1,1,4.90E-05,885841,0.999143921
25349,514,587,1,1,4.90E-05,885842,0.999145048
23332,552,140,1,1,4.90E-05,885843,0.999146176
23282,609,133,1,1,4.90E-05,885844,0.999147304
25385,236,576,1,1,4.90E-05,885845,0.999148432
23277,507,2,1,1,4.90E-05,885846,0.99914956
23269,618,439,1,1,4.90E-05,885847,0.999150688
25414,717,638,1,1,4.90E-05,885848,0.999151816
23249,50,683,1,1,4.90E-05,885849,0.999152944
25412,632,117,1,1,4.90E-05,885850,0.999154072
25409,398,5,1,1,4.90E-05,885851,0.9991552
25408,367,133,1,1,4.90E-05,885852,0.999156328
17792,605,302,1,1,4.90E-05,885853,0.999157455
23268,246,529,1,1,4.90E-05,885854,0.999158583
25403,257,497,1,1,4.90E-05,885855,0.999159711
25386,13,624,1,1,4.90E-05,885856,0.999160839
17790,314,137,1,1,4.90E-05,885857,0.999161967
25400,471,562,1,1,4.90E-05,885858,0.999163095
25399,699,14,1,1,4.90E-05,885859,0.999164223
23272,19,294,1,1,4.90E-05,885860,0.999165351
25398,280,178,1,1,4.90E-05,885861,0.999166479
25393,719,114,1,1,4.90E-05,885862,0.999167607
25387,56,133,1,1,4.90E-05,885863,0.999168734
25347,492,558,1,1,4.90E-05,885864,0.999169862
23340,141,586,1,1,4.90E-05,885865,0.99917099
25271,719,586,1,1,4.90E-05,885866,0.999172118
25342,31,646,1,1,4.90E-05,885867,0.999173246
25302,638,332,1,1,4.90E-05,885868,0.999174374
23370,525,682,1,1,4.90E-05,885869,0.999175502
25300,332,30,1,1,4.90E-05,885870,0.99917663
25297,64,20,1,1,4.90E-05,885871,0.999177758
23372,448,295,1,1,4.90E-05,885872,0.999178886
23375,638,571,1,1,4.90E-05,885873,0.999180014
25294,708,507,1,1,4.90E-05,885874,0.999181141
25290,141,463,1,1,4.90E-05,885875,0.999182269
23383,646,50,1,1,4.90E-05,885876,0.999183397
17643,2,661,1,1,4.90E-05,885877,0.999184525
23388,68,269,1,1,4.90E-05,885878,0.999185653
23406,613,463,1,1,4.90E-05,885879,0.999186781
25288,163,204,1,1,4.90E-05,885880,0.999187909
25287,294,588,1,1,4.90E-05,885881,0.999189037
25283,163,708,1,1,4.90E-05,885882,0.999190165
25276,517,552,1,1,4.90E-05,885883,0.999191293
25275,95,392,1,1,4.90E-05,885884,0.99919242
25304,141,33,1,1,4.90E-05,885885,0.999193548
25309,409,558,1,1,4.90E-05,885886,0.999194676
25311,34,290,1,1,4.90E-05,885887,0.999195804
25328,145,207,1,1,4.90E-05,885888,0.999196932
23344,95,684,1,1,4.90E-05,885889,0.99919806
25338,717,230,1,1,4.90E-05,885890,0.999199188
25335,141,156,1,1,4.90E-05,885891,0.999200316
25332,103,243,1,1,4.90E-05,885892,0.999201444
23349,138,663,1,1,4.90E-05,885893,0.999202572
25331,141,107,1,1,4.90E-05,885894,0.9992037
25330,9,371,1,1,4.90E-05,885895,0.999204827
25327,107,448,1,1,4.90E-05,885896,0.999205955
25312,582,138,1,1,4.90E-05,885897,0.999207083
15403,655,689,1,1,4.90E-05,885898,0.999208211
25322,95,261,1,1,4.90E-05,885899,0.999209339
25321,43,511,1,1,4.90E-05,885900,0.999210467
25319,3,23,1,1,4.90E-05,885901,0.999211595
23359,684,511,1,1,4.90E-05,885902,0.999212723
23365,398,23,1,1,4.90E-05,885903,0.999213851
25315,274,409,1,1,4.90E-05,885904,0.999214979
27289,404,446,1,1,4.90E-05,885905,0.999216106
24163,163,471,1,1,4.90E-05,885906,0.999217234
21765,492,158,1,1,4.90E-05,885907,0.999218362
27953,511,13,1,1,4.90E-05,885908,0.99921949
27955,448,13,1,1,4.90E-05,885909,0.999220618
28247,294,50,1,1,4.90E-05,885910,0.999221746
28249,257,12,1,1,4.90E-05,885911,0.999222874
28472,19,50,1,1,4.90E-05,885912,0.999224002
27632,587,638,1,1,4.90E-05,885913,0.99922513
28251,22,683,1,1,4.90E-05,885914,0.999226258
28252,1,43,1,1,4.90E-05,885915,0.999227386
28253,13,661,1,1,4.90E-05,885916,0.999228513
20300,689,265,1,1,4.90E-05,885917,0.999229641
21561,494,236,1,1,4.90E-05,885918,0.999230769
28470,723,558,1,1,4.90E-05,885919,0.999231897
21314,9,133,1,1,4.90E-05,885920,0.999233025
28254,354,202,1,1,4.90E-05,885921,0.999234153
27951,50,514,1,1,4.90E-05,885922,0.999235281
27949,618,85,1,1,4.90E-05,885923,0.999236409
27948,4,103,1,1,4.90E-05,885924,0.999237537
28255,624,56,1,1,4.90E-05,885925,0.999238665
21317,638,13,1,1,4.90E-05,885926,0.999239792
28467,668,1,1,1,4.90E-05,885927,0.99924092
21084,97,193,1,1,4.90E-05,885928,0.999242048
28256,117,683,1,1,4.90E-05,885929,0.999243176
19682,497,475,1,1,4.90E-05,885930,0.999244304
28245,334,593,1,1,4.90E-05,885931,0.999245432
21313,596,618,1,1,4.90E-05,885932,0.99924656
28257,522,133,1,1,4.90E-05,885933,0.999247688
19657,332,310,1,1,4.90E-05,885934,0.999248816
27970,34,525,1,1,4.90E-05,885935,0.999249944
20891,661,475,1,1,4.90E-05,885936,0.999251072
28239,269,334,1,1,4.90E-05,885937,0.999252199
27617,482,385,1,1,4.90E-05,885938,0.999253327
20892,529,295,1,1,4.90E-05,885939,0.999254455
28240,280,138,1,1,4.90E-05,885940,0.999255583
20900,624,655,1,1,4.90E-05,885941,0.999256711
27968,684,514,1,1,4.90E-05,885942,0.999257839
27967,138,50,1,1,4.90E-05,885943,0.999258967
27620,196,261,1,1,4.90E-05,885944,0.999260095
27964,699,31,1,1,4.90E-05,885945,0.999261223
21087,12,246,1,1,4.90E-05,885946,0.999262351
27623,294,674,1,1,4.90E-05,885947,0.999263478
28241,719,394,1,1,4.90E-05,885948,0.999264606
28482,560,123,1,1,4.90E-05,885949,0.999265734
21114,294,16,1,1,4.90E-05,885950,0.999266862
27627,448,195,1,1,4.90E-05,885951,0.99926799
28480,54,246,1,1,4.90E-05,885952,0.999269118
20112,207,379,1,1,4.90E-05,885953,0.999270246
27628,458,274,1,1,4.90E-05,885954,0.999271374
28477,471,646,1,1,4.90E-05,885955,0.999272502
27961,302,138,1,1,4.90E-05,885956,0.99927363
21542,20,683,1,1,4.90E-05,885957,0.999274758
27638,126,582,1,1,4.90E-05,885958,0.999275885
28489,618,587,1,1,4.90E-05,885959,0.999277013
28268,348,137,1,1,4.90E-05,885960,0.999278141
27651,535,448,1,1,4.90E-05,885961,0.999279269
27938,174,13,1,1,4.90E-05,885962,0.999280397
27653,163,12,1,1,4.90E-05,885963,0.999281525
27937,655,661,1,1,4.90E-05,885964,0.999282653
28267,593,684,1,1,4.90E-05,885965,0.999283781
28450,514,140,1,1,4.90E-05,885966,0.999284909
21506,383,689,1,1,4.90E-05,885967,0.999286037
27656,535,720,1,1,4.90E-05,885968,0.999287164
28449,145,701,1,1,4.90E-05,885969,0.999288292
28448,167,439,1,1,4.90E-05,885970,0.99928942
27658,5,85,1,1,4.90E-05,885971,0.999290548
27939,511,503,1,1,4.90E-05,885972,0.999291676
28272,257,131,1,1,4.90E-05,885973,0.999292804
27659,544,1,1,1,4.90E-05,885974,0.999293932
28273,493,130,1,1,4.90E-05,885975,0.99929506
28445,501,137,1,1,4.90E-05,885976,0.999296188
21336,160,543,1,1,4.90E-05,885977,0.999297316
27660,54,30,1,1,4.90E-05,885978,0.999298443
28443,593,493,1,1,4.90E-05,885979,0.999299571
27935,280,701,1,1,4.90E-05,885980,0.999300699
27661,503,398,1,1,4.90E-05,885981,0.999301827
28442,493,383,1,1,4.90E-05,885982,0.999302955
28458,380,576,1,1,4.90E-05,885983,0.999304083
27940,354,137,1,1,4.90E-05,885984,0.999305211
28259,54,131,1,1,4.90E-05,885985,0.999306339
27947,503,3,1,1,4.90E-05,885986,0.999307467
21524,4,683,1,1,4.90E-05,885987,0.999308595
28463,6,433,1,1,4.90E-05,885988,0.999309723
28461,392,246,1,1,4.90E-05,885989,0.99931085
27640,160,473,1,1,4.90E-05,885990,0.999311978
27642,517,683,1,1,4.90E-05,885991,0.999313106
28460,699,250,1,1,4.90E-05,885992,0.999314234
28260,117,508,1,1,4.90E-05,885993,0.999315362
27643,463,392,1,1,4.90E-05,885994,0.99931649
27644,392,528,1,1,4.90E-05,885995,0.999317618
27646,264,156,1,1,4.90E-05,885996,0.999318746
27946,202,562,1,1,4.90E-05,885997,0.999319874
28265,348,90,1,1,4.90E-05,885998,0.999321002
20147,311,569,1,1,4.90E-05,885999,0.999322129
19885,624,331,1,1,4.90E-05,886000,0.999323257
27943,124,587,1,1,4.90E-05,886001,0.999324385
27942,2,392,1,1,4.90E-05,886002,0.999325513
27648,332,171,1,1,4.90E-05,886003,0.999326641
27941,448,529,1,1,4.90E-05,886004,0.999327769
28261,195,22,1,1,4.90E-05,886005,0.999328897
27649,632,605,1,1,4.90E-05,886006,0.999330025
27650,97,571,1,1,4.90E-05,886007,0.999331153
28262,246,140,1,1,4.90E-05,886008,0.999332281
27613,204,593,1,1,4.90E-05,886009,0.999333409
20890,393,1,1,1,4.90E-05,886010,0.999334536
27990,29,439,1,1,4.90E-05,886011,0.999335664
28537,383,571,1,1,4.90E-05,886012,0.999336792
28543,12,156,1,1,4.90E-05,886013,0.99933792
19895,246,224,1,1,4.90E-05,886014,0.999339048
28541,613,242,1,1,4.90E-05,886015,0.999340176
27560,708,682,1,1,4.90E-05,886016,0.999341304
27561,371,393,1,1,4.90E-05,886017,0.999342432
27562,264,307,1,1,4.90E-05,886018,0.99934356
20440,2,404,1,1,4.90E-05,886019,0.999344688
27563,439,156,1,1,4.90E-05,886020,0.999345815
28220,131,138,1,1,4.90E-05,886021,0.999346943
27985,448,655,1,1,4.90E-05,886022,0.999348071
27564,195,552,1,1,4.90E-05,886023,0.999349199
28217,673,124,1,1,4.90E-05,886024,0.999350327
27567,195,446,1,1,4.90E-05,886025,0.999351455
20780,668,353,1,1,4.90E-05,886026,0.999352583
21610,446,48,1,1,4.90E-05,886027,0.999353711
28222,22,439,1,1,4.90E-05,886028,0.999354839
21609,448,34,1,1,4.90E-05,886029,0.999355967
21604,160,588,1,1,4.90E-05,886030,0.999357095
28225,626,3,1,1,4.90E-05,886031,0.999358222
27569,207,586,1,1,4.90E-05,886032,0.99935935
20786,689,264,1,1,4.90E-05,886033,0.999360478
27576,294,475,1,1,4.90E-05,886034,0.999361606
27986,605,20,1,1,4.90E-05,886035,0.999362734
27557,414,171,1,1,4.90E-05,886036,0.999363862
28227,535,668,1,1,4.90E-05,886037,0.99936499
20445,19,3,1,1,4.90E-05,886038,0.999366118
21653,140,170,1,1,4.90E-05,886039,0.999367246
27537,661,307,1,1,4.90E-05,886040,0.999368374
21306,409,586,1,1,4.90E-05,886041,0.999369501
19568,19,379,1,1,4.90E-05,886042,0.999370629
21648,605,552,1,1,4.90E-05,886043,0.999371757
27543,140,475,1,1,4.90E-05,886044,0.999372885
20760,517,543,1,1,4.90E-05,886045,0.999374013
27545,655,290,1,1,4.90E-05,886046,0.999375141
27546,257,522,1,1,4.90E-05,886047,0.999376269
21641,613,158,1,1,4.90E-05,886048,0.999377397
28214,543,684,1,1,4.90E-05,886049,0.999378525
20441,571,475,1,1,4.90E-05,886050,0.999379653
19583,439,20,1,1,4.90E-05,886051,0.999380781
28550,138,12,1,1,4.90E-05,886052,0.999381908
27548,160,398,1,1,4.90E-05,886053,0.999383036
27551,385,560,1,1,4.90E-05,886054,0.999384164
27552,448,498,1,1,4.90E-05,886055,0.999385292
28547,242,587,1,1,4.90E-05,886056,0.99938642
20444,674,29,1,1,4.90E-05,886057,0.999387548
27554,163,525,1,1,4.90E-05,886058,0.999388676
27556,6,613,1,1,4.90E-05,886059,0.999389804
28546,246,22,1,1,4.90E-05,886060,0.999390932
28529,683,34,1,1,4.90E-05,886061,0.99939206
27981,652,302,1,1,4.90E-05,886062,0.999393187
28238,84,175,1,1,4.90E-05,886063,0.999394315
28497,167,130,1,1,4.90E-05,886064,0.999395443
27595,404,163,1,1,4.90E-05,886065,0.999396571
28503,193,701,1,1,4.90E-05,886066,0.999397699
27597,85,105,1,1,4.90E-05,886067,0.999398827
20835,624,3,1,1,4.90E-05,886068,0.999399955
27598,562,593,1,1,4.90E-05,886069,0.999401083
20843,246,11,1,1,4.90E-05,886070,0.999402211
21583,5,446,1,1,4.90E-05,886071,0.999403339
20366,682,141,1,1,4.90E-05,886072,0.999404467
28501,175,331,1,1,4.90E-05,886073,0.999405594
28500,364,392,1,1,4.90E-05,886074,0.999406722
20353,14,618,1,1,4.90E-05,886075,0.99940785
28504,571,723,1,1,4.90E-05,886076,0.999408978
28495,385,269,1,1,4.90E-05,886077,0.999410106
20859,1,683,1,1,4.90E-05,886078,0.999411234
27603,593,409,1,1,4.90E-05,886079,0.999412362
20873,482,77,1,1,4.90E-05,886080,0.99941349
27605,683,3,1,1,4.90E-05,886081,0.999414618
19649,246,50,1,1,4.90E-05,886082,0.999415746
27610,409,385,1,1,4.90E-05,886083,0.999416873
27611,133,97,1,1,4.90E-05,886084,0.999418001
21570,492,31,1,1,4.90E-05,886085,0.999419129
20318,174,77,1,1,4.90E-05,886086,0.999420257
21585,638,290,1,1,4.90E-05,886087,0.999421385
28505,103,529,1,1,4.90E-05,886088,0.999422513
20430,23,224,1,1,4.90E-05,886089,0.999423641
20396,307,242,1,1,4.90E-05,886090,0.999424769
20797,385,714,1,1,4.90E-05,886091,0.999425897
20421,3,720,1,1,4.90E-05,886092,0.999427025
20418,164,163,1,1,4.90E-05,886093,0.999428152
28229,29,507,1,1,4.90E-05,886094,0.99942928
27980,703,204,1,1,4.90E-05,886095,0.999430408
19624,19,131,1,1,4.90E-05,886096,0.999431536
27979,50,371,1,1,4.90E-05,886097,0.999432664
20821,494,473,1,1,4.90E-05,886098,0.999433792
28521,626,529,1,1,4.90E-05,886099,0.99943492
28519,397,294,1,1,4.90E-05,886100,0.999436048
27584,31,246,1,1,4.90E-05,886101,0.999437176
21117,493,404,1,1,4.90E-05,886102,0.999438304
27587,160,508,1,1,4.90E-05,886103,0.999439432
28518,618,124,1,1,4.90E-05,886104,0.999440559
21593,246,522,1,1,4.90E-05,886105,0.999441687
27976,673,90,1,1,4.90E-05,886106,0.999442815
20099,392,522,1,1,4.90E-05,886107,0.999443943
27588,409,31,1,1,4.90E-05,886108,0.999445071
28510,207,274,1,1,4.90E-05,886109,0.999446199
28509,175,508,1,1,4.90E-05,886110,0.999447327
28508,473,494,1,1,4.90E-05,886111,0.999448455
27590,64,328,1,1,4.90E-05,886112,0.999449583
28275,202,13,1,1,4.90E-05,886113,0.999450711
28440,1,571,1,1,4.90E-05,886114,0.999451838
27666,582,719,1,1,4.90E-05,886115,0.999452966
27878,23,20,1,1,4.90E-05,886116,0.999454094
27886,242,593,1,1,4.90E-05,886117,0.999455222
27767,689,714,1,1,4.90E-05,886118,0.99945635
27768,164,193,1,1,4.90E-05,886119,0.999457478
28372,342,236,1,1,4.90E-05,886120,0.999458606
28322,114,652,1,1,4.90E-05,886121,0.999459734
21393,103,121,1,1,4.90E-05,886122,0.999460862
28323,164,332,1,1,4.90E-05,886123,0.99946199
27775,242,181,1,1,4.90E-05,886124,0.999463118
27884,498,19,1,1,4.90E-05,886125,0.999464245
28326,334,507,1,1,4.90E-05,886126,0.999465373
21004,682,528,1,1,4.90E-05,886127,0.999466501
28321,43,502,1,1,4.90E-05,886128,0.999467629
27877,103,433,1,1,4.90E-05,886129,0.999468757
27876,458,141,1,1,4.90E-05,886130,0.999469885
27875,23,34,1,1,4.90E-05,886131,0.999471013
20207,404,482,1,1,4.90E-05,886132,0.999472141
27779,613,56,1,1,4.90E-05,886133,0.999473269
27780,163,171,1,1,4.90E-05,886134,0.999474397
27784,290,498,1,1,4.90E-05,886135,0.999475524
12093,117,25,1,1,4.90E-05,886136,0.999476652
20204,243,20,1,1,4.90E-05,886137,0.99947778
27785,202,463,1,1,4.90E-05,886138,0.999478908
27889,19,170,1,1,4.90E-05,886139,0.999480036
21422,683,497,1,1,4.90E-05,886140,0.999481164
27786,302,433,1,1,4.90E-05,886141,0.999482292
27761,174,689,1,1,4.90E-05,886142,0.99948342
27746,394,171,1,1,4.90E-05,886143,0.999484548
27750,613,130,1,1,4.90E-05,886144,0.999485676
27751,683,689,1,1,4.90E-05,886145,0.999486804
28382,230,19,1,1,4.90E-05,886146,0.999487931
27752,29,532,1,1,4.90E-05,886147,0.999489059
27753,123,319,1,1,4.90E-05,886148,0.999490187
27756,652,123,1,1,4.90E-05,886149,0.999491315
28379,661,30,1,1,4.90E-05,886150,0.999492443
27758,501,409,1,1,4.90E-05,886151,0.999493571
27760,246,130,1,1,4.90E-05,886152,0.999494699
27762,593,624,1,1,4.90E-05,886153,0.999495827
27890,714,427,1,1,4.90E-05,886154,0.999496955
27763,3,160,1,1,4.90E-05,886155,0.999498083
27894,503,20,1,1,4.90E-05,886156,0.99949921
28377,684,30,1,1,4.90E-05,886157,0.999500338
28317,544,4,1,1,4.90E-05,886158,0.999501466
20218,103,353,1,1,4.90E-05,886159,0.999502594
20216,646,141,1,1,4.90E-05,886160,0.999503722
27892,48,133,1,1,4.90E-05,886161,0.99950485
27891,126,543,1,1,4.90E-05,886162,0.999505978
28376,274,569,1,1,4.90E-05,886163,0.999507106
20214,529,682,1,1,4.90E-05,886164,0.999508234
21012,15,103,1,1,4.90E-05,886165,0.999509362
27789,587,307,1,1,4.90E-05,886166,0.99951049
27669,193,586,1,1,4.90E-05,886167,0.999511617
27823,385,332,1,1,4.90E-05,886168,0.999512745
19832,167,364,1,1,4.90E-05,886169,0.999513873
28340,385,138,1,1,4.90E-05,886170,0.999515001
27848,242,392,1,1,4.90E-05,886171,0.999516129
28343,117,15,1,1,4.90E-05,886172,0.999517257
27818,290,398,1,1,4.90E-05,886173,0.999518385
27844,133,261,1,1,4.90E-05,886174,0.999519513
27820,385,290,1,1,4.90E-05,886175,0.999520641
27822,714,473,1,1,4.90E-05,886176,0.999521769
19847,385,141,1,1,4.90E-05,886177,0.999522896
21037,77,571,1,1,4.90E-05,886178,0.999524024
28359,12,20,1,1,4.90E-05,886179,0.999525152
21031,4,409,1,1,4.90E-05,886180,0.99952628
28350,167,723,1,1,4.90E-05,886181,0.999527408
28358,492,242,1,1,4.90E-05,886182,0.999528536
21038,398,140,1,1,4.90E-05,886183,0.999529664
27841,311,433,1,1,4.90E-05,886184,0.999530792
28356,246,25,1,1,4.90E-05,886185,0.99953192
27832,84,103,1,1,4.90E-05,886186,0.999533048
27833,269,328,1,1,4.90E-05,886187,0.999534176
28352,204,652,1,1,4.90E-05,886188,0.999535303
28354,514,29,1,1,4.90E-05,886189,0.999536431
27835,170,280,1,1,4.90E-05,886190,0.999537559
27811,167,25,1,1,4.90E-05,886191,0.999538687
28338,23,31,1,1,4.90E-05,886192,0.999539815
19809,20,682,1,1,4.90E-05,886193,0.999540943
21374,207,141,1,1,4.90E-05,886194,0.999542071
21385,163,14,1,1,4.90E-05,886195,0.999543199
27790,33,613,1,1,4.90E-05,886196,0.999544327
28367,121,514,1,1,4.90E-05,886197,0.999545455
21383,31,614,1,1,4.90E-05,886198,0.999546582
19820,458,158,1,1,4.90E-05,886199,0.99954771
27793,160,708,1,1,4.90E-05,886200,0.999548838
19824,133,34,1,1,4.90E-05,886201,0.999549966
27794,482,471,1,1,4.90E-05,886202,0.999551094
28366,155,242,1,1,4.90E-05,886203,0.999552222
27795,130,371,1,1,4.90E-05,886204,0.99955335
27798,328,525,1,1,4.90E-05,886205,0.999554478
21030,133,4,1,1,4.90E-05,886206,0.999555606
27799,29,56,1,1,4.90E-05,886207,0.999556734
20193,133,439,1,1,4.90E-05,886208,0.999557861
27802,307,12,1,1,4.90E-05,886209,0.999558989
28333,593,29,1,1,4.90E-05,886210,0.999560117
28363,328,613,1,1,4.90E-05,886211,0.999561245
27859,207,560,1,1,4.90E-05,886212,0.999562373
28334,332,714,1,1,4.90E-05,886213,0.999563501
21025,334,121,1,1,4.90E-05,886214,0.999564629
27806,646,514,1,1,4.90E-05,886215,0.999565757
27808,95,133,1,1,4.90E-05,886216,0.999566885
28387,482,15,1,1,4.90E-05,886217,0.999568013
27900,224,458,1,1,4.90E-05,886218,0.999569141
28307,663,261,1,1,4.90E-05,886219,0.999570268
21064,145,85,1,1,4.90E-05,886220,0.999571396
27689,141,311,1,1,4.90E-05,886221,0.999572524
27922,95,332,1,1,4.90E-05,886222,0.999573652
27919,493,560,1,1,4.90E-05,886223,0.99957478
27690,33,202,1,1,4.90E-05,886224,0.999575908
27691,427,29,1,1,4.90E-05,886225,0.999577036
28425,160,348,1,1,4.90E-05,886226,0.999578164
28424,43,624,1,1,4.90E-05,886227,0.999579292
20919,163,614,1,1,4.90E-05,886228,0.99958042
21066,571,20,1,1,4.90E-05,886229,0.999581547
19858,242,4,1,1,4.90E-05,886230,0.999582675
27695,123,720,1,1,4.90E-05,886231,0.999583803
20295,511,20,1,1,4.90E-05,886232,0.999584931
21360,2,175,1,1,4.90E-05,886233,0.999586059
20923,517,1,1,1,4.90E-05,886234,0.999587187
20161,133,50,1,1,4.90E-05,886235,0.999588315
28421,502,652,1,1,4.90E-05,886236,0.999589443
27696,586,155,1,1,4.90E-05,886237,0.999590571
21062,404,130,1,1,4.90E-05,886238,0.999591699
20286,242,56,1,1,4.90E-05,886239,0.999592827
27698,31,682,1,1,4.90E-05,886240,0.999593954
20934,497,56,1,1,4.90E-05,886241,0.999595082
27699,54,145,1,1,4.90E-05,886242,0.99959621
27688,32,613,1,1,4.90E-05,886243,0.999597338
28427,587,302,1,1,4.90E-05,886244,0.999598466
20180,507,167,1,1,4.90E-05,886245,0.999599594
19869,90,85,1,1,4.90E-05,886246,0.999600722
27933,242,2,1,1,4.90E-05,886247,0.99960185
27674,158,13,1,1,4.90E-05,886248,0.999602978
27675,354,371,1,1,4.90E-05,886249,0.999604106
28282,503,683,1,1,4.90E-05,886250,0.999605233
21492,586,171,1,1,4.90E-05,886251,0.999606361
27678,219,160,1,1,4.90E-05,886252,0.999607489
27679,54,26,1,1,4.90E-05,886253,0.999608617
27931,383,13,1,1,4.90E-05,886254,0.999609745
27681,492,261,1,1,4.90E-05,886255,0.999610873
21481,141,354,1,1,4.90E-05,886256,0.999612001
27930,347,433,1,1,4.90E-05,886257,0.999613129
28428,718,311,1,1,4.90E-05,886258,0.999614257
21343,475,587,1,1,4.90E-05,886259,0.999615385
27927,43,163,1,1,4.90E-05,886260,0.999616513
27926,193,517,1,1,4.90E-05,886261,0.99961764
28283,492,25,1,1,4.90E-05,886262,0.999618768
20911,394,507,1,1,4.90E-05,886263,0.999619896
20913,517,528,1,1,4.90E-05,886264,0.999621024
27685,427,193,1,1,4.90E-05,886265,0.999622152
19860,195,689,1,1,4.90E-05,886266,0.99962328
10642,4,593,1,1,4.90E-05,886267,0.999624408
27924,404,383,1,1,4.90E-05,886268,0.999625536
28290,50,175,1,1,4.90E-05,886269,0.999626664
27912,458,140,1,1,4.90E-05,886270,0.999627792
27908,124,164,1,1,4.90E-05,886271,0.999628919
27738,25,195,1,1,4.90E-05,886272,0.999630047
27729,364,246,1,1,4.90E-05,886273,0.999631175
27732,655,29,1,1,4.90E-05,886274,0.999632303
21480,334,364,1,1,4.90E-05,886275,0.999633431
27733,107,290,1,1,4.90E-05,886276,0.999634559
27903,714,68,1,1,4.90E-05,886277,0.999635687
21471,9,137,1,1,4.90E-05,886278,0.999636815
27736,80,103,1,1,4.90E-05,886279,0.999637943
21470,596,332,1,1,4.90E-05,886280,0.999639071
21467,95,22,1,1,4.90E-05,886281,0.999640199
21460,714,243,1,1,4.90E-05,886282,0.999641326
27739,261,528,1,1,4.90E-05,886283,0.999642454
20273,439,145,1,1,4.90E-05,886284,0.999643582
27742,394,175,1,1,4.90E-05,886285,0.99964471
21457,443,493,1,1,4.90E-05,886286,0.999645838
21444,140,640,1,1,4.90E-05,886287,0.999646966
28392,701,15,1,1,4.90E-05,886288,0.999648094
27743,175,14,1,1,4.90E-05,886289,0.999649222
21438,501,12,1,1,4.90E-05,886290,0.99965035
19768,6,720,1,1,4.90E-05,886291,0.999651478
28302,23,427,1,1,4.90E-05,886292,0.999652605
28305,497,661,1,1,4.90E-05,886293,0.999653733
28390,261,593,1,1,4.90E-05,886294,0.999654861
27726,163,683,1,1,4.90E-05,886295,0.999655989
27905,33,493,1,1,4.90E-05,886296,0.999657117
27723,29,294,1,1,4.90E-05,886297,0.999658245
27719,458,529,1,1,4.90E-05,886298,0.999659373
28412,140,294,1,1,4.90E-05,886299,0.999660501
28411,290,517,1,1,4.90E-05,886300,0.999661629
20942,458,379,1,1,4.90E-05,886301,0.999662757
28292,593,156,1,1,4.90E-05,886302,0.999663885
28293,178,663,1,1,4.90E-05,886303,0.999665012
27706,640,392,1,1,4.90E-05,886304,0.99966614
27717,587,31,1,1,4.90E-05,886305,0.999667268
28407,1,202,1,1,4.90E-05,886306,0.999668396
28296,723,230,1,1,4.90E-05,886307,0.999669524
20945,502,328,1,1,4.90E-05,886308,0.999670652
20256,721,348,1,1,4.90E-05,886309,0.99967178
20253,624,11,1,1,4.90E-05,886310,0.999672908
28405,294,121,1,1,4.90E-05,886311,0.999674036
20243,558,160,1,1,4.90E-05,886312,0.999675164
20972,131,202,1,1,4.90E-05,886313,0.999676291
27718,193,121,1,1,4.90E-05,886314,0.999677419
28402,593,587,1,1,4.90E-05,886315,0.999678547
28401,701,158,1,1,4.90E-05,886316,0.999679675
20973,708,393,1,1,4.90E-05,886317,0.999680803
28300,15,383,1,1,4.90E-05,886318,0.999681931
20986,689,501,1,1,4.90E-05,886319,0.999683059
20466,264,473,1,1,4.90E-05,886320,0.999684187
27975,30,503,1,1,4.90E-05,886321,0.999685315
28159,571,334,1,1,4.90E-05,886322,0.999686443
27341,347,646,1,1,4.90E-05,886323,0.99968757
27340,207,618,1,1,4.90E-05,886324,0.999688698
27339,674,181,1,1,4.90E-05,886325,0.999689826
28631,307,155,1,1,4.90E-05,886326,0.999690954
28173,525,661,1,1,4.90E-05,886327,0.999692082
20699,503,141,1,1,4.90E-05,886328,0.99969321
27428,640,514,1,1,4.90E-05,886329,0.999694338
28627,14,569,1,1,4.90E-05,886330,0.999695466
27338,2,433,1,1,4.90E-05,886331,0.999696594
21756,224,178,1,1,4.90E-05,886332,0.999697722
20702,502,22,1,1,4.90E-05,886333,0.99969885
27337,30,514,1,1,4.90E-05,886334,0.999699977
28691,77,721,1,1,4.90E-05,886335,0.999701105
27432,517,618,1,1,4.90E-05,886336,0.999702233
28128,246,64,1,1,4.90E-05,886337,0.999703361
28177,4,269,1,1,4.90E-05,886338,0.999704489
28692,701,655,1,1,4.90E-05,886339,0.999705617
28623,29,497,1,1,4.90E-05,886340,0.999706745
28039,171,121,1,1,4.90E-05,886341,0.999707873
27427,587,107,1,1,4.90E-05,886342,0.999709001
27410,31,140,1,1,4.90E-05,886343,0.999710129
28093,246,14,1,1,4.90E-05,886344,0.999711256
28044,4,133,1,1,4.90E-05,886345,0.999712384
27413,14,446,1,1,4.90E-05,886346,0.999713512
20525,614,174,1,1,4.90E-05,886347,0.99971464
28168,207,609,1,1,4.90E-05,886348,0.999715768
28169,121,501,1,1,4.90E-05,886349,0.999716896
28043,562,133,1,1,4.90E-05,886350,0.999718024
21281,482,473,1,1,4.90E-05,886351,0.999719152
20556,5,11,1,1,4.90E-05,886352,0.99972028
27420,242,493,1,1,4.90E-05,886353,0.999721408
27421,261,15,1,1,4.90E-05,886354,0.999722536
19925,246,114,1,1,4.90E-05,886355,0.999723663
28042,614,13,1,1,4.90E-05,886356,0.999724791
21757,493,48,1,1,4.90E-05,886357,0.999725919
28632,714,562,1,1,4.90E-05,886358,0.999727047
27426,103,498,1,1,4.90E-05,886359,0.999728175
28040,684,479,1,1,4.90E-05,886360,0.999729303
28682,6,371,1,1,4.90E-05,886361,0.999730431
27336,117,632,1,1,4.90E-05,886362,0.999731559
21745,721,163,1,1,4.90E-05,886363,0.999732687
28693,517,140,1,1,4.90E-05,886364,0.999733815
27333,335,719,1,1,4.90E-05,886365,0.999734942
27329,684,328,1,1,4.90E-05,886366,0.99973607
21731,409,26,1,1,4.90E-05,886367,0.999737198
27328,181,16,1,1,4.90E-05,886368,0.999738326
21716,646,117,1,1,4.90E-05,886369,0.999739454
28026,334,294,1,1,4.90E-05,886370,0.999740582
27459,114,171,1,1,4.90E-05,886371,0.99974171
19998,471,20,1,1,4.90E-05,886372,0.999742838
28024,605,503,1,1,4.90E-05,886373,0.999743966
19528,624,498,1,1,4.90E-05,886374,0.999745094
20589,342,588,1,1,4.90E-05,886375,0.999746222
27324,290,471,1,1,4.90E-05,886376,0.999747349
27323,463,446,1,1,4.90E-05,886377,0.999748477
20595,507,140,1,1,4.90E-05,886378,0.999749605
19529,9,720,1,1,4.90E-05,886379,0.999750733
28124,544,133,1,1,4.90E-05,886380,0.999751861
27320,404,167,1,1,4.90E-05,886381,0.999752989
21129,380,138,1,1,4.90E-05,886382,0.999754117
27457,443,717,1,1,4.90E-05,886383,0.999755245
27374,587,347,1,1,4.90E-05,886384,0.999756373
27450,311,342,1,1,4.90E-05,886385,0.999757501
27440,475,383,1,1,4.90E-05,886386,0.999758628
27435,90,354,1,1,4.90E-05,886387,0.999759756
27332,56,624,1,1,4.90E-05,886388,0.999760884
20655,163,22,1,1,4.90E-05,886389,0.999762012
20706,393,507,1,1,4.90E-05,886390,0.99976314
19503,2,511,1,1,4.90E-05,886391,0.999764268
28036,383,261,1,1,4.90E-05,886392,0.999765396
20719,133,689,1,1,4.90E-05,886393,0.999766524
20646,596,171,1,1,4.90E-05,886394,0.999767652
28027,163,64,1,1,4.90E-05,886395,0.99976878
28618,528,493,1,1,4.90E-05,886396,0.999769908
28033,393,138,1,1,4.90E-05,886397,0.999771035
28615,482,26,1,1,4.90E-05,886398,0.999772163
28029,586,448,1,1,4.90E-05,886399,0.999773291
27444,354,90,1,1,4.90E-05,886400,0.999774419
27445,683,25,1,1,4.90E-05,886401,0.999775547
28613,334,714,1,1,4.90E-05,886402,0.999776675
28045,332,503,1,1,4.90E-05,886403,0.999777803
27344,448,562,1,1,4.90E-05,886404,0.999778931
28123,673,294,1,1,4.90E-05,886405,0.999780059
28139,674,668,1,1,4.90E-05,886406,0.999781187
28142,15,646,1,1,4.90E-05,886407,0.999782314
28665,493,30,1,1,4.90E-05,886408,0.999783442
20543,95,85,1,1,4.90E-05,886409,0.99978457
28654,195,414,1,1,4.90E-05,886410,0.999785698
27383,11,138,1,1,4.90E-05,886411,0.999786826
27367,609,13,1,1,4.90E-05,886412,0.999787954
28651,497,29,1,1,4.90E-05,886413,0.999789082
28650,668,514,1,1,4.90E-05,886414,0.99979021
28078,535,525,1,1,4.90E-05,886415,0.999791338
28072,140,167,1,1,4.90E-05,886416,0.999792466
21145,31,56,1,1,4.90E-05,886417,0.999793594
28648,2,448,1,1,4.90E-05,886418,0.999794721
28069,618,682,1,1,4.90E-05,886419,0.999795849
27364,714,280,1,1,4.90E-05,886420,0.999796977
27362,202,242,1,1,4.90E-05,886421,0.999798105
27384,661,236,1,1,4.90E-05,886422,0.999799233
28667,683,13,1,1,4.90E-05,886423,0.999800361
28655,250,290,1,1,4.90E-05,886424,0.999801489
28657,682,571,1,1,4.90E-05,886425,0.999802617
28679,353,133,1,1,4.90E-05,886426,0.999803745
27368,265,195,1,1,4.90E-05,886427,0.999804873
27378,246,274,1,1,4.90E-05,886428,0.999806
28134,13,493,1,1,4.90E-05,886429,0.999807128
28135,511,140,1,1,4.90E-05,886430,0.999808256
28136,155,576,1,1,4.90E-05,886431,0.999809384
28659,661,632,1,1,4.90E-05,886432,0.999810512
27380,723,15,1,1,4.90E-05,886433,0.99981164
27371,493,501,1,1,4.90E-05,886434,0.999812768
20547,164,475,1,1,4.90E-05,886435,0.999813896
28080,624,170,1,1,4.90E-05,886436,0.999815024
28081,593,54,1,1,4.90E-05,886437,0.999816152
28083,511,646,1,1,4.90E-05,886438,0.999817279
28131,274,133,1,1,4.90E-05,886439,0.999818407
28084,682,661,1,1,4.90E-05,886440,0.999819535
20057,439,85,1,1,4.90E-05,886441,0.999820663
21245,207,84,1,1,4.90E-05,886442,0.999821791
28663,68,458,1,1,4.90E-05,886443,0.999822919
27382,475,593,1,1,4.90E-05,886444,0.999824047
28129,138,97,1,1,4.90E-05,886445,0.999825175
28150,593,133,1,1,4.90E-05,886446,0.999826303
28067,614,720,1,1,4.90E-05,886447,0.999827431
28066,571,196,1,1,4.90E-05,886448,0.999828559
27398,409,295,1,1,4.90E-05,886449,0.999829686
27399,156,683,1,1,4.90E-05,886450,0.999830814
28643,613,32,1,1,4.90E-05,886451,0.999831942
27346,54,141,1,1,4.90E-05,886452,0.99983307
28158,167,624,1,1,4.90E-05,886453,0.999834198
28057,105,719,1,1,4.90E-05,886454,0.999835326
28641,448,25,1,1,4.90E-05,886455,0.999836454
19930,334,264,1,1,4.90E-05,886456,0.999837582
20536,265,392,1,1,4.90E-05,886457,0.99983871
20753,605,295,1,1,4.90E-05,886458,0.999839838
27402,353,525,1,1,4.90E-05,886459,0.999840965
27405,160,385,1,1,4.90E-05,886460,0.999842093
28637,164,528,1,1,4.90E-05,886461,0.999843221
27407,689,383,1,1,4.90E-05,886462,0.999844349
28050,43,332,1,1,4.90E-05,886463,0.999845477
21137,12,560,1,1,4.90E-05,886464,0.999846605
19984,683,385,1,1,4.90E-05,886465,0.999847733
28644,290,614,1,1,4.90E-05,886466,0.999848861
28678,68,684,1,1,4.90E-05,886467,0.999849989
28675,347,85,1,1,4.90E-05,886468,0.999851117
28672,2,25,1,1,4.90E-05,886469,0.999852245
20049,682,30,1,1,4.90E-05,886470,0.999853372
28670,107,43,1,1,4.90E-05,886471,0.9998545
28646,717,167,1,1,4.90E-05,886472,0.999855628
27391,141,14,1,1,4.90E-05,886473,0.999856756
27392,178,121,1,1,4.90E-05,886474,0.999857884
28151,439,502,1,1,4.90E-05,886475,0.999859012
21237,133,155,1,1,4.90E-05,886476,0.99986014
27352,475,571,1,1,4.90E-05,886477,0.999861268
28061,170,586,1,1,4.90E-05,886478,0.999862396
28152,117,22,1,1,4.90E-05,886479,0.999863524
20551,507,714,1,1,4.90E-05,886480,0.999864651
27350,446,280,1,1,4.90E-05,886481,0.999865779
28153,544,193,1,1,4.90E-05,886482,0.999866907
19937,379,571,1,1,4.90E-05,886483,0.999868035
28064,507,193,1,1,4.90E-05,886484,0.999869163
21141,502,632,1,1,4.90E-05,886485,0.999870291
21126,95,528,1,1,4.90E-05,886486,0.999871419
28612,503,393,1,1,4.90E-05,886487,0.999872547
27373,511,269,1,1,4.90E-05,886488,0.999873675
27492,33,124,1,1,4.90E-05,886489,0.999874803
27302,427,383,1,1,4.90E-05,886490,0.999875931
27493,482,130,1,1,4.90E-05,886491,0.999877058
20607,714,353,1,1,4.90E-05,886492,0.999878186
20726,23,202,1,1,4.90E-05,886493,0.999879314
28018,117,493,1,1,4.90E-05,886494,0.999880442
28116,652,596,1,1,4.90E-05,886495,0.99988157
27303,19,56,1,1,4.90E-05,886496,0.999882698
28200,383,683,1,1,4.90E-05,886497,0.999883826
21285,265,683,1,1,4.90E-05,886498,0.999884954
28019,164,618,1,1,4.90E-05,886499,0.999886082
27999,121,562,1,1,4.90E-05,886500,0.99988721
21686,105,684,1,1,4.90E-05,886501,0.999888337
27306,719,56,1,1,4.90E-05,886502,0.999889465
27490,721,364,1,1,4.90E-05,886503,0.999890593
27298,56,155,1,1,4.90E-05,886504,0.999891721
27998,717,9,1,1,4.90E-05,886505,0.999892849
27291,1,383,1,1,4.90E-05,886506,0.999893977
27510,257,4,1,1,4.90E-05,886507,0.999895105
21687,171,3,1,1,4.90E-05,886508,0.999896233
21198,514,2,1,1,4.90E-05,886509,0.999897361
27512,14,652,1,1,4.90E-05,886510,0.999898489
27997,33,319,1,1,4.90E-05,886511,0.999899617
27506,717,532,1,1,4.90E-05,886512,0.999900744
19917,246,219,1,1,4.90E-05,886513,0.999901872
20606,290,64,1,1,4.90E-05,886514,0.999903
27513,264,640,1,1,4.90E-05,886515,0.999904128
27514,171,571,1,1,4.90E-05,886516,0.999905256
28117,290,311,1,1,4.90E-05,886517,0.999906384
28115,117,204,1,1,4.90E-05,886518,0.999907512
28598,587,250,1,1,4.90E-05,886519,0.99990864
28602,503,170,1,1,4.90E-05,886520,0.999909768
28015,720,543,1,1,4.90E-05,886521,0.999910896
28007,503,156,1,1,4.90E-05,886522,0.999912023
28114,332,121,1,1,4.90E-05,886523,0.999913151
21679,331,720,1,1,4.90E-05,886524,0.999914279
28586,290,393,1,1,4.90E-05,886525,0.999915407
19918,141,334,1,1,4.90E-05,886526,0.999916535
27503,684,280,1,1,4.90E-05,886527,0.999917663
27507,126,1,1,1,4.90E-05,886528,0.999918791
28595,721,207,1,1,4.90E-05,886529,0.999919919
27501,3,133,1,1,4.90E-05,886530,0.999921047
28711,699,117,1,1,4.90E-05,886531,0.999922175
28204,84,138,1,1,4.90E-05,886532,0.999923303
28012,543,103,1,1,4.90E-05,886533,0.99992443
27297,13,398,1,1,4.90E-05,886534,0.999925558
28206,719,13,1,1,4.90E-05,886535,0.999926686
27509,138,427,1,1,4.90E-05,886536,0.999927814
28006,655,571,1,1,4.90E-05,886537,0.999928942
21680,202,11,1,1,4.90E-05,886538,0.99993007
28201,652,9,1,1,4.90E-05,886539,0.999931198
27508,717,302,1,1,4.90E-05,886540,0.999932326
28708,508,15,1,1,4.90E-05,886541,0.999933454
20021,674,652,1,1,4.90E-05,886542,0.999934582
28001,274,525,1,1,4.90E-05,886543,0.999935709
20035,446,2,1,1,4.90E-05,886544,0.999936837
28579,274,13,1,1,4.90E-05,886545,0.999937965
21697,97,156,1,1,4.90E-05,886546,0.999939093
28210,717,397,1,1,4.90E-05,886547,0.999940221
28597,261,448,1,1,4.90E-05,886548,0.999941349
28017,332,479,1,1,4.90E-05,886549,0.999942477
21669,652,331,1,1,4.90E-05,886550,0.999943605
28569,170,392,1,1,4.90E-05,886551,0.999944733
20733,265,475,1,1,4.90E-05,886552,0.999945861
21656,1,552,1,1,4.90E-05,886553,0.999946988
28714,674,294,1,1,4.90E-05,886554,0.999948116
28022,717,354,1,1,4.90E-05,886555,0.999949244
19562,397,508,1,1,4.90E-05,886556,0.999950372
27472,207,393,1,1,4.90E-05,886557,0.9999515
28703,156,482,1,1,4.90E-05,886558,0.999952628
21663,20,140,1,1,4.90E-05,886559,0.999953756
27470,439,482,1,1,4.90E-05,886560,0.999954884
27466,167,307,1,1,4.90E-05,886561,0.999956012
27316,493,471,1,1,4.90E-05,886562,0.99995714
28188,250,624,1,1,4.90E-05,886563,0.999958268
27993,674,90,1,1,4.90E-05,886564,0.999959395
28185,458,30,1,1,4.90E-05,886565,0.999960523
21659,353,193,1,1,4.90E-05,886566,0.999961651
28120,163,2,1,1,4.90E-05,886567,0.999962779
27307,202,50,1,1,4.90E-05,886568,0.999963907
27991,4,90,1,1,4.90E-05,886569,0.999965035
28122,673,193,1,1,4.90E-05,886570,0.999966163
28559,294,353,1,1,4.90E-05,886571,0.999967291
28184,717,535,1,1,4.90E-05,886572,0.999968419
28557,54,652,1,1,4.90E-05,886573,0.999969547
27318,475,290,1,1,4.90E-05,886574,0.999970674
20605,2,605,1,1,4.90E-05,886575,0.999971802
28095,522,701,1,1,4.90E-05,886576,0.99997293
28702,446,689,1,1,4.90E-05,886577,0.999974058
28554,587,243,1,1,4.90E-05,886578,0.999975186
28609,126,479,1,1,4.90E-05,886579,0.999976314
27531,164,5,1,1,4.90E-05,886580,0.999977442
27532,95,90,1,1,4.90E-05,886581,0.99997857
28190,290,56,1,1,4.90E-05,886582,0.999979698
28213,663,720,1,1,4.90E-05,886583,0.999980826
27505,385,632,1,1,4.90E-05,886584,0.999981954
27520,11,137,1,1,4.90E-05,886585,0.999983081
28566,409,543,1,1,4.90E-05,886586,0.999984209
27481,204,446,1,1,4.90E-05,886587,0.999985337
28021,498,576,1,1,4.90E-05,886588,0.999986465
28564,219,294,1,1,4.90E-05,886589,0.999987593
20029,307,56,1,1,4.90E-05,886590,0.999988721
21300,562,246,1,1,4.90E-05,886591,0.999989849
21299,33,673,1,1,4.90E-05,886592,0.999990977
28704,571,95,1,1,4.90E-05,886593,0.999992105
28563,699,33,1,1,4.90E-05,886594,0.999993233
28193,12,171,1,1,4.90E-05,886595,0.99999436
28608,103,586,1,1,4.90E-05,886596,0.999995488
28604,178,446,1,1,4.90E-05,886597,0.999996616
27484,114,269,1,1,4.90E-05,886598,0.999997744
27477,475,714,1,1,4.90E-05,886599,0.999998872
27292,427,294,1,1,4.90E-05,886600,1
33653,54,528,0,0,0,886600,1
35363,684,193,0,0,0,886600,1
33456,207,19,0,0,0,886600,1
33403,652,307,0,0,0,886600,1
33461,133,319,0,0,0,886600,1
33455,246,160,0,0,0,886600,1
35231,655,721,0,0,0,886600,1
33401,90,689,0,0,0,886600,1
33450,508,311,0,0,0,886600,1
33462,439,576,0,0,0,886600,1
33410,587,618,0,0,0,886600,1
35233,475,332,0,0,0,886600,1
33457,261,294,0,0,0,886600,1
33652,202,19,0,0,0,886600,1
35365,334,494,0,0,0,886600,1
33673,181,596,0,0,0,886600,1
33676,171,246,0,0,0,886600,1
33459,68,568,0,0,0,886600,1
35228,439,13,0,0,0,886600,1
33454,503,552,0,0,0,886600,1
35366,19,371,0,0,0,886600,1
23540,14,507,0,0,0,886600,1
33679,655,492,0,0,0,886600,1
33404,397,124,0,0,0,886600,1
33650,140,13,0,0,0,886600,1
33680,508,335,0,0,0,886600,1
23546,43,174,0,0,0,886600,1
33405,290,117,0,0,0,886600,1
35339,718,393,0,0,0,886600,1
33651,64,178,0,0,0,886600,1
33458,15,138,0,0,0,886600,1
35364,54,163,0,0,0,886600,1
35216,313,19,0,0,0,886600,1
35219,290,609,0,0,0,886600,1
35230,269,507,0,0,0,886600,1
33678,380,684,0,0,0,886600,1
33460,5,137,0,0,0,886600,1
33428,475,23,0,0,0,886600,1
35340,371,364,0,0,0,886600,1
35352,156,525,0,0,0,886600,1
33425,167,448,0,0,0,886600,1
33434,246,29,0,0,0,886600,1
35351,528,155,0,0,0,886600,1
33660,433,50,0,0,0,886600,1
33435,385,503,0,0,0,886600,1
35350,525,668,0,0,0,886600,1
33659,701,544,0,0,0,886600,1
33424,156,371,0,0,0,886600,1
33423,383,618,0,0,0,886600,1
35349,332,195,0,0,0,886600,1
35358,723,114,0,0,0,886600,1
33437,290,107,0,0,0,886600,1
33438,43,269,0,0,0,886600,1
33666,264,652,0,0,0,886600,1
33421,269,4,0,0,0,886600,1
33667,22,29,0,0,0,886600,1
33658,492,560,0,0,0,886600,1
35357,371,32,0,0,0,886600,1
35356,207,624,0,0,0,886600,1
33449,97,525,0,0,0,886600,1
33433,493,708,0,0,0,886600,1
33662,160,43,0,0,0,886600,1
35355,668,319,0,0,0,886600,1
35224,27,718,0,0,0,886600,1
33429,261,673,0,0,0,886600,1
33430,587,586,0,0,0,886600,1
35354,280,43,0,0,0,886600,1
20047,385,479,0,0,0,886600,1
33431,493,632,0,0,0,886600,1
33661,683,640,0,0,0,886600,1
33427,668,560,0,0,0,886600,1
23504,638,701,0,0,0,886600,1
35353,517,624,0,0,0,886600,1
33432,85,661,0,0,0,886600,1
35226,492,140,0,0,0,886600,1
33663,508,571,0,0,0,886600,1
33664,264,494,0,0,0,886600,1
33665,290,25,0,0,0,886600,1
33420,708,646,0,0,0,886600,1
33668,114,181,0,0,0,886600,1
33669,560,508,0,0,0,886600,1
23501,307,85,0,0,0,886600,1
33442,354,160,0,0,0,886600,1
35362,141,174,0,0,0,886600,1
33654,371,522,0,0,0,886600,1
33444,307,138,0,0,0,886600,1
23100,163,638,0,0,0,886600,1
35343,103,250,0,0,0,886600,1
33445,718,334,0,0,0,886600,1
35342,646,269,0,0,0,886600,1
21171,342,105,0,0,0,886600,1
21176,638,195,0,0,0,886600,1
33446,3,458,0,0,0,886600,1
33447,663,719,0,0,0,886600,1
33448,397,433,0,0,0,886600,1
35220,196,719,0,0,0,886600,1
23531,682,64,0,0,0,886600,1
23533,588,568,0,0,0,886600,1
35341,137,463,0,0,0,886600,1
33414,655,1,0,0,0,886600,1
35361,719,569,0,0,0,886600,1
35344,458,684,0,0,0,886600,1
35223,158,493,0,0,0,886600,1
33419,699,22,0,0,0,886600,1
35359,310,433,0,0,0,886600,1
33440,64,673,0,0,0,886600,1
33418,482,25,0,0,0,886600,1
35360,433,14,0,0,0,886600,1
35348,383,207,0,0,0,886600,1
35347,380,721,0,0,0,886600,1
33417,246,85,0,0,0,886600,1
33415,443,720,0,0,0,886600,1
33670,103,54,0,0,0,886600,1
35222,90,13,0,0,0,886600,1
33657,137,97,0,0,0,886600,1
33656,202,414,0,0,0,886600,1
35346,652,522,0,0,0,886600,1
35345,307,721,0,0,0,886600,1
33655,448,458,0,0,0,886600,1
23492,371,314,0,0,0,886600,1
33569,174,332,0,0,0,886600,1
33463,652,295,0,0,0,886600,1
33645,97,19,0,0,0,886600,1
23232,626,20,0,0,0,886600,1
33534,64,668,0,0,0,886600,1
33535,507,319,0,0,0,886600,1
35302,80,371,0,0,0,886600,1
35266,145,446,0,0,0,886600,1
35267,446,138,0,0,0,886600,1
33536,48,137,0,0,0,886600,1
35301,14,124,0,0,0,886600,1
35268,720,130,0,0,0,886600,1
35269,404,576,0,0,0,886600,1
35270,163,511,0,0,0,886600,1
35271,448,502,0,0,0,886600,1
33538,195,605,0,0,0,886600,1
33539,458,586,0,0,0,886600,1
35272,661,196,0,0,0,886600,1
23348,632,181,0,0,0,886600,1
23347,383,508,0,0,0,886600,1
35273,576,219,0,0,0,886600,1
33542,364,207,0,0,0,886600,1
35274,224,371,0,0,0,886600,1
23256,264,392,0,0,0,886600,1
35300,290,613,0,0,0,886600,1
23258,314,721,0,0,0,886600,1
33533,605,342,0,0,0,886600,1
35265,130,494,0,0,0,886600,1
33532,718,34,0,0,0,886600,1
35308,394,160,0,0,0,886600,1
35259,250,699,0,0,0,886600,1
33604,33,371,0,0,0,886600,1
33603,494,347,0,0,0,886600,1
23369,265,30,0,0,0,886600,1
21094,347,404,0,0,0,886600,1
23362,160,264,0,0,0,886600,1
33523,236,433,0,0,0,886600,1
33524,652,280,0,0,0,886600,1
35260,655,494,0,0,0,886600,1
33525,174,181,0,0,0,886600,1
17695,4,492,0,0,0,886600,1
33531,502,178,0,0,0,886600,1
33601,22,668,0,0,0,886600,1
35307,613,458,0,0,0,886600,1
35306,719,4,0,0,0,886600,1
33599,503,163,0,0,0,886600,1
33528,668,626,0,0,0,886600,1
35263,614,448,0,0,0,886600,1
33529,68,494,0,0,0,886600,1
23353,274,261,0,0,0,886600,1
35303,723,663,0,0,0,886600,1
35264,392,383,0,0,0,886600,1
33543,269,409,0,0,0,886600,1
33587,246,673,0,0,0,886600,1
35299,379,458,0,0,0,886600,1
33563,433,32,0,0,0,886600,1
23297,414,503,0,0,0,886600,1
35289,392,543,0,0,0,886600,1
35280,511,720,0,0,0,886600,1
23293,493,95,0,0,0,886600,1
33575,717,562,0,0,0,886600,1
33574,525,701,0,0,0,886600,1
35288,571,663,0,0,0,886600,1
35287,525,13,0,0,0,886600,1
33562,701,661,0,0,0,886600,1
35286,294,19,0,0,0,886600,1
33573,137,31,0,0,0,886600,1
35290,207,242,0,0,0,886600,1
23290,614,90,0,0,0,886600,1
23288,164,640,0,0,0,886600,1
33572,54,181,0,0,0,886600,1
35281,160,20,0,0,0,886600,1
35285,508,475,0,0,0,886600,1
23275,85,517,0,0,0,886600,1
35284,23,64,0,0,0,886600,1
35282,95,719,0,0,0,886600,1
35283,624,393,0,0,0,886600,1
33568,721,613,0,0,0,886600,1
33556,137,367,0,0,0,886600,1
35291,718,689,0,0,0,886600,1
35275,342,140,0,0,0,886600,1
35296,397,257,0,0,0,886600,1
33545,640,409,0,0,0,886600,1
23342,163,674,0,0,0,886600,1
23341,562,193,0,0,0,886600,1
35276,25,446,0,0,0,886600,1
33585,427,133,0,0,0,886600,1
35277,482,290,0,0,0,886600,1
33548,158,137,0,0,0,886600,1
33549,22,246,0,0,0,886600,1
35367,332,174,0,0,0,886600,1
35297,719,613,0,0,0,886600,1
35295,475,138,0,0,0,886600,1
35279,50,593,0,0,0,886600,1
35294,84,684,0,0,0,886600,1
23329,507,683,0,0,0,886600,1
35292,708,458,0,0,0,886600,1
33582,195,514,0,0,0,886600,1
33553,684,242,0,0,0,886600,1
33581,517,261,0,0,0,886600,1
33580,609,137,0,0,0,886600,1
33579,117,494,0,0,0,886600,1
33578,718,414,0,0,0,886600,1
35278,23,605,0,0,0,886600,1
33605,714,463,0,0,0,886600,1
33606,576,117,0,0,0,886600,1
35311,56,721,0,0,0,886600,1
33632,632,493,0,0,0,886600,1
23146,394,137,0,0,0,886600,1
23154,34,4,0,0,0,886600,1
35241,494,652,0,0,0,886600,1
33484,433,33,0,0,0,886600,1
33635,137,64,0,0,0,886600,1
33485,175,614,0,0,0,886600,1
23155,529,54,0,0,0,886600,1
33633,626,367,0,0,0,886600,1
33487,640,525,0,0,0,886600,1
20153,511,155,0,0,0,886600,1
35328,718,84,0,0,0,886600,1
23445,448,68,0,0,0,886600,1
33488,23,593,0,0,0,886600,1
23156,498,246,0,0,0,886600,1
33489,294,264,0,0,0,886600,1
35243,492,269,0,0,0,886600,1
33490,64,243,0,0,0,886600,1
35327,30,342,0,0,0,886600,1
33629,398,103,0,0,0,886600,1
35326,167,246,0,0,0,886600,1
23171,141,26,0,0,0,886600,1
21140,640,246,0,0,0,886600,1
35240,243,175,0,0,0,886600,1
35239,439,494,0,0,0,886600,1
33494,587,560,0,0,0,886600,1
33471,195,274,0,0,0,886600,1
33465,502,181,0,0,0,886600,1
35234,328,290,0,0,0,886600,1
33466,383,684,0,0,0,886600,1
35235,661,392,0,0,0,886600,1
20178,503,588,0,0,0,886600,1
33467,723,56,0,0,0,886600,1
23462,576,353,0,0,0,886600,1
17537,393,30,0,0,0,886600,1
21049,32,493,0,0,0,886600,1
21055,160,394,0,0,0,886600,1
33472,137,9,0,0,0,886600,1
35238,593,492,0,0,0,886600,1
33642,19,613,0,0,0,886600,1
33473,571,708,0,0,0,886600,1
33474,701,85,0,0,0,886600,1
33475,97,503,0,0,0,886600,1
21061,532,193,0,0,0,886600,1
35236,137,25,0,0,0,886600,1
33478,446,178,0,0,0,886600,1
33479,560,174,0,0,0,886600,1
23446,482,353,0,0,0,886600,1
33641,587,632,0,0,0,886600,1
35246,261,207,0,0,0,886600,1
35325,714,274,0,0,0,886600,1
35312,446,525,0,0,0,886600,1
33512,508,313,0,0,0,886600,1
33617,394,13,0,0,0,886600,1
33507,167,576,0,0,0,886600,1
33616,26,19,0,0,0,886600,1
33508,280,668,0,0,0,886600,1
33615,30,163,0,0,0,886600,1
35315,138,261,0,0,0,886600,1
35253,525,624,0,0,0,886600,1
33509,294,514,0,0,0,886600,1
33510,19,652,0,0,0,886600,1
35254,507,138,0,0,0,886600,1
33513,721,5,0,0,0,886600,1
23409,33,163,0,0,0,886600,1
35314,269,689,0,0,0,886600,1
35255,269,482,0,0,0,886600,1
35256,529,342,0,0,0,886600,1
33613,652,528,0,0,0,886600,1
33612,332,661,0,0,0,886600,1
35257,178,458,0,0,0,886600,1
23205,714,26,0,0,0,886600,1
35258,22,290,0,0,0,886600,1
33608,163,661,0,0,0,886600,1
33607,137,15,0,0,0,886600,1
33618,137,32,0,0,0,886600,1
35252,640,626,0,0,0,886600,1
35247,170,609,0,0,0,886600,1
35249,640,494,0,0,0,886600,1
33496,181,609,0,0,0,886600,1
35324,170,433,0,0,0,886600,1
33497,29,163,0,0,0,886600,1
35323,576,130,0,0,0,886600,1
33498,22,364,0,0,0,886600,1
35248,718,498,0,0,0,886600,1
35322,717,331,0,0,0,886600,1
33499,31,269,0,0,0,886600,1
33500,31,409,0,0,0,886600,1
33624,342,497,0,0,0,886600,1
33502,274,668,0,0,0,886600,1
35251,398,719,0,0,0,886600,1
35321,458,640,0,0,0,886600,1
35320,141,133,0,0,0,886600,1
33621,178,202,0,0,0,886600,1
35319,95,525,0,0,0,886600,1
33620,708,721,0,0,0,886600,1
35318,379,719,0,0,0,886600,1
33619,661,501,0,0,0,886600,1
35250,280,448,0,0,0,886600,1
35317,571,310,0,0,0,886600,1
33505,508,48,0,0,0,886600,1
33400,661,383,0,0,0,886600,1
33294,571,354,0,0,0,886600,1
33399,433,353,0,0,0,886600,1
33045,141,196,0,0,0,886600,1
33053,103,511,0,0,0,886600,1
33052,482,392,0,0,0,886600,1
35524,448,719,0,0,0,886600,1
33050,699,501,0,0,0,886600,1
35525,568,195,0,0,0,886600,1
33048,334,371,0,0,0,886600,1
33044,492,204,0,0,0,886600,1
33055,164,294,0,0,0,886600,1
33043,508,107,0,0,0,886600,1
35526,699,562,0,0,0,886600,1
23912,264,682,0,0,0,886600,1
33039,294,107,0,0,0,886600,1
33038,163,195,0,0,0,886600,1
33037,507,269,0,0,0,886600,1
33054,367,178,0,0,0,886600,1
33056,202,290,0,0,0,886600,1
20720,138,334,0,0,0,886600,1
33066,178,236,0,0,0,886600,1
33072,103,646,0,0,0,886600,1
33071,392,618,0,0,0,886600,1
33070,609,571,0,0,0,886600,1
33069,492,126,0,0,0,886600,1
33068,587,397,0,0,0,886600,1
35519,414,202,0,0,0,886600,1
33065,290,448,0,0,0,886600,1
35523,307,718,0,0,0,886600,1
33064,383,138,0,0,0,886600,1
33062,171,19,0,0,0,886600,1
33061,202,385,0,0,0,886600,1
35521,624,714,0,0,0,886600,1
35522,443,124,0,0,0,886600,1
33058,167,535,0,0,0,886600,1
33036,652,131,0,0,0,886600,1
33035,158,392,0,0,0,886600,1
35368,290,497,0,0,0,886600,1
33008,652,25,0,0,0,886600,1
33014,508,535,0,0,0,886600,1
33013,544,587,0,0,0,886600,1
33011,294,364,0,0,0,886600,1
33010,717,720,0,0,0,886600,1
35530,54,714,0,0,0,886600,1
33009,511,569,0,0,0,886600,1
33006,160,479,0,0,0,886600,1
33017,19,626,0,0,0,886600,1
33005,392,673,0,0,0,886600,1
33004,458,661,0,0,0,886600,1
33003,661,140,0,0,0,886600,1
33002,25,624,0,0,0,886600,1
35532,202,250,0,0,0,886600,1
32999,683,332,0,0,0,886600,1
23951,544,528,0,0,0,886600,1
23950,458,394,0,0,0,886600,1
33034,342,439,0,0,0,886600,1
33027,448,439,0,0,0,886600,1
23917,164,479,0,0,0,886600,1
33032,269,663,0,0,0,886600,1
35528,569,498,0,0,0,886600,1
33031,261,458,0,0,0,886600,1
33030,181,155,0,0,0,886600,1
33028,502,175,0,0,0,886600,1
33026,310,19,0,0,0,886600,1
35529,439,181,0,0,0,886600,1
33025,54,614,0,0,0,886600,1
23934,4,543,0,0,0,886600,1
33023,158,19,0,0,0,886600,1
33022,367,175,0,0,0,886600,1
23939,720,443,0,0,0,886600,1
23947,586,482,0,0,0,886600,1
23868,638,448,0,0,0,886600,1
33075,708,571,0,0,0,886600,1
33076,393,257,0,0,0,886600,1
33117,353,492,0,0,0,886600,1
23790,493,475,0,0,0,886600,1
23797,257,314,0,0,0,886600,1
23799,383,85,0,0,0,886600,1
33120,257,552,0,0,0,886600,1
33119,701,508,0,0,0,886600,1
33118,269,30,0,0,0,886600,1
33116,332,624,0,0,0,886600,1
33127,85,22,0,0,0,886600,1
33113,160,503,0,0,0,886600,1
33112,482,404,0,0,0,886600,1
33111,68,433,0,0,0,886600,1
33110,720,155,0,0,0,886600,1
33109,458,683,0,0,0,886600,1
33108,439,383,0,0,0,886600,1
33125,160,56,0,0,0,886600,1
20404,43,385,0,0,0,886600,1
33078,433,535,0,0,0,886600,1
33144,443,174,0,0,0,886600,1
33150,525,261,0,0,0,886600,1
33149,6,137,0,0,0,886600,1
20828,170,32,0,0,0,886600,1
23753,265,171,0,0,0,886600,1
33146,137,158,0,0,0,886600,1
33145,446,614,0,0,0,886600,1
20393,307,683,0,0,0,886600,1
23768,137,353,0,0,0,886600,1
23754,613,385,0,0,0,886600,1
35486,398,175,0,0,0,886600,1
33141,427,494,0,0,0,886600,1
33140,141,12,0,0,0,886600,1
17225,4,560,0,0,0,886600,1
33133,689,701,0,0,0,886600,1
33107,364,433,0,0,0,886600,1
33106,493,140,0,0,0,886600,1
33104,626,158,0,0,0,886600,1
35514,137,638,0,0,0,886600,1
35512,138,269,0,0,0,886600,1
33089,257,525,0,0,0,886600,1
23843,181,471,0,0,0,886600,1
33087,202,265,0,0,0,886600,1
33086,414,720,0,0,0,886600,1
17110,30,265,0,0,0,886600,1
33084,699,364,0,0,0,886600,1
23808,133,503,0,0,0,886600,1
35515,371,117,0,0,0,886600,1
33082,25,43,0,0,0,886600,1
35516,158,43,0,0,0,886600,1
35517,181,652,0,0,0,886600,1
35518,439,174,0,0,0,886600,1
33079,207,202,0,0,0,886600,1
33091,640,493,0,0,0,886600,1
33092,661,133,0,0,0,886600,1
35511,661,525,0,0,0,886600,1
33093,54,494,0,0,0,886600,1
20745,105,160,0,0,0,886600,1
33094,202,181,0,0,0,886600,1
35509,364,261,0,0,0,886600,1
35508,181,508,0,0,0,886600,1
35506,661,114,0,0,0,886600,1
35505,714,511,0,0,0,886600,1
33095,219,138,0,0,0,886600,1
23838,313,319,0,0,0,886600,1
35501,596,124,0,0,0,886600,1
23836,605,507,0,0,0,886600,1
35500,508,414,0,0,0,886600,1
20774,164,3,0,0,0,886600,1
23809,682,126,0,0,0,886600,1
35534,30,494,0,0,0,886600,1
32997,392,126,0,0,0,886600,1
23970,587,552,0,0,0,886600,1
35566,29,448,0,0,0,886600,1
24133,31,117,0,0,0,886600,1
35561,202,571,0,0,0,886600,1
35563,85,446,0,0,0,886600,1
20664,708,562,0,0,0,886600,1
35565,718,56,0,0,0,886600,1
32892,141,614,0,0,0,886600,1
20661,522,626,0,0,0,886600,1
35560,290,236,0,0,0,886600,1
32890,493,668,0,0,0,886600,1
24135,543,683,0,0,0,886600,1
32888,85,68,0,0,0,886600,1
35570,145,717,0,0,0,886600,1
32887,544,246,0,0,0,886600,1
20635,5,19,0,0,0,886600,1
32895,22,371,0,0,0,886600,1
24125,497,683,0,0,0,886600,1
32921,246,714,0,0,0,886600,1
24099,701,354,0,0,0,886600,1
24079,16,138,0,0,0,886600,1
32917,624,493,0,0,0,886600,1
32916,560,48,0,0,0,886600,1
35558,655,433,0,0,0,886600,1
24095,117,640,0,0,0,886600,1
32913,497,525,0,0,0,886600,1
32909,498,717,0,0,0,886600,1
24114,624,274,0,0,0,886600,1
32907,19,23,0,0,0,886600,1
24109,586,5,0,0,0,886600,1
24111,494,663,0,0,0,886600,1
32903,498,494,0,0,0,886600,1
32902,587,482,0,0,0,886600,1
32901,684,171,0,0,0,886600,1
32886,443,202,0,0,0,886600,1
35574,126,723,0,0,0,886600,1
32885,54,508,0,0,0,886600,1
35580,720,364,0,0,0,886600,1
32866,22,571,0,0,0,886600,1
32864,543,458,0,0,0,886600,1
32863,30,717,0,0,0,886600,1
32861,684,655,0,0,0,886600,1
24152,503,77,0,0,0,886600,1
32859,133,624,0,0,0,886600,1
35581,265,525,0,0,0,886600,1
32884,14,458,0,0,0,886600,1
20623,682,708,0,0,0,886600,1
24160,195,26,0,0,0,886600,1
32855,257,31,0,0,0,886600,1
35583,332,1,0,0,0,886600,1
32853,661,5,0,0,0,886600,1
32852,383,181,0,0,0,886600,1
32867,492,514,0,0,0,886600,1
32869,29,661,0,0,0,886600,1
32870,269,319,0,0,0,886600,1
32871,124,586,0,0,0,886600,1
35577,723,295,0,0,0,886600,1
24138,342,230,0,0,0,886600,1
32873,718,77,0,0,0,886600,1
32874,514,721,0,0,0,886600,1
32875,178,117,0,0,0,886600,1
32876,560,501,0,0,0,886600,1
32877,257,145,0,0,0,886600,1
32878,661,117,0,0,0,886600,1
32879,587,383,0,0,0,886600,1
32880,290,569,0,0,0,886600,1
32881,257,121,0,0,0,886600,1
32882,170,117,0,0,0,886600,1
32883,587,535,0,0,0,886600,1
32920,701,682,0,0,0,886600,1
32922,274,342,0,0,0,886600,1
35535,195,342,0,0,0,886600,1
20688,494,393,0,0,0,886600,1
32973,508,674,0,0,0,886600,1
32972,683,195,0,0,0,886600,1
32971,661,409,0,0,0,886600,1
35540,723,246,0,0,0,886600,1
32970,683,569,0,0,0,886600,1
35541,569,313,0,0,0,886600,1
35543,383,174,0,0,0,886600,1
32975,723,397,0,0,0,886600,1
35544,392,587,0,0,0,886600,1
32968,160,269,0,0,0,886600,1
32966,503,269,0,0,0,886600,1
32965,525,646,0,0,0,886600,1
32964,121,714,0,0,0,886600,1
35546,605,19,0,0,0,886600,1
32974,571,544,0,0,0,886600,1
24001,673,593,0,0,0,886600,1
32923,699,475,0,0,0,886600,1
32985,261,137,0,0,0,886600,1
23975,652,68,0,0,0,886600,1
20517,609,85,0,0,0,886600,1
32992,311,576,0,0,0,886600,1
23980,354,525,0,0,0,886600,1
23996,31,22,0,0,0,886600,1
32986,170,529,0,0,0,886600,1
32984,720,535,0,0,0,886600,1
32977,717,103,0,0,0,886600,1
32983,624,85,0,0,0,886600,1
32982,689,568,0,0,0,886600,1
32981,155,328,0,0,0,886600,1
32980,652,50,0,0,0,886600,1
32979,64,624,0,0,0,886600,1
32978,385,13,0,0,0,886600,1
32963,181,26,0,0,0,886600,1
32962,409,54,0,0,0,886600,1
32961,167,587,0,0,0,886600,1
35551,492,552,0,0,0,886600,1
32941,560,689,0,0,0,886600,1
24034,522,668,0,0,0,886600,1
32939,652,107,0,0,0,886600,1
32938,342,587,0,0,0,886600,1
32937,614,332,0,0,0,886600,1
35550,463,701,0,0,0,886600,1
35552,433,502,0,0,0,886600,1
32960,661,156,0,0,0,886600,1
32931,54,158,0,0,0,886600,1
35554,508,97,0,0,0,886600,1
35555,195,562,0,0,0,886600,1
35556,684,5,0,0,0,886600,1
24075,133,514,0,0,0,886600,1
32924,371,3,0,0,0,886600,1
32942,560,274,0,0,0,886600,1
24031,379,720,0,0,0,886600,1
32944,717,25,0,0,0,886600,1
32945,294,443,0,0,0,886600,1
35549,463,624,0,0,0,886600,1
32947,701,107,0,0,0,886600,1
32948,156,668,0,0,0,886600,1
32949,661,178,0,0,0,886600,1
35548,54,409,0,0,0,886600,1
35547,167,482,0,0,0,886600,1
32953,652,497,0,0,0,886600,1
32954,64,130,0,0,0,886600,1
32955,479,568,0,0,0,886600,1
32956,593,618,0,0,0,886600,1
32957,414,458,0,0,0,886600,1
32958,5,701,0,0,0,886600,1
32959,174,682,0,0,0,886600,1
20840,514,646,0,0,0,886600,1
35480,140,103,0,0,0,886600,1
23744,163,170,0,0,0,886600,1
35398,195,448,0,0,0,886600,1
33322,195,528,0,0,0,886600,1
33321,701,514,0,0,0,886600,1
33320,219,568,0,0,0,886600,1
33319,130,626,0,0,0,886600,1
33318,160,193,0,0,0,886600,1
33317,699,689,0,0,0,886600,1
33316,493,137,0,0,0,886600,1
33323,77,257,0,0,0,886600,1
33315,394,717,0,0,0,886600,1
33314,383,171,0,0,0,886600,1
33313,175,433,0,0,0,886600,1
23573,133,587,0,0,0,886600,1
20992,133,543,0,0,0,886600,1
35400,568,4,0,0,0,886600,1
20221,95,683,0,0,0,886600,1
33324,29,280,0,0,0,886600,1
33337,22,525,0,0,0,886600,1
23571,90,107,0,0,0,886600,1
35390,409,383,0,0,0,886600,1
35391,689,721,0,0,0,886600,1
33335,708,525,0,0,0,886600,1
33334,529,2,0,0,0,886600,1
35392,569,31,0,0,0,886600,1
33333,269,364,0,0,0,886600,1
33331,684,138,0,0,0,886600,1
35396,703,663,0,0,0,886600,1
23572,133,507,0,0,0,886600,1
33329,409,587,0,0,0,886600,1
33328,90,661,0,0,0,886600,1
33327,703,535,0,0,0,886600,1
33326,714,328,0,0,0,886600,1
33325,392,156,0,0,0,886600,1
33310,508,14,0,0,0,886600,1
35401,64,614,0,0,0,886600,1
33309,54,448,0,0,0,886600,1
33287,632,668,0,0,0,886600,1
33293,290,280,0,0,0,886600,1
23600,331,668,0,0,0,886600,1
33291,718,243,0,0,0,886600,1
23601,393,23,0,0,0,886600,1
33289,392,552,0,0,0,886600,1
33288,646,2,0,0,0,886600,1
33286,95,493,0,0,0,886600,1
33308,269,90,0,0,0,886600,1
33285,514,673,0,0,0,886600,1
35413,294,398,0,0,0,886600,1
33283,383,103,0,0,0,886600,1
33282,723,544,0,0,0,886600,1
35416,397,175,0,0,0,886600,1
35417,80,290,0,0,0,886600,1
33682,348,626,0,0,0,886600,1
33295,30,392,0,0,0,886600,1
35409,723,302,0,0,0,886600,1
23582,605,140,0,0,0,886600,1
33297,719,494,0,0,0,886600,1
23581,138,367,0,0,0,886600,1
23580,174,443,0,0,0,886600,1
33300,195,25,0,0,0,886600,1
33301,708,576,0,0,0,886600,1
33303,11,43,0,0,0,886600,1
33304,473,721,0,0,0,886600,1
33305,170,64,0,0,0,886600,1
35404,482,529,0,0,0,886600,1
35403,204,613,0,0,0,886600,1
33306,181,107,0,0,0,886600,1
33307,64,274,0,0,0,886600,1
20988,164,174,0,0,0,886600,1
35389,121,246,0,0,0,886600,1
33338,714,158,0,0,0,886600,1
35420,124,261,0,0,0,886600,1
33377,448,246,0,0,0,886600,1
33383,562,178,0,0,0,886600,1
33382,562,458,0,0,0,886600,1
33381,511,492,0,0,0,886600,1
33380,114,701,0,0,0,886600,1
33379,544,409,0,0,0,886600,1
33378,193,719,0,0,0,886600,1
33375,85,32,0,0,0,886600,1
33385,492,493,0,0,0,886600,1
33374,458,103,0,0,0,886600,1
33373,90,683,0,0,0,886600,1
33372,517,501,0,0,0,886600,1
33371,511,294,0,0,0,886600,1
23558,311,178,0,0,0,886600,1
33369,714,11,0,0,0,886600,1
17438,379,261,0,0,0,886600,1
33386,250,43,0,0,0,886600,1
33339,294,114,0,0,0,886600,1
33394,371,54,0,0,0,886600,1
35369,207,492,0,0,0,886600,1
33397,409,64,0,0,0,886600,1
35370,13,207,0,0,0,886600,1
33396,439,433,0,0,0,886600,1
35371,397,137,0,0,0,886600,1
33395,43,90,0,0,0,886600,1
33393,12,568,0,0,0,886600,1
33387,10,576,0,0,0,886600,1
35373,448,427,0,0,0,886600,1
33392,124,250,0,0,0,886600,1
33391,250,448,0,0,0,886600,1
33390,332,571,0,0,0,886600,1
33389,25,13,0,0,0,886600,1
33388,448,140,0,0,0,886600,1
35378,507,85,0,0,0,886600,1
33368,90,31,0,0,0,886600,1
33367,114,446,0,0,0,886600,1
33347,433,310,0,0,0,886600,1
33352,117,618,0,0,0,886600,1
35387,26,701,0,0,0,886600,1
33351,661,1,0,0,0,886600,1
33350,25,175,0,0,0,886600,1
33349,699,682,0,0,0,886600,1
33348,181,219,0,0,0,886600,1
33346,353,181,0,0,0,886600,1
33366,587,56,0,0,0,886600,1
33345,618,493,0,0,0,886600,1
23562,638,12,0,0,0,886600,1
23563,498,569,0,0,0,886600,1
33342,605,525,0,0,0,886600,1
33341,175,394,0,0,0,886600,1
33340,498,90,0,0,0,886600,1
33353,682,720,0,0,0,886600,1
35386,596,719,0,0,0,886600,1
33354,638,525,0,0,0,886600,1
33355,257,398,0,0,0,886600,1
35384,652,219,0,0,0,886600,1
33356,562,576,0,0,0,886600,1
33357,723,6,0,0,0,886600,1
33358,175,121,0,0,0,886600,1
33359,392,661,0,0,0,886600,1
33360,708,392,0,0,0,886600,1
35381,682,174,0,0,0,886600,1
33361,439,342,0,0,0,886600,1
33362,609,720,0,0,0,886600,1
23560,721,12,0,0,0,886600,1
33364,448,433,0,0,0,886600,1
35380,195,77,0,0,0,886600,1
33365,609,294,0,0,0,886600,1
33280,482,243,0,0,0,886600,1
33278,242,85,0,0,0,886600,1
35478,137,348,0,0,0,886600,1
23694,6,503,0,0,0,886600,1
33195,552,332,0,0,0,886600,1
33194,458,593,0,0,0,886600,1
33193,181,33,0,0,0,886600,1
33192,167,646,0,0,0,886600,1
33191,85,141,0,0,0,886600,1
33190,718,475,0,0,0,886600,1
33188,242,90,0,0,0,886600,1
33197,718,19,0,0,0,886600,1
23700,593,23,0,0,0,886600,1
33186,294,22,0,0,0,886600,1
33185,714,673,0,0,0,886600,1
33184,23,371,0,0,0,886600,1
33183,626,307,0,0,0,886600,1
33182,246,605,0,0,0,886600,1
33196,371,243,0,0,0,886600,1
33199,683,714,0,0,0,886600,1
33217,155,502,0,0,0,886600,1
33209,140,137,0,0,0,886600,1
33215,137,310,0,0,0,886600,1
33214,133,721,0,0,0,886600,1
23683,652,80,0,0,0,886600,1
20908,15,261,0,0,0,886600,1
35451,568,605,0,0,0,886600,1
33210,543,576,0,0,0,886600,1
33208,164,246,0,0,0,886600,1
33200,23,364,0,0,0,886600,1
33206,290,552,0,0,0,886600,1
33205,714,264,0,0,0,886600,1
33204,265,433,0,0,0,886600,1
33203,117,175,0,0,0,886600,1
33202,568,193,0,0,0,886600,1
33201,68,160,0,0,0,886600,1
33181,181,167,0,0,0,886600,1
35453,673,719,0,0,0,886600,1
35454,613,562,0,0,0,886600,1
35470,525,156,0,0,0,886600,1
33169,638,43,0,0,0,886600,1
33168,703,497,0,0,0,886600,1
35467,493,34,0,0,0,886600,1
33166,560,195,0,0,0,886600,1
33165,714,117,0,0,0,886600,1
33163,371,655,0,0,0,886600,1
23717,682,632,0,0,0,886600,1
33180,508,280,0,0,0,886600,1
35472,29,23,0,0,0,886600,1
23729,29,290,0,0,0,886600,1
35474,11,624,0,0,0,886600,1
35476,571,48,0,0,0,886600,1
33155,552,160,0,0,0,886600,1
23741,264,543,0,0,0,886600,1
33170,587,130,0,0,0,886600,1
33171,560,30,0,0,0,886600,1
33172,684,482,0,0,0,886600,1
35464,596,160,0,0,0,886600,1
35463,13,514,0,0,0,886600,1
33173,207,103,0,0,0,886600,1
33174,576,311,0,0,0,886600,1
20901,482,48,0,0,0,886600,1
35461,257,171,0,0,0,886600,1
35460,5,433,0,0,0,886600,1
33176,50,701,0,0,0,886600,1
35459,140,202,0,0,0,886600,1
23703,646,95,0,0,0,886600,1
35458,163,97,0,0,0,886600,1
35457,398,90,0,0,0,886600,1
35456,29,90,0,0,0,886600,1
35455,652,586,0,0,0,886600,1
23680,307,4,0,0,0,886600,1
33218,701,404,0,0,0,886600,1
35421,34,668,0,0,0,886600,1
35432,204,717,0,0,0,886600,1
35430,133,2,0,0,0,886600,1
35431,155,13,0,0,0,886600,1
33257,163,364,0,0,0,886600,1
33256,160,552,0,0,0,886600,1
23636,269,335,0,0,0,886600,1
33254,409,1,0,0,0,886600,1
33252,701,163,0,0,0,886600,1
33260,121,494,0,0,0,886600,1
33251,571,640,0,0,0,886600,1
35433,126,158,0,0,0,886600,1
33249,463,202,0,0,0,886600,1
33248,493,507,0,0,0,886600,1
35434,718,502,0,0,0,886600,1
35435,409,632,0,0,0,886600,1
33259,261,684,0,0,0,886600,1
23626,392,6,0,0,0,886600,1
33219,196,493,0,0,0,886600,1
33270,718,219,0,0,0,886600,1
33277,29,19,0,0,0,886600,1
33276,20,342,0,0,0,886600,1
33275,543,246,0,0,0,886600,1
33274,720,4,0,0,0,886600,1
35423,529,178,0,0,0,886600,1
33273,613,12,0,0,0,886600,1
33269,684,652,0,0,0,886600,1
35427,160,261,0,0,0,886600,1
20918,529,97,0,0,0,886600,1
23623,141,123,0,0,0,886600,1
33267,544,699,0,0,0,886600,1
33266,714,596,0,0,0,886600,1
23624,683,48,0,0,0,886600,1
33264,10,160,0,0,0,886600,1
23653,290,3,0,0,0,886600,1
33244,181,443,0,0,0,886600,1
35436,43,23,0,0,0,886600,1
33226,626,29,0,0,0,886600,1
35447,230,342,0,0,0,886600,1
33231,618,90,0,0,0,886600,1
33230,482,525,0,0,0,886600,1
33229,383,290,0,0,0,886600,1
33228,204,261,0,0,0,886600,1
33227,714,528,0,0,0,886600,1
33225,652,1,0,0,0,886600,1
33242,569,2,0,0,0,886600,1
33224,493,12,0,0,0,886600,1
33223,699,126,0,0,0,886600,1
33222,156,646,0,0,0,886600,1
35448,332,138,0,0,0,886600,1
35449,683,155,0,0,0,886600,1
33220,646,332,0,0,0,886600,1
35446,171,684,0,0,0,886600,1
35445,684,392,0,0,0,886600,1
35444,242,668,0,0,0,886600,1
33234,458,571,0,0,0,886600,1
35443,525,684,0,0,0,886600,1
35442,414,446,0,0,0,886600,1
35441,568,385,0,0,0,886600,1
33235,204,12,0,0,0,886600,1
35440,43,720,0,0,0,886600,1
33236,2,332,0,0,0,886600,1
33237,160,652,0,0,0,886600,1
33238,723,655,0,0,0,886600,1
35439,250,103,0,0,0,886600,1
35438,514,720,0,0,0,886600,1
23662,311,43,0,0,0,886600,1
33241,290,274,0,0,0,886600,1
35437,723,347,0,0,0,886600,1
23067,394,155,0,0,0,886600,1
33825,646,525,0,0,0,886600,1
33683,257,652,0,0,0,886600,1
34420,6,668,0,0,0,886600,1
34418,170,714,0,0,0,886600,1
21580,443,569,0,0,0,886600,1
22198,529,593,0,0,0,886600,1
34921,587,171,0,0,0,886600,1
34416,502,90,0,0,0,886600,1
34922,64,269,0,0,0,886600,1
34923,409,25,0,0,0,886600,1
34413,175,167,0,0,0,886600,1
34412,50,138,0,0,0,886600,1
34410,655,181,0,0,0,886600,1
34925,31,43,0,0,0,886600,1
34408,131,160,0,0,0,886600,1
34407,409,503,0,0,0,886600,1
34406,714,708,0,0,0,886600,1
22215,720,638,0,0,0,886600,1
34419,90,475,0,0,0,886600,1
22197,207,544,0,0,0,886600,1
34403,313,717,0,0,0,886600,1
34422,674,342,0,0,0,886600,1
34435,163,160,0,0,0,886600,1
22186,471,571,0,0,0,886600,1
34914,701,114,0,0,0,886600,1
22193,720,64,0,0,0,886600,1
34430,492,319,0,0,0,886600,1
34429,371,683,0,0,0,886600,1
34915,718,394,0,0,0,886600,1
34428,138,493,0,0,0,886600,1
34917,703,193,0,0,0,886600,1
34918,133,332,0,0,0,886600,1
34427,392,319,0,0,0,886600,1
34426,26,290,0,0,0,886600,1
34425,181,34,0,0,0,886600,1
34424,103,371,0,0,0,886600,1
34423,137,427,0,0,0,886600,1
34404,433,193,0,0,0,886600,1
34402,4,342,0,0,0,886600,1
34367,85,158,0,0,0,886600,1
34382,414,433,0,0,0,886600,1
34930,613,409,0,0,0,886600,1
34380,261,618,0,0,0,886600,1
34931,493,126,0,0,0,886600,1
34379,613,501,0,0,0,886600,1
34378,178,576,0,0,0,886600,1
34376,532,371,0,0,0,886600,1
34375,720,164,0,0,0,886600,1
34932,714,50,0,0,0,886600,1
34373,170,5,0,0,0,886600,1
34372,511,103,0,0,0,886600,1
34371,294,11,0,0,0,886600,1
34933,652,121,0,0,0,886600,1
34934,497,175,0,0,0,886600,1
34370,334,446,0,0,0,886600,1
34369,48,721,0,0,0,886600,1
34381,717,155,0,0,0,886600,1
34383,64,458,0,0,0,886600,1
19656,708,264,0,0,0,886600,1
34384,720,307,0,0,0,886600,1
34400,568,638,0,0,0,886600,1
34399,290,439,0,0,0,886600,1
21567,609,156,0,0,0,886600,1
34397,90,207,0,0,0,886600,1
34396,138,544,0,0,0,886600,1
34395,576,475,0,0,0,886600,1
34394,294,560,0,0,0,886600,1
34393,655,525,0,0,0,886600,1
34392,471,684,0,0,0,886600,1
34391,342,655,0,0,0,886600,1
34390,568,246,0,0,0,886600,1
34389,6,717,0,0,0,886600,1
34388,414,684,0,0,0,886600,1
34386,684,12,0,0,0,886600,1
34385,141,479,0,0,0,886600,1
34913,250,193,0,0,0,886600,1
34436,383,701,0,0,0,886600,1
22182,385,543,0,0,0,886600,1
21631,261,439,0,0,0,886600,1
22115,721,471,0,0,0,886600,1
34488,699,20,0,0,0,886600,1
34487,718,560,0,0,0,886600,1
34486,364,175,0,0,0,886600,1
34485,529,668,0,0,0,886600,1
21627,383,682,0,0,0,886600,1
34484,371,219,0,0,0,886600,1
34483,145,719,0,0,0,886600,1
34482,439,525,0,0,0,886600,1
19615,4,2,0,0,0,886600,1
34480,137,332,0,0,0,886600,1
21611,494,56,0,0,0,886600,1
34476,33,719,0,0,0,886600,1
34475,568,331,0,0,0,886600,1
34473,699,5,0,0,0,886600,1
19592,605,307,0,0,0,886600,1
34491,13,269,0,0,0,886600,1
34912,433,517,0,0,0,886600,1
34492,137,243,0,0,0,886600,1
34879,257,32,0,0,0,886600,1
34510,718,313,0,0,0,886600,1
34880,97,720,0,0,0,886600,1
34507,717,242,0,0,0,886600,1
34505,141,171,0,0,0,886600,1
34504,385,126,0,0,0,886600,1
34884,525,652,0,0,0,886600,1
34502,2,624,0,0,0,886600,1
34500,682,576,0,0,0,886600,1
34499,250,257,0,0,0,886600,1
22099,264,22,0,0,0,886600,1
34497,385,701,0,0,0,886600,1
21652,371,105,0,0,0,886600,1
34496,193,140,0,0,0,886600,1
34494,689,319,0,0,0,886600,1
34472,85,114,0,0,0,886600,1
34896,508,29,0,0,0,886600,1
34470,439,163,0,0,0,886600,1
34469,193,703,0,0,0,886600,1
18985,493,427,0,0,0,886600,1
34451,414,160,0,0,0,886600,1
34908,517,492,0,0,0,886600,1
34450,85,48,0,0,0,886600,1
34449,77,719,0,0,0,886600,1
34910,587,261,0,0,0,886600,1
34448,714,723,0,0,0,886600,1
34447,29,514,0,0,0,886600,1
34446,257,613,0,0,0,886600,1
22168,380,569,0,0,0,886600,1
34443,668,446,0,0,0,886600,1
34442,640,269,0,0,0,886600,1
34441,117,174,0,0,0,886600,1
34440,290,243,0,0,0,886600,1
34438,54,708,0,0,0,886600,1
34453,701,242,0,0,0,886600,1
34907,174,163,0,0,0,886600,1
34906,257,10,0,0,0,886600,1
34458,133,717,0,0,0,886600,1
34468,544,43,0,0,0,886600,1
34467,84,576,0,0,0,886600,1
34464,85,439,0,0,0,886600,1
34462,497,593,0,0,0,886600,1
34461,576,274,0,0,0,886600,1
22162,494,522,0,0,0,886600,1
34457,257,463,0,0,0,886600,1
34905,181,145,0,0,0,886600,1
34456,497,246,0,0,0,886600,1
34900,392,167,0,0,0,886600,1
34901,264,613,0,0,0,886600,1
34902,265,319,0,0,0,886600,1
34903,364,133,0,0,0,886600,1
34904,138,482,0,0,0,886600,1
34368,334,624,0,0,0,886600,1
34366,175,95,0,0,0,886600,1
35215,558,717,0,0,0,886600,1
34970,195,164,0,0,0,886600,1
34284,269,195,0,0,0,886600,1
34972,269,383,0,0,0,886600,1
34283,717,364,0,0,0,886600,1
34282,593,448,0,0,0,886600,1
34973,364,137,0,0,0,886600,1
18778,170,80,0,0,0,886600,1
34280,158,448,0,0,0,886600,1
34279,246,624,0,0,0,886600,1
32850,718,397,0,0,0,886600,1
34277,178,661,0,0,0,886600,1
34276,133,19,0,0,0,886600,1
22360,721,385,0,0,0,886600,1
34274,587,529,0,0,0,886600,1
34273,717,307,0,0,0,886600,1
34974,723,14,0,0,0,886600,1
34971,196,668,0,0,0,886600,1
34285,257,123,0,0,0,886600,1
34975,13,124,0,0,0,886600,1
34969,353,699,0,0,0,886600,1
34297,492,409,0,0,0,886600,1
34960,494,708,0,0,0,886600,1
34296,458,13,0,0,0,886600,1
34295,29,242,0,0,0,886600,1
34294,313,721,0,0,0,886600,1
34961,717,501,0,0,0,886600,1
34962,242,202,0,0,0,886600,1
21496,587,170,0,0,0,886600,1
34291,178,274,0,0,0,886600,1
34965,587,178,0,0,0,886600,1
34967,294,614,0,0,0,886600,1
34288,683,342,0,0,0,886600,1
34287,269,261,0,0,0,886600,1
34286,543,43,0,0,0,886600,1
34968,54,511,0,0,0,886600,1
34272,652,385,0,0,0,886600,1
34271,517,175,0,0,0,886600,1
34365,587,124,0,0,0,886600,1
34256,121,328,0,0,0,886600,1
34255,1,332,0,0,0,886600,1
34254,207,720,0,0,0,886600,1
22371,145,605,0,0,0,886600,1
34983,439,290,0,0,0,886600,1
34251,294,307,0,0,0,886600,1
34250,501,43,0,0,0,886600,1
22383,195,156,0,0,0,886600,1
22386,684,497,0,0,0,886600,1
34246,613,342,0,0,0,886600,1
34245,508,353,0,0,0,886600,1
34244,596,569,0,0,0,886600,1
34243,347,494,0,0,0,886600,1
34984,507,29,0,0,0,886600,1
34985,383,661,0,0,0,886600,1
34241,458,511,0,0,0,886600,1
34982,12,181,0,0,0,886600,1
34257,507,652,0,0,0,886600,1
34270,364,181,0,0,0,886600,1
34258,528,673,0,0,0,886600,1
34269,43,19,0,0,0,886600,1
34268,501,175,0,0,0,886600,1
34976,458,175,0,0,0,886600,1
34977,503,202,0,0,0,886600,1
34267,720,207,0,0,0,886600,1
34978,195,124,0,0,0,886600,1
34266,167,160,0,0,0,886600,1
34265,720,181,0,0,0,886600,1
34979,95,160,0,0,0,886600,1
34263,141,85,0,0,0,886600,1
34980,458,503,0,0,0,886600,1
34261,167,175,0,0,0,886600,1
34981,133,494,0,0,0,886600,1
34260,501,719,0,0,0,886600,1
34259,170,544,0,0,0,886600,1
22337,446,354,0,0,0,886600,1
34299,137,409,0,0,0,886600,1
34959,613,274,0,0,0,886600,1
34351,652,95,0,0,0,886600,1
34349,703,723,0,0,0,886600,1
34348,174,261,0,0,0,886600,1
21531,404,202,0,0,0,886600,1
34346,683,1,0,0,0,886600,1
21519,5,26,0,0,0,886600,1
34343,25,569,0,0,0,886600,1
21510,90,3,0,0,0,886600,1
22266,714,16,0,0,0,886600,1
34341,560,264,0,0,0,886600,1
34340,290,332,0,0,0,886600,1
34339,718,107,0,0,0,886600,1
34338,674,371,0,0,0,886600,1
18881,409,123,0,0,0,886600,1
22272,84,492,0,0,0,886600,1
34335,23,12,0,0,0,886600,1
34350,290,507,0,0,0,886600,1
34352,22,181,0,0,0,886600,1
34300,587,196,0,0,0,886600,1
34353,482,593,0,0,0,886600,1
34364,503,126,0,0,0,886600,1
34363,155,269,0,0,0,886600,1
34362,156,446,0,0,0,886600,1
34935,703,48,0,0,0,886600,1
34936,170,290,0,0,0,886600,1
34360,632,43,0,0,0,886600,1
34359,307,371,0,0,0,886600,1
34937,274,720,0,0,0,886600,1
34938,684,525,0,0,0,886600,1
34358,502,137,0,0,0,886600,1
34357,319,250,0,0,0,886600,1
21549,195,9,0,0,0,886600,1
34356,463,613,0,0,0,886600,1
34355,514,409,0,0,0,886600,1
34354,560,77,0,0,0,886600,1
34334,202,140,0,0,0,886600,1
34947,503,723,0,0,0,886600,1
34333,257,593,0,0,0,886600,1
34332,204,90,0,0,0,886600,1
34317,236,626,0,0,0,886600,1
19725,160,614,0,0,0,886600,1
34958,19,596,0,0,0,886600,1
18818,207,632,0,0,0,886600,1
34313,145,342,0,0,0,886600,1
34312,193,43,0,0,0,886600,1
34311,568,493,0,0,0,886600,1
34310,137,503,0,0,0,886600,1
34309,494,544,0,0,0,886600,1
34308,525,371,0,0,0,886600,1
34307,117,571,0,0,0,886600,1
34305,385,446,0,0,0,886600,1
34304,137,552,0,0,0,886600,1
34302,703,84,0,0,0,886600,1
34301,246,528,0,0,0,886600,1
22297,655,646,0,0,0,886600,1
21508,25,683,0,0,0,886600,1
21509,302,332,0,0,0,886600,1
34950,178,414,0,0,0,886600,1
34331,624,332,0,0,0,886600,1
34948,121,482,0,0,0,886600,1
34329,568,463,0,0,0,886600,1
34328,568,522,0,0,0,886600,1
34949,246,193,0,0,0,886600,1
34327,257,280,0,0,0,886600,1
34325,458,207,0,0,0,886600,1
34953,661,26,0,0,0,886600,1
34324,719,552,0,0,0,886600,1
34323,613,193,0,0,0,886600,1
34951,16,202,0,0,0,886600,1
34952,11,202,0,0,0,886600,1
22293,331,624,0,0,0,886600,1
34320,364,507,0,0,0,886600,1
34511,12,178,0,0,0,886600,1
34512,2,163,0,0,0,886600,1
21666,501,155,0,0,0,886600,1
21891,404,708,0,0,0,886600,1
34698,640,721,0,0,0,886600,1
34697,427,458,0,0,0,886600,1
34696,310,721,0,0,0,886600,1
34695,723,174,0,0,0,886600,1
34813,371,532,0,0,0,886600,1
34694,175,310,0,0,0,886600,1
34693,587,414,0,0,0,886600,1
34692,492,640,0,0,0,886600,1
34691,501,342,0,0,0,886600,1
34690,140,482,0,0,0,886600,1
34689,528,160,0,0,0,886600,1
34688,717,624,0,0,0,886600,1
34687,503,6,0,0,0,886600,1
34686,571,576,0,0,0,886600,1
34685,433,394,0,0,0,886600,1
34699,195,140,0,0,0,886600,1
34701,265,294,0,0,0,886600,1
34814,703,295,0,0,0,886600,1
34702,703,311,0,0,0,886600,1
34806,723,708,0,0,0,886600,1
34807,673,458,0,0,0,886600,1
34713,175,195,0,0,0,886600,1
34808,290,529,0,0,0,886600,1
34711,160,2,0,0,0,886600,1
34809,257,14,0,0,0,886600,1
34710,446,528,0,0,0,886600,1
34810,587,145,0,0,0,886600,1
34708,723,269,0,0,0,886600,1
34706,576,508,0,0,0,886600,1
34705,178,383,0,0,0,886600,1
34811,257,392,0,0,0,886600,1
34812,117,699,0,0,0,886600,1
34704,138,1,0,0,0,886600,1
34703,703,385,0,0,0,886600,1
34684,64,433,0,0,0,886600,1
34815,482,34,0,0,0,886600,1
34513,471,133,0,0,0,886600,1
34670,385,525,0,0,0,886600,1
21914,246,501,0,0,0,886600,1
34667,587,494,0,0,0,886600,1
34826,703,632,0,0,0,886600,1
34666,560,605,0,0,0,886600,1
34665,393,175,0,0,0,886600,1
34664,12,673,0,0,0,886600,1
34827,723,682,0,0,0,886600,1
34663,334,319,0,0,0,886600,1
34662,207,661,0,0,0,886600,1
34661,290,13,0,0,0,886600,1
34828,243,133,0,0,0,886600,1
34660,517,508,0,0,0,886600,1
34658,15,202,0,0,0,886600,1
34657,404,699,0,0,0,886600,1
34656,471,525,0,0,0,886600,1
34825,433,56,0,0,0,886600,1
34824,720,280,0,0,0,886600,1
34683,25,668,0,0,0,886600,1
34823,22,409,0,0,0,886600,1
34816,170,85,0,0,0,886600,1
34682,508,552,0,0,0,886600,1
34681,141,294,0,0,0,886600,1
34817,720,502,0,0,0,886600,1
34680,708,133,0,0,0,886600,1
34818,1,261,0,0,0,886600,1
34819,84,717,0,0,0,886600,1
34679,257,11,0,0,0,886600,1
34820,242,492,0,0,0,886600,1
34821,652,562,0,0,0,886600,1
34676,383,160,0,0,0,886600,1
34675,723,588,0,0,0,886600,1
34822,427,103,0,0,0,886600,1
34673,682,257,0,0,0,886600,1
34672,85,560,0,0,0,886600,1
34714,398,290,0,0,0,886600,1
34716,126,624,0,0,0,886600,1
34717,130,717,0,0,0,886600,1
34764,156,160,0,0,0,886600,1
34763,48,458,0,0,0,886600,1
34785,448,507,0,0,0,886600,1
34762,371,514,0,0,0,886600,1
34761,508,10,0,0,0,886600,1
34760,164,624,0,0,0,886600,1
34759,137,560,0,0,0,886600,1
34758,482,501,0,0,0,886600,1
34757,1,160,0,0,0,886600,1
34786,560,673,0,0,0,886600,1
34756,714,295,0,0,0,886600,1
34755,699,714,0,0,0,886600,1
34754,723,502,0,0,0,886600,1
34787,511,493,0,0,0,886600,1
34788,587,105,0,0,0,886600,1
34753,668,682,0,0,0,886600,1
34784,155,409,0,0,0,886600,1
34765,137,544,0,0,0,886600,1
34718,720,264,0,0,0,886600,1
34766,158,202,0,0,0,886600,1
34777,138,479,0,0,0,886600,1
34778,571,560,0,0,0,886600,1
34779,652,398,0,0,0,886600,1
21766,404,544,0,0,0,886600,1
34780,332,569,0,0,0,886600,1
34781,167,140,0,0,0,886600,1
34773,126,103,0,0,0,886600,1
34772,19,502,0,0,0,886600,1
34771,493,552,0,0,0,886600,1
34770,269,307,0,0,0,886600,1
34782,613,34,0,0,0,886600,1
34769,265,193,0,0,0,886600,1
34768,571,64,0,0,0,886600,1
34767,613,145,0,0,0,886600,1
34783,655,342,0,0,0,886600,1
34789,673,568,0,0,0,886600,1
34790,609,494,0,0,0,886600,1
34791,613,4,0,0,0,886600,1
34792,646,673,0,0,0,886600,1
34735,342,107,0,0,0,886600,1
19396,204,668,0,0,0,886600,1
19395,446,586,0,0,0,886600,1
34728,77,568,0,0,0,886600,1
34801,19,332,0,0,0,886600,1
34802,708,90,0,0,0,886600,1
34725,246,525,0,0,0,886600,1
34724,290,265,0,0,0,886600,1
34803,718,683,0,0,0,886600,1
19372,269,250,0,0,0,886600,1
34804,331,433,0,0,0,886600,1
34721,448,393,0,0,0,886600,1
34805,103,264,0,0,0,886600,1
34720,5,409,0,0,0,886600,1
34719,15,19,0,0,0,886600,1
34800,587,30,0,0,0,886600,1
34799,674,626,0,0,0,886600,1
34798,717,246,0,0,0,886600,1
34747,475,458,0,0,0,886600,1
34752,717,160,0,0,0,886600,1
34793,624,404,0,0,0,886600,1
34751,507,332,0,0,0,886600,1
34750,264,246,0,0,0,886600,1
34749,701,501,0,0,0,886600,1
34748,587,532,0,0,0,886600,1
34794,175,398,0,0,0,886600,1
21827,274,174,0,0,0,886600,1
34795,158,138,0,0,0,886600,1
34796,193,328,0,0,0,886600,1
19447,638,174,0,0,0,886600,1
34797,294,427,0,0,0,886600,1
21791,624,202,0,0,0,886600,1
19417,138,3,0,0,0,886600,1
34655,353,124,0,0,0,886600,1
21918,443,160,0,0,0,886600,1
34653,502,85,0,0,0,886600,1
34567,290,446,0,0,0,886600,1
34565,33,721,0,0,0,886600,1
34863,507,103,0,0,0,886600,1
34563,562,721,0,0,0,886600,1
34562,448,613,0,0,0,886600,1
34561,717,236,0,0,0,886600,1
21689,493,588,0,0,0,886600,1
34560,126,195,0,0,0,886600,1
22021,684,393,0,0,0,886600,1
22027,243,409,0,0,0,886600,1
34557,174,568,0,0,0,886600,1
21682,307,195,0,0,0,886600,1
34555,571,393,0,0,0,886600,1
34554,394,668,0,0,0,886600,1
34553,261,371,0,0,0,886600,1
34552,689,503,0,0,0,886600,1
34566,261,409,0,0,0,886600,1
34568,137,674,0,0,0,886600,1
34582,609,207,0,0,0,886600,1
34569,682,178,0,0,0,886600,1
34580,114,571,0,0,0,886600,1
34579,646,682,0,0,0,886600,1
34857,23,130,0,0,0,886600,1
21692,568,170,0,0,0,886600,1
34859,380,202,0,0,0,886600,1
34578,160,171,0,0,0,886600,1
34577,492,164,0,0,0,886600,1
34860,131,494,0,0,0,886600,1
34861,433,471,0,0,0,886600,1
34862,448,409,0,0,0,886600,1
34576,701,274,0,0,0,886600,1
34575,568,473,0,0,0,886600,1
34574,141,543,0,0,0,886600,1
22005,529,560,0,0,0,886600,1
34570,605,290,0,0,0,886600,1
34551,433,84,0,0,0,886600,1
34550,532,701,0,0,0,886600,1
34868,269,15,0,0,0,886600,1
34548,174,503,0,0,0,886600,1
34874,560,140,0,0,0,886600,1
34529,137,30,0,0,0,886600,1
34528,117,90,0,0,0,886600,1
34527,30,138,0,0,0,886600,1
34525,160,528,0,0,0,886600,1
34524,586,178,0,0,0,886600,1
34522,138,195,0,0,0,886600,1
34521,661,414,0,0,0,886600,1
34520,543,717,0,0,0,886600,1
34518,95,492,0,0,0,886600,1
21668,156,414,0,0,0,886600,1
34517,626,261,0,0,0,886600,1
34516,587,471,0,0,0,886600,1
34515,682,133,0,0,0,886600,1
34514,626,409,0,0,0,886600,1
22042,427,364,0,0,0,886600,1
34873,529,576,0,0,0,886600,1
34532,701,397,0,0,0,886600,1
34870,137,274,0,0,0,886600,1
34547,342,397,0,0,0,886600,1
34546,433,708,0,0,0,886600,1
34544,13,613,0,0,0,886600,1
34543,684,163,0,0,0,886600,1
19202,123,624,0,0,0,886600,1
34541,371,588,0,0,0,886600,1
34871,723,535,0,0,0,886600,1
34533,494,383,0,0,0,886600,1
34540,668,175,0,0,0,886600,1
34539,568,334,0,0,0,886600,1
34538,723,126,0,0,0,886600,1
34536,246,514,0,0,0,886600,1
34535,95,626,0,0,0,886600,1
34534,54,294,0,0,0,886600,1
34581,398,721,0,0,0,886600,1
34583,295,160,0,0,0,886600,1
34829,661,246,0,0,0,886600,1
21759,689,193,0,0,0,886600,1
34637,568,394,0,0,0,886600,1
34636,138,701,0,0,0,886600,1
34635,558,494,0,0,0,886600,1
34634,219,576,0,0,0,886600,1
21938,609,2,0,0,0,886600,1
34631,331,719,0,0,0,886600,1
34630,133,493,0,0,0,886600,1
34629,138,618,0,0,0,886600,1
34628,264,618,0,0,0,886600,1
34627,723,328,0,0,0,886600,1
21944,54,219,0,0,0,886600,1
34624,689,593,0,0,0,886600,1
34623,409,371,0,0,0,886600,1
34621,626,295,0,0,0,886600,1
19298,97,85,0,0,0,886600,1
34837,719,525,0,0,0,886600,1
34640,103,392,0,0,0,886600,1
34584,2,458,0,0,0,886600,1
34641,558,721,0,0,0,886600,1
34652,394,195,0,0,0,886600,1
34651,433,48,0,0,0,886600,1
34649,618,290,0,0,0,886600,1
34648,492,708,0,0,0,886600,1
34647,137,23,0,0,0,886600,1
34646,529,569,0,0,0,886600,1
34830,181,614,0,0,0,886600,1
34831,126,655,0,0,0,886600,1
34644,703,668,0,0,0,886600,1
34643,138,552,0,0,0,886600,1
34832,689,699,0,0,0,886600,1
34833,334,684,0,0,0,886600,1
34834,23,145,0,0,0,886600,1
34642,719,683,0,0,0,886600,1
34835,31,684,0,0,0,886600,1
19486,307,319,0,0,0,886600,1
34618,14,133,0,0,0,886600,1
34617,586,319,0,0,0,886600,1
34616,708,85,0,0,0,886600,1
34597,493,174,0,0,0,886600,1
34596,528,13,0,0,0,886600,1
34595,85,31,0,0,0,886600,1
21734,668,22,0,0,0,886600,1
34593,508,30,0,0,0,886600,1
34592,699,507,0,0,0,886600,1
34591,140,43,0,0,0,886600,1
19526,4,708,0,0,0,886600,1
34590,535,684,0,0,0,886600,1
34589,175,164,0,0,0,886600,1
34588,446,587,0,0,0,886600,1
34586,141,684,0,0,0,886600,1
34854,85,614,0,0,0,886600,1
34855,175,334,0,0,0,886600,1
34585,367,257,0,0,0,886600,1
34599,703,353,0,0,0,886600,1
34847,502,433,0,0,0,886600,1
34601,609,174,0,0,0,886600,1
34608,103,156,0,0,0,886600,1
34615,568,314,0,0,0,886600,1
34614,261,482,0,0,0,886600,1
21743,379,137,0,0,0,886600,1
21736,661,334,0,0,0,886600,1
34610,699,130,0,0,0,886600,1
34609,54,673,0,0,0,886600,1
21961,334,1,0,0,0,886600,1
34846,618,593,0,0,0,886600,1
19290,719,624,0,0,0,886600,1
34605,433,196,0,0,0,886600,1
34845,543,699,0,0,0,886600,1
34604,290,596,0,0,0,886600,1
21968,264,562,0,0,0,886600,1
34602,717,668,0,0,0,886600,1
34240,257,6,0,0,0,886600,1
34239,560,714,0,0,0,886600,1
34238,543,178,0,0,0,886600,1
33883,181,379,0,0,0,886600,1
33881,48,576,0,0,0,886600,1
33880,714,383,0,0,0,886600,1
33879,392,181,0,0,0,886600,1
35140,20,568,0,0,0,886600,1
35141,723,311,0,0,0,886600,1
33876,103,720,0,0,0,886600,1
33875,170,689,0,0,0,886600,1
35142,717,274,0,0,0,886600,1
35143,683,171,0,0,0,886600,1
21312,503,9,0,0,0,886600,1
33872,103,446,0,0,0,886600,1
33871,723,236,0,0,0,886600,1
33870,661,269,0,0,0,886600,1
33869,163,193,0,0,0,886600,1
33868,703,562,0,0,0,886600,1
33882,160,392,0,0,0,886600,1
33884,15,525,0,0,0,886600,1
33866,342,638,0,0,0,886600,1
33885,576,348,0,0,0,886600,1
33896,655,124,0,0,0,886600,1
33895,576,393,0,0,0,886600,1
33894,501,19,0,0,0,886600,1
33893,503,34,0,0,0,886600,1
35134,703,32,0,0,0,886600,1
33892,385,371,0,0,0,886600,1
33891,714,261,0,0,0,886600,1
33890,269,302,0,0,0,886600,1
35135,571,587,0,0,0,886600,1
35136,663,525,0,0,0,886600,1
35137,719,246,0,0,0,886600,1
33887,525,43,0,0,0,886600,1
35138,11,294,0,0,0,886600,1
35139,544,458,0,0,0,886600,1
33886,178,479,0,0,0,886600,1
33867,14,371,0,0,0,886600,1
33865,683,137,0,0,0,886600,1
33965,246,593,0,0,0,886600,1
33843,587,511,0,0,0,886600,1
33840,652,668,0,0,0,886600,1
35155,458,507,0,0,0,886600,1
22856,708,114,0,0,0,886600,1
33836,181,307,0,0,0,886600,1
33833,723,562,0,0,0,886600,1
33832,398,137,0,0,0,886600,1
35156,181,10,0,0,0,886600,1
33831,661,2,0,0,0,886600,1
33829,494,528,0,0,0,886600,1
22871,307,246,0,0,0,886600,1
33827,701,164,0,0,0,886600,1
22872,257,48,0,0,0,886600,1
35158,508,174,0,0,0,886600,1
35159,661,446,0,0,0,886600,1
33823,385,181,0,0,0,886600,1
33841,684,528,0,0,0,886600,1
35153,16,433,0,0,0,886600,1
33864,170,502,0,0,0,886600,1
33844,90,586,0,0,0,886600,1
33863,54,138,0,0,0,886600,1
22800,562,163,0,0,0,886600,1
33861,15,328,0,0,0,886600,1
33860,332,202,0,0,0,886600,1
33859,571,347,0,0,0,886600,1
33856,302,684,0,0,0,886600,1
33855,652,117,0,0,0,886600,1
33854,458,587,0,0,0,886600,1
35147,458,397,0,0,0,886600,1
35148,626,427,0,0,0,886600,1
33852,646,5,0,0,0,886600,1
33851,652,532,0,0,0,886600,1
35151,383,319,0,0,0,886600,1
33846,5,23,0,0,0,886600,1
22838,624,193,0,0,0,886600,1
33897,23,138,0,0,0,886600,1
35133,652,708,0,0,0,886600,1
35132,155,140,0,0,0,886600,1
22754,543,652,0,0,0,886600,1
22759,502,587,0,0,0,886600,1
33946,717,140,0,0,0,886600,1
33944,250,137,0,0,0,886600,1
33943,32,342,0,0,0,886600,1
33941,605,371,0,0,0,886600,1
33940,175,141,0,0,0,886600,1
33939,181,535,0,0,0,886600,1
33938,508,126,0,0,0,886600,1
21320,295,392,0,0,0,886600,1
22765,463,448,0,0,0,886600,1
22767,404,204,0,0,0,886600,1
33935,307,19,0,0,0,886600,1
33934,609,1,0,0,0,886600,1
33933,178,140,0,0,0,886600,1
33932,246,126,0,0,0,886600,1
33948,717,674,0,0,0,886600,1
35118,4,175,0,0,0,886600,1
33898,497,721,0,0,0,886600,1
33950,334,342,0,0,0,886600,1
33963,652,511,0,0,0,886600,1
35114,493,319,0,0,0,886600,1
33962,178,544,0,0,0,886600,1
33961,605,626,0,0,0,886600,1
33960,22,133,0,0,0,886600,1
33958,332,175,0,0,0,886600,1
33957,701,25,0,0,0,886600,1
33956,15,371,0,0,0,886600,1
33955,708,383,0,0,0,886600,1
33954,25,494,0,0,0,886600,1
33953,4,458,0,0,0,886600,1
35116,492,532,0,0,0,886600,1
35117,126,242,0,0,0,886600,1
33952,668,569,0,0,0,886600,1
33951,257,302,0,0,0,886600,1
33931,19,117,0,0,0,886600,1
33929,544,719,0,0,0,886600,1
33928,668,571,0,0,0,886600,1
33927,593,5,0,0,0,886600,1
35128,202,328,0,0,0,886600,1
33909,714,163,0,0,0,886600,1
33908,50,719,0,0,0,886600,1
33907,85,123,0,0,0,886600,1
33906,719,22,0,0,0,886600,1
35129,347,246,0,0,0,886600,1
33905,164,494,0,0,0,886600,1
33904,718,25,0,0,0,886600,1
35130,492,274,0,0,0,886600,1
33903,137,497,0,0,0,886600,1
22782,394,482,0,0,0,886600,1
33901,718,398,0,0,0,886600,1
33900,246,164,0,0,0,886600,1
35131,433,242,0,0,0,886600,1
33899,568,77,0,0,0,886600,1
33910,458,204,0,0,0,886600,1
35127,178,614,0,0,0,886600,1
33911,683,673,0,0,0,886600,1
33919,576,682,0,0,0,886600,1
33926,571,367,0,0,0,886600,1
33925,138,448,0,0,0,886600,1
33924,22,1,0,0,0,886600,1
33923,371,33,0,0,0,886600,1
33922,398,202,0,0,0,886600,1
33921,126,84,0,0,0,886600,1
22773,314,124,0,0,0,886600,1
33912,13,684,0,0,0,886600,1
35124,170,25,0,0,0,886600,1
33916,348,719,0,0,0,886600,1
35125,720,19,0,0,0,886600,1
33915,328,160,0,0,0,886600,1
33913,458,171,0,0,0,886600,1
35126,652,605,0,0,0,886600,1
35160,493,195,0,0,0,886600,1
33822,699,193,0,0,0,886600,1
33821,433,6,0,0,0,886600,1
21247,11,30,0,0,0,886600,1
35196,160,383,0,0,0,886600,1
33730,54,552,0,0,0,886600,1
33729,97,433,0,0,0,886600,1
23028,568,175,0,0,0,886600,1
33727,257,558,0,0,0,886600,1
33726,668,503,0,0,0,886600,1
33725,34,719,0,0,0,886600,1
33724,332,439,0,0,0,886600,1
33721,652,171,0,0,0,886600,1
19985,383,463,0,0,0,886600,1
33720,714,501,0,0,0,886600,1
33719,699,414,0,0,0,886600,1
18048,720,311,0,0,0,886600,1
33717,652,463,0,0,0,886600,1
23045,718,80,0,0,0,886600,1
23021,5,103,0,0,0,886600,1
33733,661,332,0,0,0,886600,1
33753,257,587,0,0,0,886600,1
35193,23,123,0,0,0,886600,1
33751,482,167,0,0,0,886600,1
33750,54,560,0,0,0,886600,1
33749,492,290,0,0,0,886600,1
19963,261,663,0,0,0,886600,1
33747,668,156,0,0,0,886600,1
33745,114,503,0,0,0,886600,1
21250,371,397,0,0,0,886600,1
33743,493,618,0,0,0,886600,1
33742,195,393,0,0,0,886600,1
33741,393,160,0,0,0,886600,1
33740,13,163,0,0,0,886600,1
33739,141,167,0,0,0,886600,1
33738,167,290,0,0,0,886600,1
23001,503,265,0,0,0,886600,1
33736,529,43,0,0,0,886600,1
33715,471,576,0,0,0,886600,1
33714,439,193,0,0,0,886600,1
33712,174,482,0,0,0,886600,1
35201,497,719,0,0,0,886600,1
33696,717,85,0,0,0,886600,1
35211,371,307,0,0,0,886600,1
33695,257,138,0,0,0,886600,1
33694,126,10,0,0,0,886600,1
33693,31,613,0,0,0,886600,1
33692,170,264,0,0,0,886600,1
35212,714,593,0,0,0,886600,1
33691,334,178,0,0,0,886600,1
35214,393,569,0,0,0,886600,1
33690,160,446,0,0,0,886600,1
33689,257,23,0,0,0,886600,1
33688,23,689,0,0,0,886600,1
33687,720,497,0,0,0,886600,1
33685,269,683,0,0,0,886600,1
33684,624,290,0,0,0,886600,1
23066,103,522,0,0,0,886600,1
35210,508,181,0,0,0,886600,1
33698,371,502,0,0,0,886600,1
33705,242,178,0,0,0,886600,1
23047,141,683,0,0,0,886600,1
33710,163,508,0,0,0,886600,1
23049,385,133,0,0,0,886600,1
33708,708,503,0,0,0,886600,1
35202,392,544,0,0,0,886600,1
21210,348,433,0,0,0,886600,1
33704,170,140,0,0,0,886600,1
20012,264,588,0,0,0,886600,1
35204,207,269,0,0,0,886600,1
33702,571,1,0,0,0,886600,1
20002,261,31,0,0,0,886600,1
35206,714,508,0,0,0,886600,1
33699,4,290,0,0,0,886600,1
35207,264,508,0,0,0,886600,1
33752,683,409,0,0,0,886600,1
33755,307,160,0,0,0,886600,1
35161,141,503,0,0,0,886600,1
33802,16,717,0,0,0,886600,1
35165,23,482,0,0,0,886600,1
35166,494,43,0,0,0,886600,1
33799,503,140,0,0,0,886600,1
35167,613,517,0,0,0,886600,1
33798,54,171,0,0,0,886600,1
22919,30,264,0,0,0,886600,1
33796,701,398,0,0,0,886600,1
33794,646,552,0,0,0,886600,1
35168,23,195,0,0,0,886600,1
35169,334,618,0,0,0,886600,1
33792,3,719,0,0,0,886600,1
33791,409,511,0,0,0,886600,1
33790,246,155,0,0,0,886600,1
33789,160,714,0,0,0,886600,1
33788,508,448,0,0,0,886600,1
33801,141,1,0,0,0,886600,1
22917,133,475,0,0,0,886600,1
33756,133,458,0,0,0,886600,1
33804,107,458,0,0,0,886600,1
33819,683,261,0,0,0,886600,1
33818,383,137,0,0,0,886600,1
33817,347,12,0,0,0,886600,1
33816,379,342,0,0,0,886600,1
33815,719,576,0,0,0,886600,1
33814,448,414,0,0,0,886600,1
33813,364,163,0,0,0,886600,1
33812,246,507,0,0,0,886600,1
22894,714,314,0,0,0,886600,1
35162,718,544,0,0,0,886600,1
33809,593,446,0,0,0,886600,1
35163,15,668,0,0,0,886600,1
33807,717,342,0,0,0,886600,1
35164,689,494,0,0,0,886600,1
33805,596,181,0,0,0,886600,1
35170,613,576,0,0,0,886600,1
35171,446,385,0,0,0,886600,1
33786,364,552,0,0,0,886600,1
33785,508,2,0,0,0,886600,1
19929,265,204,0,0,0,886600,1
33771,5,528,0,0,0,886600,1
35185,448,4,0,0,0,886600,1
33769,85,64,0,0,0,886600,1
33768,332,319,0,0,0,886600,1
35186,593,19,0,0,0,886600,1
33765,433,145,0,0,0,886600,1
35188,652,264,0,0,0,886600,1
21259,204,85,0,0,0,886600,1
35190,525,543,0,0,0,886600,1
33761,661,543,0,0,0,886600,1
33760,54,23,0,0,0,886600,1
33759,717,164,0,0,0,886600,1
33758,23,398,0,0,0,886600,1
33757,33,138,0,0,0,886600,1
33772,668,448,0,0,0,886600,1
33773,332,528,0,0,0,886600,1
35182,652,614,0,0,0,886600,1
35176,13,668,0,0,0,886600,1
35172,568,171,0,0,0,886600,1
35173,257,68,0,0,0,886600,1
33783,446,661,0,0,0,886600,1
18191,4,130,0,0,0,886600,1
35174,163,371,0,0,0,886600,1
35175,328,719,0,0,0,886600,1
35177,367,717,0,0,0,886600,1
33774,511,261,0,0,0,886600,1
33780,243,124,0,0,0,886600,1
35178,29,576,0,0,0,886600,1
22947,181,20,0,0,0,886600,1
33776,624,569,0,0,0,886600,1
22951,699,334,0,0,0,886600,1
35181,494,683,0,0,0,886600,1
33964,511,163,0,0,0,886600,1
33966,137,95,0,0,0,886600,1
34237,107,719,0,0,0,886600,1
35027,511,290,0,0,0,886600,1
34139,23,409,0,0,0,886600,1
34138,392,133,0,0,0,886600,1
34137,175,1,0,0,0,886600,1
34136,576,632,0,0,0,886600,1
34135,475,576,0,0,0,886600,1
34133,560,492,0,0,0,886600,1
34132,528,103,0,0,0,886600,1
22581,22,342,0,0,0,886600,1
22590,332,170,0,0,0,886600,1
34126,307,137,0,0,0,886600,1
19829,458,385,0,0,0,886600,1
18569,117,14,0,0,0,886600,1
21375,458,638,0,0,0,886600,1
34123,13,720,0,0,0,886600,1
34122,207,511,0,0,0,886600,1
34140,195,12,0,0,0,886600,1
34141,246,178,0,0,0,886600,1
35036,397,178,0,0,0,886600,1
34142,124,569,0,0,0,886600,1
22556,529,587,0,0,0,886600,1
22559,385,723,0,0,0,886600,1
35024,126,587,0,0,0,886600,1
34152,569,385,0,0,0,886600,1
22569,257,331,0,0,0,886600,1
34150,202,596,0,0,0,886600,1
34149,97,668,0,0,0,886600,1
34148,699,571,0,0,0,886600,1
34147,718,265,0,0,0,886600,1
35025,514,138,0,0,0,886600,1
34146,269,714,0,0,0,886600,1
35026,156,269,0,0,0,886600,1
34145,587,334,0,0,0,886600,1
34144,721,294,0,0,0,886600,1
34143,202,593,0,0,0,886600,1
34121,719,19,0,0,0,886600,1
35037,701,714,0,0,0,886600,1
35113,85,274,0,0,0,886600,1
34105,243,446,0,0,0,886600,1
35042,236,202,0,0,0,886600,1
34103,170,195,0,0,0,886600,1
34102,137,314,0,0,0,886600,1
34101,624,720,0,0,0,886600,1
34100,609,178,0,0,0,886600,1
35044,19,661,0,0,0,886600,1
34098,493,294,0,0,0,886600,1
35045,264,103,0,0,0,886600,1
34097,97,458,0,0,0,886600,1
22603,133,364,0,0,0,886600,1
34095,207,535,0,0,0,886600,1
34094,502,29,0,0,0,886600,1
35046,171,202,0,0,0,886600,1
35047,646,294,0,0,0,886600,1
34093,587,663,0,0,0,886600,1
34104,103,385,0,0,0,886600,1
35041,613,511,0,0,0,886600,1
34120,717,2,0,0,0,886600,1
34106,353,719,0,0,0,886600,1
34119,371,334,0,0,0,886600,1
34118,178,571,0,0,0,886600,1
34117,19,507,0,0,0,886600,1
35038,626,446,0,0,0,886600,1
34116,569,174,0,0,0,886600,1
34115,348,721,0,0,0,886600,1
34114,171,160,0,0,0,886600,1
34113,618,371,0,0,0,886600,1
34112,618,492,0,0,0,886600,1
34111,446,503,0,0,0,886600,1
34110,568,532,0,0,0,886600,1
34109,532,342,0,0,0,886600,1
34108,103,133,0,0,0,886600,1
34107,56,673,0,0,0,886600,1
19835,446,9,0,0,0,886600,1
35023,503,332,0,0,0,886600,1
35022,593,160,0,0,0,886600,1
34158,246,170,0,0,0,886600,1
18719,141,353,0,0,0,886600,1
34213,463,433,0,0,0,886600,1
34212,586,721,0,0,0,886600,1
34211,576,34,0,0,0,886600,1
34210,560,587,0,0,0,886600,1
34209,624,137,0,0,0,886600,1
34206,85,522,0,0,0,886600,1
34205,178,207,0,0,0,886600,1
35002,4,19,0,0,0,886600,1
34203,508,123,0,0,0,886600,1
35003,587,3,0,0,0,886600,1
34201,503,587,0,0,0,886600,1
34200,124,274,0,0,0,886600,1
35004,517,133,0,0,0,886600,1
22464,404,543,0,0,0,886600,1
22469,219,137,0,0,0,886600,1
34215,638,371,0,0,0,886600,1
34992,68,721,0,0,0,886600,1
35021,605,85,0,0,0,886600,1
34221,493,124,0,0,0,886600,1
34236,587,6,0,0,0,886600,1
34235,503,295,0,0,0,886600,1
34234,517,525,0,0,0,886600,1
34233,319,196,0,0,0,886600,1
34986,552,613,0,0,0,886600,1
34987,626,294,0,0,0,886600,1
34988,626,334,0,0,0,886600,1
34989,204,124,0,0,0,886600,1
34230,493,261,0,0,0,886600,1
34229,367,568,0,0,0,886600,1
22408,720,33,0,0,0,886600,1
34990,250,446,0,0,0,886600,1
34226,264,64,0,0,0,886600,1
34224,652,501,0,0,0,886600,1
34991,576,158,0,0,0,886600,1
34194,137,605,0,0,0,886600,1
34193,294,507,0,0,0,886600,1
34191,124,181,0,0,0,886600,1
35005,674,458,0,0,0,886600,1
34174,720,596,0,0,0,886600,1
35013,588,718,0,0,0,886600,1
35014,124,714,0,0,0,886600,1
34172,701,439,0,0,0,886600,1
35015,202,23,0,0,0,886600,1
35016,193,673,0,0,0,886600,1
22530,264,404,0,0,0,886600,1
34168,409,242,0,0,0,886600,1
34166,492,562,0,0,0,886600,1
19787,156,12,0,0,0,886600,1
34165,23,302,0,0,0,886600,1
34164,137,123,0,0,0,886600,1
34163,178,507,0,0,0,886600,1
34161,471,178,0,0,0,886600,1
35019,202,332,0,0,0,886600,1
22510,439,265,0,0,0,886600,1
22508,514,511,0,0,0,886600,1
35012,264,178,0,0,0,886600,1
35008,274,717,0,0,0,886600,1
22490,689,164,0,0,0,886600,1
35006,508,652,0,0,0,886600,1
22492,117,507,0,0,0,886600,1
34188,175,6,0,0,0,886600,1
34187,682,717,0,0,0,886600,1
35007,257,313,0,0,0,886600,1
34183,684,517,0,0,0,886600,1
34178,6,718,0,0,0,886600,1
34182,164,569,0,0,0,886600,1
35009,587,443,0,0,0,886600,1
35010,121,593,0,0,0,886600,1
34181,718,661,0,0,0,886600,1
35011,103,25,0,0,0,886600,1
34179,605,571,0,0,0,886600,1
35048,12,193,0,0,0,886600,1
34092,138,64,0,0,0,886600,1
35049,2,720,0,0,0,886600,1
35096,175,354,0,0,0,886600,1
34020,175,701,0,0,0,886600,1
35097,683,514,0,0,0,886600,1
34019,242,508,0,0,0,886600,1
35098,714,502,0,0,0,886600,1
34017,544,103,0,0,0,886600,1
34016,103,294,0,0,0,886600,1
34015,593,319,0,0,0,886600,1
34013,569,379,0,0,0,886600,1
34012,202,525,0,0,0,886600,1
34011,398,569,0,0,0,886600,1
34010,446,443,0,0,0,886600,1
35099,718,230,0,0,0,886600,1
34009,126,328,0,0,0,886600,1
34008,689,342,0,0,0,886600,1
34007,250,181,0,0,0,886600,1
34021,443,494,0,0,0,886600,1
34022,22,383,0,0,0,886600,1
22684,193,334,0,0,0,886600,1
35095,342,117,0,0,0,886600,1
34035,714,307,0,0,0,886600,1
34033,544,137,0,0,0,886600,1
34032,582,433,0,0,0,886600,1
34031,332,525,0,0,0,886600,1
22694,130,409,0,0,0,886600,1
34029,290,560,0,0,0,886600,1
34028,624,682,0,0,0,886600,1
35090,196,433,0,0,0,886600,1
34027,385,43,0,0,0,886600,1
35091,661,587,0,0,0,886600,1
34026,385,569,0,0,0,886600,1
35092,294,571,0,0,0,886600,1
35093,202,103,0,0,0,886600,1
35094,571,219,0,0,0,886600,1
34024,137,596,0,0,0,886600,1
35100,723,586,0,0,0,886600,1
35101,571,511,0,0,0,886600,1
34006,371,95,0,0,0,886600,1
34005,392,525,0,0,0,886600,1
19857,529,4,0,0,0,886600,1
33988,458,446,0,0,0,886600,1
33987,655,720,0,0,0,886600,1
33986,175,230,0,0,0,886600,1
33985,140,721,0,0,0,886600,1
33984,463,90,0,0,0,886600,1
33983,137,328,0,0,0,886600,1
33981,718,137,0,0,0,886600,1
33980,204,718,0,0,0,886600,1
33979,587,446,0,0,0,886600,1
33978,646,383,0,0,0,886600,1
21347,494,16,0,0,0,886600,1
33971,290,383,0,0,0,886600,1
33970,23,294,0,0,0,886600,1
33969,13,137,0,0,0,886600,1
33989,714,207,0,0,0,886600,1
33990,193,371,0,0,0,886600,1
19848,668,29,0,0,0,886600,1
33999,246,569,0,0,0,886600,1
22716,638,683,0,0,0,886600,1
34003,646,160,0,0,0,886600,1
34002,560,427,0,0,0,886600,1
35102,85,463,0,0,0,886600,1
34001,568,29,0,0,0,886600,1
34000,525,613,0,0,0,886600,1
33998,492,23,0,0,0,886600,1
33991,371,11,0,0,0,886600,1
35103,626,498,0,0,0,886600,1
33996,175,243,0,0,0,886600,1
33995,714,414,0,0,0,886600,1
33994,532,719,0,0,0,886600,1
33993,163,492,0,0,0,886600,1
33992,34,494,0,0,0,886600,1
35089,178,264,0,0,0,886600,1
34038,137,334,0,0,0,886600,1
35050,175,5,0,0,0,886600,1
34078,385,576,0,0,0,886600,1
35062,717,427,0,0,0,886600,1
35063,393,124,0,0,0,886600,1
35064,587,22,0,0,0,886600,1
35065,117,720,0,0,0,886600,1
34076,414,576,0,0,0,886600,1
34075,207,383,0,0,0,886600,1
34074,593,720,0,0,0,886600,1
34073,717,655,0,0,0,886600,1
35066,717,385,0,0,0,886600,1
34071,84,19,0,0,0,886600,1
35067,543,392,0,0,0,886600,1
35068,294,609,0,0,0,886600,1
35069,525,29,0,0,0,886600,1
34067,332,409,0,0,0,886600,1
35070,385,721,0,0,0,886600,1
34077,493,503,0,0,0,886600,1
34079,257,508,0,0,0,886600,1
34039,719,560,0,0,0,886600,1
34080,517,137,0,0,0,886600,1
35051,632,652,0,0,0,886600,1
34087,560,543,0,0,0,886600,1
35052,494,501,0,0,0,886600,1
35053,494,54,0,0,0,886600,1
35054,158,290,0,0,0,886600,1
35055,717,175,0,0,0,886600,1
35056,170,571,0,0,0,886600,1
35057,699,532,0,0,0,886600,1
35058,525,332,0,0,0,886600,1
35059,181,414,0,0,0,886600,1
34083,684,448,0,0,0,886600,1
35060,560,20,0,0,0,886600,1
35061,265,701,0,0,0,886600,1
34082,404,569,0,0,0,886600,1
34081,392,514,0,0,0,886600,1
34066,508,131,0,0,0,886600,1
34065,446,84,0,0,0,886600,1
34063,371,543,0,0,0,886600,1
35071,398,571,0,0,0,886600,1
35082,23,414,0,0,0,886600,1
35083,290,175,0,0,0,886600,1
34051,23,354,0,0,0,886600,1
34050,155,178,0,0,0,886600,1
34049,721,383,0,0,0,886600,1
35084,614,294,0,0,0,886600,1
35085,514,195,0,0,0,886600,1
35086,668,290,0,0,0,886600,1
34044,20,12,0,0,0,886600,1
35087,195,682,0,0,0,886600,1
34043,23,160,0,0,0,886600,1
34042,508,562,0,0,0,886600,1
35088,652,14,0,0,0,886600,1
34041,528,701,0,0,0,886600,1
34040,269,290,0,0,0,886600,1
18491,661,588,0,0,0,886600,1
34055,632,19,0,0,0,886600,1
34056,720,13,0,0,0,886600,1
35074,242,290,0,0,0,886600,1
34062,311,717,0,0,0,886600,1
34061,522,202,0,0,0,886600,1
34060,15,719,0,0,0,886600,1
34059,717,130,0,0,0,886600,1
35072,708,673,0,0,0,886600,1
35073,587,164,0,0,0,886600,1
35075,560,475,0,0,0,886600,1
35081,655,668,0,0,0,886600,1
35076,721,433,0,0,0,886600,1
35077,684,1,0,0,0,886600,1
35078,721,409,0,0,0,886600,1
34058,95,137,0,0,0,886600,1
35079,508,307,0,0,0,886600,1
35080,473,703,0,0,0,886600,1
28715,181,334,0,0,0,886600,1
24976,195,543,0,0,0,886600,1
32849,140,160,0,0,0,886600,1
27084,638,261,0,0,0,886600,1
30211,342,219,0,0,0,886600,1
30208,638,720,0,0,0,886600,1
30207,586,624,0,0,0,886600,1
27073,145,392,0,0,0,886600,1
30205,482,427,0,0,0,886600,1
30204,605,319,0,0,0,886600,1
27081,167,614,0,0,0,886600,1
30202,56,569,0,0,0,886600,1
30199,207,56,0,0,0,886600,1
27112,158,721,0,0,0,886600,1
30196,719,609,0,0,0,886600,1
30194,14,269,0,0,0,886600,1
30193,392,64,0,0,0,886600,1
30191,30,525,0,0,0,886600,1
30187,392,614,0,0,0,886600,1
30186,571,230,0,0,0,886600,1
30185,721,155,0,0,0,886600,1
30184,257,379,0,0,0,886600,1
30212,708,414,0,0,0,886600,1
30214,668,552,0,0,0,886600,1
30215,458,414,0,0,0,886600,1
30217,446,593,0,0,0,886600,1
27046,404,605,0,0,0,886600,1
30238,105,257,0,0,0,886600,1
27050,164,544,0,0,0,886600,1
30235,414,494,0,0,0,886600,1
30233,458,155,0,0,0,886600,1
30232,497,624,0,0,0,886600,1
30231,721,593,0,0,0,886600,1
27055,501,661,0,0,0,886600,1
27058,137,663,0,0,0,886600,1
30228,614,181,0,0,0,886600,1
27060,242,383,0,0,0,886600,1
30225,264,689,0,0,0,886600,1
27064,482,586,0,0,0,886600,1
30222,433,588,0,0,0,886600,1
30221,638,492,0,0,0,886600,1
30219,371,535,0,0,0,886600,1
27068,30,137,0,0,0,886600,1
27110,497,552,0,0,0,886600,1
30180,640,202,0,0,0,886600,1
30366,655,207,0,0,0,886600,1
27180,409,529,0,0,0,886600,1
27152,632,4,0,0,0,886600,1
30142,141,15,0,0,0,886600,1
27158,640,503,0,0,0,886600,1
27160,723,105,0,0,0,886600,1
30138,446,141,0,0,0,886600,1
27169,493,347,0,0,0,886600,1
30136,4,446,0,0,0,886600,1
30135,409,140,0,0,0,886600,1
27182,558,458,0,0,0,886600,1
30179,269,22,0,0,0,886600,1
30129,257,596,0,0,0,886600,1
30127,181,404,0,0,0,886600,1
30126,482,174,0,0,0,886600,1
27186,723,522,0,0,0,886600,1
27188,708,404,0,0,0,886600,1
27190,718,471,0,0,0,886600,1
30122,178,13,0,0,0,886600,1
30121,529,193,0,0,0,886600,1
30146,242,261,0,0,0,886600,1
30147,482,439,0,0,0,886600,1
30149,409,682,0,0,0,886600,1
30150,164,714,0,0,0,886600,1
30178,141,22,0,0,0,886600,1
27120,160,632,0,0,0,886600,1
30175,502,207,0,0,0,886600,1
27122,482,145,0,0,0,886600,1
30172,371,9,0,0,0,886600,1
27127,385,475,0,0,0,886600,1
30167,4,494,0,0,0,886600,1
27131,394,661,0,0,0,886600,1
27132,4,156,0,0,0,886600,1
27133,394,569,0,0,0,886600,1
27134,274,160,0,0,0,886600,1
30161,427,618,0,0,0,886600,1
27137,133,640,0,0,0,886600,1
27143,97,265,0,0,0,886600,1
27147,195,498,0,0,0,886600,1
30153,103,560,0,0,0,886600,1
30151,618,12,0,0,0,886600,1
27042,30,246,0,0,0,886600,1
30242,514,701,0,0,0,886600,1
30243,497,1,0,0,0,886600,1
30318,29,552,0,0,0,886600,1
26955,257,354,0,0,0,886600,1
26963,294,446,0,0,0,886600,1
30327,163,133,0,0,0,886600,1
26964,294,224,0,0,0,886600,1
30325,294,328,0,0,0,886600,1
30324,720,398,0,0,0,886600,1
30322,439,714,0,0,0,886600,1
30320,638,646,0,0,0,886600,1
26972,719,398,0,0,0,886600,1
30244,701,586,0,0,0,886600,1
26979,652,48,0,0,0,886600,1
30312,525,446,0,0,0,886600,1
30311,689,181,0,0,0,886600,1
30309,294,535,0,0,0,886600,1
26982,257,107,0,0,0,886600,1
30307,95,503,0,0,0,886600,1
26983,137,532,0,0,0,886600,1
30303,33,503,0,0,0,886600,1
26952,717,379,0,0,0,886600,1
26946,167,236,0,0,0,886600,1
26942,661,535,0,0,0,886600,1
26941,290,475,0,0,0,886600,1
30364,29,624,0,0,0,886600,1
30363,683,164,0,0,0,886600,1
26916,242,171,0,0,0,886600,1
30361,164,133,0,0,0,886600,1
26919,392,295,0,0,0,886600,1
30358,613,638,0,0,0,886600,1
30357,193,264,0,0,0,886600,1
30356,482,242,0,0,0,886600,1
30355,114,319,0,0,0,886600,1
26920,160,155,0,0,0,886600,1
26922,137,77,0,0,0,886600,1
26923,498,668,0,0,0,886600,1
30351,90,640,0,0,0,886600,1
30346,138,708,0,0,0,886600,1
30345,54,20,0,0,0,886600,1
30339,502,155,0,0,0,886600,1
26940,701,265,0,0,0,886600,1
30302,54,265,0,0,0,886600,1
30301,103,26,0,0,0,886600,1
26989,219,90,0,0,0,886600,1
30274,525,364,0,0,0,886600,1
27008,714,123,0,0,0,886600,1
27009,43,261,0,0,0,886600,1
27010,160,307,0,0,0,886600,1
27011,174,528,0,0,0,886600,1
27013,638,246,0,0,0,886600,1
27014,367,673,0,0,0,886600,1
27015,193,439,0,0,0,886600,1
30265,427,593,0,0,0,886600,1
27016,414,137,0,0,0,886600,1
30262,475,673,0,0,0,886600,1
30261,140,193,0,0,0,886600,1
30259,246,171,0,0,0,886600,1
30256,498,207,0,0,0,886600,1
30255,80,342,0,0,0,886600,1
30253,294,529,0,0,0,886600,1
27037,264,507,0,0,0,886600,1
27038,97,22,0,0,0,886600,1
30273,479,409,0,0,0,886600,1
30275,482,364,0,0,0,886600,1
30298,562,525,0,0,0,886600,1
30276,587,141,0,0,0,886600,1
26990,448,586,0,0,0,886600,1
30295,140,1,0,0,0,886600,1
26993,458,498,0,0,0,886600,1
30293,458,497,0,0,0,886600,1
30292,614,571,0,0,0,886600,1
30291,123,19,0,0,0,886600,1
26998,684,84,0,0,0,886600,1
26999,313,433,0,0,0,886600,1
27000,246,264,0,0,0,886600,1
27001,242,552,0,0,0,886600,1
30284,138,632,0,0,0,886600,1
30283,207,404,0,0,0,886600,1
27003,723,310,0,0,0,886600,1
30280,668,398,0,0,0,886600,1
30279,446,414,0,0,0,886600,1
27005,246,558,0,0,0,886600,1
27007,207,264,0,0,0,886600,1
30119,414,332,0,0,0,886600,1
30118,257,502,0,0,0,886600,1
27192,230,433,0,0,0,886600,1
29906,243,85,0,0,0,886600,1
29920,307,178,0,0,0,886600,1
27438,95,202,0,0,0,886600,1
29917,170,517,0,0,0,886600,1
29916,30,593,0,0,0,886600,1
29914,714,404,0,0,0,886600,1
29913,137,404,0,0,0,886600,1
27443,398,171,0,0,0,886600,1
27452,717,335,0,0,0,886600,1
29905,140,64,0,0,0,886600,1
29959,613,164,0,0,0,886600,1
29903,482,689,0,0,0,886600,1
29902,586,290,0,0,0,886600,1
29901,114,178,0,0,0,886600,1
27460,632,242,0,0,0,886600,1
27462,243,181,0,0,0,886600,1
29898,571,331,0,0,0,886600,1
29897,409,307,0,0,0,886600,1
27463,207,397,0,0,0,886600,1
27431,257,50,0,0,0,886600,1
29923,493,155,0,0,0,886600,1
27425,269,723,0,0,0,886600,1
27424,181,588,0,0,0,886600,1
27386,463,124,0,0,0,886600,1
29955,20,269,0,0,0,886600,1
29954,558,19,0,0,0,886600,1
27390,632,12,0,0,0,886600,1
29952,683,414,0,0,0,886600,1
27393,332,5,0,0,0,886600,1
27395,514,155,0,0,0,886600,1
29947,503,544,0,0,0,886600,1
27396,552,4,0,0,0,886600,1
27400,33,269,0,0,0,886600,1
27408,54,586,0,0,0,886600,1
27411,178,48,0,0,0,886600,1
29936,19,130,0,0,0,886600,1
27417,371,77,0,0,0,886600,1
29933,689,4,0,0,0,886600,1
27418,246,497,0,0,0,886600,1
27422,463,43,0,0,0,886600,1
29895,246,4,0,0,0,886600,1
27473,448,64,0,0,0,886600,1
27474,257,243,0,0,0,886600,1
29851,141,414,0,0,0,886600,1
29849,383,552,0,0,0,886600,1
27535,699,236,0,0,0,886600,1
27538,379,181,0,0,0,886600,1
27539,646,663,0,0,0,886600,1
29842,587,131,0,0,0,886600,1
29838,482,683,0,0,0,886600,1
27547,392,145,0,0,0,886600,1
29836,4,23,0,0,0,886600,1
27550,95,178,0,0,0,886600,1
29829,668,502,0,0,0,886600,1
27558,195,243,0,0,0,886600,1
27559,498,525,0,0,0,886600,1
29821,23,522,0,0,0,886600,1
29818,257,544,0,0,0,886600,1
29817,587,175,0,0,0,886600,1
29816,699,605,0,0,0,886600,1
29814,269,543,0,0,0,886600,1
27530,652,310,0,0,0,886600,1
27529,473,133,0,0,0,886600,1
29889,193,682,0,0,0,886600,1
29853,448,170,0,0,0,886600,1
27486,414,29,0,0,0,886600,1
27488,170,68,0,0,0,886600,1
29883,138,683,0,0,0,886600,1
29880,167,121,0,0,0,886600,1
29879,614,684,0,0,0,886600,1
27497,54,638,0,0,0,886600,1
27498,482,532,0,0,0,886600,1
29875,458,393,0,0,0,886600,1
29874,294,397,0,0,0,886600,1
29871,103,571,0,0,0,886600,1
29866,257,130,0,0,0,886600,1
29865,668,683,0,0,0,886600,1
27518,294,552,0,0,0,886600,1
29858,3,371,0,0,0,886600,1
29856,593,43,0,0,0,886600,1
27525,638,178,0,0,0,886600,1
27528,508,473,0,0,0,886600,1
29958,721,133,0,0,0,886600,1
29960,140,20,0,0,0,886600,1
30116,19,392,0,0,0,886600,1
30062,11,319,0,0,0,886600,1
30076,141,34,0,0,0,886600,1
30074,525,56,0,0,0,886600,1
30073,605,174,0,0,0,886600,1
30072,33,576,0,0,0,886600,1
30071,257,105,0,0,0,886600,1
30070,265,85,0,0,0,886600,1
27257,458,50,0,0,0,886600,1
30065,463,525,0,0,0,886600,1
27265,22,427,0,0,0,886600,1
29961,90,265,0,0,0,886600,1
27266,30,433,0,0,0,886600,1
27270,307,569,0,0,0,886600,1
27271,392,307,0,0,0,886600,1
27272,25,261,0,0,0,886600,1
30052,364,593,0,0,0,886600,1
27277,163,269,0,0,0,886600,1
27279,137,558,0,0,0,886600,1
30049,652,10,0,0,0,886600,1
30077,525,560,0,0,0,886600,1
30078,196,673,0,0,0,886600,1
30082,668,414,0,0,0,886600,1
27236,294,380,0,0,0,886600,1
30115,137,655,0,0,0,886600,1
27206,714,6,0,0,0,886600,1
27210,4,493,0,0,0,886600,1
30110,170,30,0,0,0,886600,1
27212,332,242,0,0,0,886600,1
30108,126,379,0,0,0,886600,1
27215,43,25,0,0,0,886600,1
30106,294,587,0,0,0,886600,1
30105,331,626,0,0,0,886600,1
30103,514,174,0,0,0,886600,1
27218,137,529,0,0,0,886600,1
27222,652,77,0,0,0,886600,1
30096,181,105,0,0,0,886600,1
30095,6,525,0,0,0,886600,1
30093,498,721,0,0,0,886600,1
27232,137,11,0,0,0,886600,1
27233,9,160,0,0,0,886600,1
27282,448,497,0,0,0,886600,1
30045,207,22,0,0,0,886600,1
30039,494,68,0,0,0,886600,1
30005,265,569,0,0,0,886600,1
29999,145,23,0,0,0,886600,1
27335,494,443,0,0,0,886600,1
27343,123,138,0,0,0,886600,1
29990,404,1,0,0,0,886600,1
29989,586,181,0,0,0,886600,1
29987,562,138,0,0,0,886600,1
29986,141,236,0,0,0,886600,1
29982,19,29,0,0,0,886600,1
27355,624,529,0,0,0,886600,1
27358,269,558,0,0,0,886600,1
29979,54,307,0,0,0,886600,1
27360,379,103,0,0,0,886600,1
27370,124,114,0,0,0,886600,1
29972,155,163,0,0,0,886600,1
27379,294,393,0,0,0,886600,1
29963,328,171,0,0,0,886600,1
29962,703,640,0,0,0,886600,1
27331,646,158,0,0,0,886600,1
27325,295,43,0,0,0,886600,1
30037,613,614,0,0,0,886600,1
30009,131,85,0,0,0,886600,1
30036,196,246,0,0,0,886600,1
30035,342,501,0,0,0,886600,1
27295,138,14,0,0,0,886600,1
27296,160,117,0,0,0,886600,1
30031,655,103,0,0,0,886600,1
30029,264,661,0,0,0,886600,1
30026,246,674,0,0,0,886600,1
27305,22,689,0,0,0,886600,1
30022,392,497,0,0,0,886600,1
30020,493,562,0,0,0,886600,1
27309,265,2,0,0,0,886600,1
27315,714,130,0,0,0,886600,1
27317,342,310,0,0,0,886600,1
30015,720,397,0,0,0,886600,1
27319,257,582,0,0,0,886600,1
30012,170,674,0,0,0,886600,1
30010,511,714,0,0,0,886600,1
30365,640,178,0,0,0,886600,1
30367,482,543,0,0,0,886600,1
32848,204,138,0,0,0,886600,1
30690,29,193,0,0,0,886600,1
26617,458,544,0,0,0,886600,1
26620,587,9,0,0,0,886600,1
30697,196,332,0,0,0,886600,1
26622,265,138,0,0,0,886600,1
26624,334,20,0,0,0,886600,1
30694,646,613,0,0,0,886600,1
30692,661,443,0,0,0,886600,1
30691,576,33,0,0,0,886600,1
30687,503,562,0,0,0,886600,1
30673,508,498,0,0,0,886600,1
26630,138,714,0,0,0,886600,1
30684,246,307,0,0,0,886600,1
30683,393,90,0,0,0,886600,1
30682,353,701,0,0,0,886600,1
26634,16,458,0,0,0,886600,1
26645,290,673,0,0,0,886600,1
26646,290,103,0,0,0,886600,1
26647,684,26,0,0,0,886600,1
26614,701,3,0,0,0,886600,1
26609,458,673,0,0,0,886600,1
26606,414,174,0,0,0,886600,1
30707,181,427,0,0,0,886600,1
30733,720,404,0,0,0,886600,1
30732,543,613,0,0,0,886600,1
30731,171,682,0,0,0,886600,1
30730,32,138,0,0,0,886600,1
30728,613,307,0,0,0,886600,1
30726,720,274,0,0,0,886600,1
30725,264,29,0,0,0,886600,1
30724,558,568,0,0,0,886600,1
30723,699,514,0,0,0,886600,1
26591,170,174,0,0,0,886600,1
30719,508,196,0,0,0,886600,1
30718,543,12,0,0,0,886600,1
30717,171,593,0,0,0,886600,1
30713,207,652,0,0,0,886600,1
26604,342,167,0,0,0,886600,1
30710,56,571,0,0,0,886600,1
30708,720,674,0,0,0,886600,1
26648,140,618,0,0,0,886600,1
26655,15,12,0,0,0,886600,1
26907,137,331,0,0,0,886600,1
30630,193,529,0,0,0,886600,1
30638,475,493,0,0,0,886600,1
26684,482,295,0,0,0,886600,1
30636,718,302,0,0,0,886600,1
30635,29,529,0,0,0,886600,1
30634,195,250,0,0,0,886600,1
30633,393,290,0,0,0,886600,1
30632,560,674,0,0,0,886600,1
30631,155,439,0,0,0,886600,1
26689,646,242,0,0,0,886600,1
26656,33,342,0,0,0,886600,1
30625,689,269,0,0,0,886600,1
30624,394,673,0,0,0,886600,1
30623,446,404,0,0,0,886600,1
30622,393,458,0,0,0,886600,1
26692,13,175,0,0,0,886600,1
30620,640,458,0,0,0,886600,1
30619,646,507,0,0,0,886600,1
30618,133,618,0,0,0,886600,1
30641,307,124,0,0,0,886600,1
30642,85,655,0,0,0,886600,1
30643,2,714,0,0,0,886600,1
30644,163,290,0,0,0,886600,1
26657,543,23,0,0,0,886600,1
30666,652,243,0,0,0,886600,1
26658,448,158,0,0,0,886600,1
26660,19,404,0,0,0,886600,1
30663,137,164,0,0,0,886600,1
30662,257,443,0,0,0,886600,1
30661,257,3,0,0,0,886600,1
30659,167,328,0,0,0,886600,1
30657,207,319,0,0,0,886600,1
26668,398,482,0,0,0,886600,1
30653,264,90,0,0,0,886600,1
30651,274,458,0,0,0,886600,1
30649,511,178,0,0,0,886600,1
26678,379,492,0,0,0,886600,1
30647,133,126,0,0,0,886600,1
30646,404,5,0,0,0,886600,1
30645,433,473,0,0,0,886600,1
30734,290,26,0,0,0,886600,1
30735,475,19,0,0,0,886600,1
30736,114,409,0,0,0,886600,1
30826,155,646,0,0,0,886600,1
30835,160,587,0,0,0,886600,1
30834,295,137,0,0,0,886600,1
26476,655,160,0,0,0,886600,1
26477,167,544,0,0,0,886600,1
30830,138,528,0,0,0,886600,1
26485,404,492,0,0,0,886600,1
26488,385,482,0,0,0,886600,1
26490,655,85,0,0,0,886600,1
30823,646,261,0,0,0,886600,1
30737,508,380,0,0,0,886600,1
30822,207,175,0,0,0,886600,1
26494,409,479,0,0,0,886600,1
30820,302,19,0,0,0,886600,1
26495,170,20,0,0,0,886600,1
26497,196,4,0,0,0,886600,1
30816,720,236,0,0,0,886600,1
26498,699,68,0,0,0,886600,1
26499,90,682,0,0,0,886600,1
30836,562,103,0,0,0,886600,1
26473,683,29,0,0,0,886600,1
30838,380,719,0,0,0,886600,1
30839,708,124,0,0,0,886600,1
30861,393,371,0,0,0,886600,1
30860,720,250,0,0,0,886600,1
30859,720,393,0,0,0,886600,1
30858,508,171,0,0,0,886600,1
26455,23,385,0,0,0,886600,1
30854,274,701,0,0,0,886600,1
26457,334,508,0,0,0,886600,1
26465,673,569,0,0,0,886600,1
26466,117,409,0,0,0,886600,1
26467,126,33,0,0,0,886600,1
30849,717,77,0,0,0,886600,1
26472,2,503,0,0,0,886600,1
30844,492,682,0,0,0,886600,1
30843,25,1,0,0,0,886600,1
30842,219,178,0,0,0,886600,1
30841,178,290,0,0,0,886600,1
30840,246,638,0,0,0,886600,1
30813,202,514,0,0,0,886600,1
26502,393,332,0,0,0,886600,1
30808,264,593,0,0,0,886600,1
26532,439,683,0,0,0,886600,1
26540,171,668,0,0,0,886600,1
30766,443,19,0,0,0,886600,1
30765,295,458,0,0,0,886600,1
30764,511,332,0,0,0,886600,1
26555,494,6,0,0,0,886600,1
26558,34,493,0,0,0,886600,1
26562,699,295,0,0,0,886600,1
26566,332,97,0,0,0,886600,1
26571,12,85,0,0,0,886600,1
30749,167,502,0,0,0,886600,1
26575,307,661,0,0,0,886600,1
26581,605,475,0,0,0,886600,1
30743,310,178,0,0,0,886600,1
26585,181,310,0,0,0,886600,1
30740,525,562,0,0,0,886600,1
30739,261,624,0,0,0,886600,1
30738,174,652,0,0,0,886600,1
26535,257,27,0,0,0,886600,1
26531,683,544,0,0,0,886600,1
30807,494,204,0,0,0,886600,1
30778,207,392,0,0,0,886600,1
30805,392,85,0,0,0,886600,1
30804,448,552,0,0,0,886600,1
30803,522,19,0,0,0,886600,1
26507,532,569,0,0,0,886600,1
30797,661,482,0,0,0,886600,1
26512,204,720,0,0,0,886600,1
30795,196,613,0,0,0,886600,1
26516,638,458,0,0,0,886600,1
26518,587,80,0,0,0,886600,1
30789,632,392,0,0,0,886600,1
30787,493,274,0,0,0,886600,1
30786,717,689,0,0,0,886600,1
26523,138,348,0,0,0,886600,1
30784,269,3,0,0,0,886600,1
26528,638,714,0,0,0,886600,1
30780,708,12,0,0,0,886600,1
30779,25,137,0,0,0,886600,1
30617,544,392,0,0,0,886600,1
30616,684,414,0,0,0,886600,1
30614,163,446,0,0,0,886600,1
26854,133,482,0,0,0,886600,1
26850,560,640,0,0,0,886600,1
30453,123,202,0,0,0,886600,1
26852,174,294,0,0,0,886600,1
30450,385,163,0,0,0,886600,1
30449,354,342,0,0,0,886600,1
30448,587,236,0,0,0,886600,1
30446,558,138,0,0,0,886600,1
30445,174,107,0,0,0,886600,1
26857,433,20,0,0,0,886600,1
30494,605,103,0,0,0,886600,1
30442,181,448,0,0,0,886600,1
30439,265,593,0,0,0,886600,1
30438,587,158,0,0,0,886600,1
30436,103,605,0,0,0,886600,1
30435,609,560,0,0,0,886600,1
30434,443,492,0,0,0,886600,1
30432,137,33,0,0,0,886600,1
26864,525,514,0,0,0,886600,1
30455,463,138,0,0,0,886600,1
26849,155,114,0,0,0,886600,1
30457,609,332,0,0,0,886600,1
30462,313,138,0,0,0,886600,1
26812,494,158,0,0,0,886600,1
30490,393,668,0,0,0,886600,1
30489,23,33,0,0,0,886600,1
30488,661,528,0,0,0,886600,1
13063,4,242,0,0,0,886600,1
30486,587,497,0,0,0,886600,1
26820,302,133,0,0,0,886600,1
26825,170,398,0,0,0,886600,1
30479,661,609,0,0,0,886600,1
26827,543,332,0,0,0,886600,1
26831,689,90,0,0,0,886600,1
26836,517,174,0,0,0,886600,1
30470,626,543,0,0,0,886600,1
30469,25,613,0,0,0,886600,1
30468,137,50,0,0,0,886600,1
30465,433,9,0,0,0,886600,1
30464,243,319,0,0,0,886600,1
30428,195,242,0,0,0,886600,1
30425,30,684,0,0,0,886600,1
30424,714,141,0,0,0,886600,1
26897,701,331,0,0,0,886600,1
30391,5,646,0,0,0,886600,1
30390,196,514,0,0,0,886600,1
30389,342,307,0,0,0,886600,1
30388,684,364,0,0,0,886600,1
30387,588,138,0,0,0,886600,1
26898,64,414,0,0,0,886600,1
26899,23,68,0,0,0,886600,1
30384,114,587,0,0,0,886600,1
30383,97,202,0,0,0,886600,1
30381,14,493,0,0,0,886600,1
30380,294,265,0,0,0,886600,1
30379,586,90,0,0,0,886600,1
30378,614,433,0,0,0,886600,1
30377,181,335,0,0,0,886600,1
30375,257,328,0,0,0,886600,1
30374,618,392,0,0,0,886600,1
30373,257,77,0,0,0,886600,1
30392,379,525,0,0,0,886600,1
30396,48,624,0,0,0,886600,1
30423,126,164,0,0,0,886600,1
30398,683,632,0,0,0,886600,1
30422,137,48,0,0,0,886600,1
30421,269,392,0,0,0,886600,1
30419,646,274,0,0,0,886600,1
26869,502,475,0,0,0,886600,1
30417,137,313,0,0,0,886600,1
26874,535,181,0,0,0,886600,1
30415,511,414,0,0,0,886600,1
30414,48,433,0,0,0,886600,1
26877,43,446,0,0,0,886600,1
30411,398,525,0,0,0,886600,1
30409,328,103,0,0,0,886600,1
26880,661,84,0,0,0,886600,1
30404,525,23,0,0,0,886600,1
26888,26,294,0,0,0,886600,1
26889,398,167,0,0,0,886600,1
26890,155,514,0,0,0,886600,1
26891,674,138,0,0,0,886600,1
30493,155,383,0,0,0,886600,1
26803,632,576,0,0,0,886600,1
30612,652,204,0,0,0,886600,1
30573,97,613,0,0,0,886600,1
30584,124,511,0,0,0,886600,1
30582,174,23,0,0,0,886600,1
30581,126,614,0,0,0,886600,1
30579,54,605,0,0,0,886600,1
30577,714,204,0,0,0,886600,1
30576,264,528,0,0,0,886600,1
30575,269,471,0,0,0,886600,1
30574,494,26,0,0,0,886600,1
30572,689,246,0,0,0,886600,1
30496,528,261,0,0,0,886600,1
30571,97,569,0,0,0,886600,1
26724,668,196,0,0,0,886600,1
30568,562,13,0,0,0,886600,1
30567,409,22,0,0,0,886600,1
30560,290,640,0,0,0,886600,1
26735,64,204,0,0,0,886600,1
30557,699,609,0,0,0,886600,1
30556,494,558,0,0,0,886600,1
30585,439,409,0,0,0,886600,1
30586,661,427,0,0,0,886600,1
30589,114,673,0,0,0,886600,1
30591,721,535,0,0,0,886600,1
30611,202,609,0,0,0,886600,1
30610,364,332,0,0,0,886600,1
30609,699,353,0,0,0,886600,1
30608,674,525,0,0,0,886600,1
30607,124,404,0,0,0,886600,1
30606,342,471,0,0,0,886600,1
26697,163,646,0,0,0,886600,1
30603,682,624,0,0,0,886600,1
26701,571,80,0,0,0,886600,1
30601,640,138,0,0,0,886600,1
30600,107,576,0,0,0,886600,1
26708,640,23,0,0,0,886600,1
30597,56,448,0,0,0,886600,1
26711,501,85,0,0,0,886600,1
26713,68,668,0,0,0,886600,1
26714,264,364,0,0,0,886600,1
30592,414,195,0,0,0,886600,1
30555,562,392,0,0,0,886600,1
30554,497,652,0,0,0,886600,1
30553,219,701,0,0,0,886600,1
26791,414,673,0,0,0,886600,1
30514,626,640,0,0,0,886600,1
30513,646,25,0,0,0,886600,1
26796,609,652,0,0,0,886600,1
30510,156,576,0,0,0,886600,1
30509,16,576,0,0,0,886600,1
30508,448,265,0,0,0,886600,1
26798,105,458,0,0,0,886600,1
30506,371,471,0,0,0,886600,1
30505,529,175,0,0,0,886600,1
30504,290,242,0,0,0,886600,1
26800,646,145,0,0,0,886600,1
30502,576,379,0,0,0,886600,1
30501,14,528,0,0,0,886600,1
30500,532,202,0,0,0,886600,1
30499,535,160,0,0,0,886600,1
26801,640,19,0,0,0,886600,1
26802,114,20,0,0,0,886600,1
30515,717,552,0,0,0,886600,1
26789,290,586,0,0,0,886600,1
26739,145,624,0,0,0,886600,1
30521,673,181,0,0,0,886600,1
26742,19,167,0,0,0,886600,1
30549,103,164,0,0,0,886600,1
30547,661,708,0,0,0,886600,1
26744,290,20,0,0,0,886600,1
26746,582,458,0,0,0,886600,1
30544,302,371,0,0,0,886600,1
30543,446,364,0,0,0,886600,1
30542,332,269,0,0,0,886600,1
26749,640,684,0,0,0,886600,1
26756,380,626,0,0,0,886600,1
26763,497,493,0,0,0,886600,1
30535,290,130,0,0,0,886600,1
30533,560,638,0,0,0,886600,1
30532,701,280,0,0,0,886600,1
26776,609,525,0,0,0,886600,1
30528,257,638,0,0,0,886600,1
30527,170,682,0,0,0,886600,1
27574,723,473,0,0,0,886600,1
27577,280,290,0,0,0,886600,1
29810,517,167,0,0,0,886600,1
29065,661,562,0,0,0,886600,1
28332,614,569,0,0,0,886600,1
29073,473,458,0,0,0,886600,1
29072,195,114,0,0,0,886600,1
29071,427,661,0,0,0,886600,1
29070,511,207,0,0,0,886600,1
29069,475,613,0,0,0,886600,1
29068,371,131,0,0,0,886600,1
29066,133,246,0,0,0,886600,1
29061,34,261,0,0,0,886600,1
29046,64,141,0,0,0,886600,1
29060,50,493,0,0,0,886600,1
28345,294,158,0,0,0,886600,1
28351,163,6,0,0,0,886600,1
29055,494,475,0,0,0,886600,1
29054,663,494,0,0,0,886600,1
28353,332,20,0,0,0,886600,1
29051,514,137,0,0,0,886600,1
29050,682,482,0,0,0,886600,1
28328,117,170,0,0,0,886600,1
29077,683,5,0,0,0,886600,1
28324,582,124,0,0,0,886600,1
28319,246,723,0,0,0,886600,1
29109,246,511,0,0,0,886600,1
29108,613,264,0,0,0,886600,1
28288,12,29,0,0,0,886600,1
28295,207,130,0,0,0,886600,1
28297,138,640,0,0,0,886600,1
28299,11,494,0,0,0,886600,1
29099,409,560,0,0,0,886600,1
28306,682,140,0,0,0,886600,1
29094,302,492,0,0,0,886600,1
28308,250,171,0,0,0,886600,1
28312,160,640,0,0,0,886600,1
29090,471,668,0,0,0,886600,1
29089,175,655,0,0,0,886600,1
28313,4,568,0,0,0,886600,1
28314,32,494,0,0,0,886600,1
28315,684,264,0,0,0,886600,1
28318,708,246,0,0,0,886600,1
29048,392,274,0,0,0,886600,1
28357,193,433,0,0,0,886600,1
29809,280,137,0,0,0,886600,1
28396,353,720,0,0,0,886600,1
29015,114,12,0,0,0,886600,1
29013,6,163,0,0,0,886600,1
29012,85,4,0,0,0,886600,1
28381,4,552,0,0,0,886600,1
28391,397,446,0,0,0,886600,1
29005,155,103,0,0,0,886600,1
29003,494,307,0,0,0,886600,1
29002,11,193,0,0,0,886600,1
29000,668,5,0,0,0,886600,1
29044,97,332,0,0,0,886600,1
28399,84,319,0,0,0,886600,1
28400,684,683,0,0,0,886600,1
28403,236,43,0,0,0,886600,1
28994,673,409,0,0,0,886600,1
28404,307,175,0,0,0,886600,1
28991,482,632,0,0,0,886600,1
28990,638,163,0,0,0,886600,1
28406,174,661,0,0,0,886600,1
29016,587,393,0,0,0,886600,1
29018,170,196,0,0,0,886600,1
28374,569,522,0,0,0,886600,1
28373,383,525,0,0,0,886600,1
28360,242,482,0,0,0,886600,1
28361,683,207,0,0,0,886600,1
29039,195,544,0,0,0,886600,1
29038,683,439,0,0,0,886600,1
29036,699,264,0,0,0,886600,1
28365,367,290,0,0,0,886600,1
29034,720,529,0,0,0,886600,1
29032,265,371,0,0,0,886600,1
28368,364,12,0,0,0,886600,1
28369,264,383,0,0,0,886600,1
28370,4,661,0,0,0,886600,1
29027,593,193,0,0,0,886600,1
28371,632,261,0,0,0,886600,1
29025,439,43,0,0,0,886600,1
29024,640,624,0,0,0,886600,1
29022,409,514,0,0,0,886600,1
29021,138,638,0,0,0,886600,1
29110,720,114,0,0,0,886600,1
29111,364,85,0,0,0,886600,1
28287,668,714,0,0,0,886600,1
28196,202,243,0,0,0,886600,1
29214,140,261,0,0,0,886600,1
29212,193,652,0,0,0,886600,1
28191,294,155,0,0,0,886600,1
29210,163,543,0,0,0,886600,1
29209,479,23,0,0,0,886600,1
28192,723,80,0,0,0,886600,1
28194,155,661,0,0,0,886600,1
28195,54,517,0,0,0,886600,1
29203,167,414,0,0,0,886600,1
29113,494,33,0,0,0,886600,1
29202,265,90,0,0,0,886600,1
29198,458,174,0,0,0,886600,1
29197,48,319,0,0,0,886600,1
28209,265,721,0,0,0,886600,1
29193,163,493,0,0,0,886600,1
29192,103,427,0,0,0,886600,1
29190,371,68,0,0,0,886600,1
29188,257,56,0,0,0,886600,1
28189,723,193,0,0,0,886600,1
29218,494,529,0,0,0,886600,1
29220,342,498,0,0,0,886600,1
29221,170,29,0,0,0,886600,1
28162,723,34,0,0,0,886600,1
28163,257,385,0,0,0,886600,1
29240,141,264,0,0,0,886600,1
28171,571,394,0,0,0,886600,1
28172,246,562,0,0,0,886600,1
28175,544,525,0,0,0,886600,1
28176,714,121,0,0,0,886600,1
28178,544,85,0,0,0,886600,1
29230,482,605,0,0,0,886600,1
29229,261,20,0,0,0,886600,1
29228,576,380,0,0,0,886600,1
29227,195,560,0,0,0,886600,1
29226,609,195,0,0,0,886600,1
28182,269,544,0,0,0,886600,1
29224,195,181,0,0,0,886600,1
29223,175,54,0,0,0,886600,1
29222,661,638,0,0,0,886600,1
28215,193,605,0,0,0,886600,1
29184,331,178,0,0,0,886600,1
28221,571,497,0,0,0,886600,1
28242,90,121,0,0,0,886600,1
28244,23,348,0,0,0,886600,1
29146,269,95,0,0,0,886600,1
29144,720,95,0,0,0,886600,1
29141,618,652,0,0,0,886600,1
29137,207,682,0,0,0,886600,1
29135,719,328,0,0,0,886600,1
29134,257,33,0,0,0,886600,1
29130,126,311,0,0,0,886600,1
29129,717,56,0,0,0,886600,1
29127,448,243,0,0,0,886600,1
29126,507,181,0,0,0,886600,1
29125,494,471,0,0,0,886600,1
28277,383,246,0,0,0,886600,1
28280,290,158,0,0,0,886600,1
28281,29,274,0,0,0,886600,1
29117,12,448,0,0,0,886600,1
28284,613,64,0,0,0,886600,1
29153,20,626,0,0,0,886600,1
29155,661,367,0,0,0,886600,1
29182,19,181,0,0,0,886600,1
29156,26,448,0,0,0,886600,1
28224,385,64,0,0,0,886600,1
28226,269,587,0,0,0,886600,1
29176,33,494,0,0,0,886600,1
29174,174,242,0,0,0,886600,1
29173,167,178,0,0,0,886600,1
28231,571,507,0,0,0,886600,1
29171,674,174,0,0,0,886600,1
28232,508,638,0,0,0,886600,1
28233,246,34,0,0,0,886600,1
28235,571,13,0,0,0,886600,1
28236,1,12,0,0,0,886600,1
28237,501,684,0,0,0,886600,1
29164,661,250,0,0,0,886600,1
29162,392,646,0,0,0,886600,1
29160,4,174,0,0,0,886600,1
29158,347,482,0,0,0,886600,1
29157,257,335,0,0,0,886600,1
28408,117,34,0,0,0,886600,1
28410,2,514,0,0,0,886600,1
28413,535,19,0,0,0,886600,1
28619,137,302,0,0,0,886600,1
28601,511,1,0,0,0,886600,1
28818,246,12,0,0,0,886600,1
28817,174,114,0,0,0,886600,1
28605,508,158,0,0,0,886600,1
28812,609,155,0,0,0,886600,1
28811,334,409,0,0,0,886600,1
28610,497,195,0,0,0,886600,1
28614,668,364,0,0,0,886600,1
28620,683,682,0,0,0,886600,1
28548,439,261,0,0,0,886600,1
28621,475,717,0,0,0,886600,1
28800,701,56,0,0,0,886600,1
28798,593,126,0,0,0,886600,1
28624,121,261,0,0,0,886600,1
28626,529,138,0,0,0,886600,1
28630,1,458,0,0,0,886600,1
28791,334,544,0,0,0,886600,1
28790,532,207,0,0,0,886600,1
28600,342,121,0,0,0,886600,1
28599,593,661,0,0,0,886600,1
28822,261,708,0,0,0,886600,1
28596,133,571,0,0,0,886600,1
28852,383,560,0,0,0,886600,1
28851,196,133,0,0,0,886600,1
28552,175,10,0,0,0,886600,1
28849,448,264,0,0,0,886600,1
28848,207,501,0,0,0,886600,1
28553,719,502,0,0,0,886600,1
28843,257,471,0,0,0,886600,1
28842,448,174,0,0,0,886600,1
28562,137,16,0,0,0,886600,1
28840,137,10,0,0,0,886600,1
28836,448,353,0,0,0,886600,1
28567,507,137,0,0,0,886600,1
28572,682,525,0,0,0,886600,1
28577,404,560,0,0,0,886600,1
28581,332,609,0,0,0,886600,1
28584,19,11,0,0,0,886600,1
28585,294,103,0,0,0,886600,1
28789,525,348,0,0,0,886600,1
28633,668,13,0,0,0,886600,1
28635,699,497,0,0,0,886600,1
28684,525,121,0,0,0,886600,1
28742,2,85,0,0,0,886600,1
28740,257,479,0,0,0,886600,1
28694,397,138,0,0,0,886600,1
28737,717,393,0,0,0,886600,1
28695,655,624,0,0,0,886600,1
28735,167,517,0,0,0,886600,1
28696,699,25,0,0,0,886600,1
28698,124,170,0,0,0,886600,1
28701,175,498,0,0,0,886600,1
28730,295,269,0,0,0,886600,1
28705,137,105,0,0,0,886600,1
28726,668,586,0,0,0,886600,1
28725,568,32,0,0,0,886600,1
28722,652,367,0,0,0,886600,1
28721,371,335,0,0,0,886600,1
28712,525,117,0,0,0,886600,1
28713,414,525,0,0,0,886600,1
28687,121,683,0,0,0,886600,1
28747,22,646,0,0,0,886600,1
28785,618,514,0,0,0,886600,1
28748,720,544,0,0,0,886600,1
28784,383,632,0,0,0,886600,1
28642,137,582,0,0,0,886600,1
28779,714,33,0,0,0,886600,1
28645,482,121,0,0,0,886600,1
28647,138,514,0,0,0,886600,1
28774,307,163,0,0,0,886600,1
28773,84,178,0,0,0,886600,1
28652,397,202,0,0,0,886600,1
28768,367,624,0,0,0,886600,1
28656,719,673,0,0,0,886600,1
28764,560,313,0,0,0,886600,1
28658,25,90,0,0,0,886600,1
28661,264,97,0,0,0,886600,1
28662,723,280,0,0,0,886600,1
28674,385,156,0,0,0,886600,1
28676,701,295,0,0,0,886600,1
28681,332,562,0,0,0,886600,1
28551,9,684,0,0,0,886600,1
28857,393,137,0,0,0,886600,1
28417,90,439,0,0,0,886600,1
28456,9,719,0,0,0,886600,1
28444,174,502,0,0,0,886600,1
28949,181,558,0,0,0,886600,1
28948,613,5,0,0,0,886600,1
28452,181,479,0,0,0,886600,1
28943,90,501,0,0,0,886600,1
28454,529,661,0,0,0,886600,1
28941,508,19,0,0,0,886600,1
28455,364,15,0,0,0,886600,1
28459,646,492,0,0,0,886600,1
28858,290,532,0,0,0,886600,1
28936,19,398,0,0,0,886600,1
28935,294,97,0,0,0,886600,1
28933,571,50,0,0,0,886600,1
28930,587,32,0,0,0,886600,1
28471,699,522,0,0,0,886600,1
28925,446,56,0,0,0,886600,1
28473,138,54,0,0,0,886600,1
28922,163,295,0,0,0,886600,1
28441,552,569,0,0,0,886600,1
28955,393,652,0,0,0,886600,1
28957,160,97,0,0,0,886600,1
28439,458,364,0,0,0,886600,1
28981,494,609,0,0,0,886600,1
28980,257,383,0,0,0,886600,1
28979,3,138,0,0,0,886600,1
28418,503,137,0,0,0,886600,1
28976,174,250,0,0,0,886600,1
28422,668,507,0,0,0,886600,1
28974,720,1,0,0,0,886600,1
28973,446,532,0,0,0,886600,1
28970,552,624,0,0,0,886600,1
28969,624,25,0,0,0,886600,1
28429,717,158,0,0,0,886600,1
28964,371,586,0,0,0,886600,1
28434,5,525,0,0,0,886600,1
28437,160,689,0,0,0,886600,1
28961,439,103,0,0,0,886600,1
28438,508,170,0,0,0,886600,1
28959,34,332,0,0,0,886600,1
28478,332,475,0,0,0,886600,1
28920,723,10,0,0,0,886600,1
28481,2,593,0,0,0,886600,1
28502,492,392,0,0,0,886600,1
28889,385,1,0,0,0,886600,1
28888,170,50,0,0,0,886600,1
28887,392,708,0,0,0,886600,1
28883,294,236,0,0,0,886600,1
28880,446,171,0,0,0,886600,1
28512,140,503,0,0,0,886600,1
28876,652,348,0,0,0,886600,1
28522,652,3,0,0,0,886600,1
28523,43,507,0,0,0,886600,1
28871,23,393,0,0,0,886600,1
28525,718,174,0,0,0,886600,1
28526,246,68,0,0,0,886600,1
28527,250,319,0,0,0,886600,1
28530,624,719,0,0,0,886600,1
28536,167,13,0,0,0,886600,1
28540,12,494,0,0,0,886600,1
28544,342,295,0,0,0,886600,1
28890,562,290,0,0,0,886600,1
28892,307,332,0,0,0,886600,1
28917,90,246,0,0,0,886600,1
28496,482,614,0,0,0,886600,1
28483,661,385,0,0,0,886600,1
28484,475,202,0,0,0,886600,1
28913,156,332,0,0,0,886600,1
28485,90,614,0,0,0,886600,1
28911,446,439,0,0,0,886600,1
28486,507,528,0,0,0,886600,1
28487,544,661,0,0,0,886600,1
28908,714,385,0,0,0,886600,1
28488,22,13,0,0,0,886600,1
28490,334,383,0,0,0,886600,1
28904,347,414,0,0,0,886600,1
28903,532,494,0,0,0,886600,1
28492,269,242,0,0,0,886600,1
28901,85,302,0,0,0,886600,1
28493,19,385,0,0,0,886600,1
28494,560,522,0,0,0,886600,1
28897,502,708,0,0,0,886600,1
28160,587,394,0,0,0,886600,1
28156,123,684,0,0,0,886600,1
29247,31,133,0,0,0,886600,1
29617,138,475,0,0,0,886600,1
27765,54,347,0,0,0,886600,1
29626,525,535,0,0,0,886600,1
27766,473,719,0,0,0,886600,1
29624,164,138,0,0,0,886600,1
29623,90,1,0,0,0,886600,1
29622,392,14,0,0,0,886600,1
29621,342,243,0,0,0,886600,1
29620,105,721,0,0,0,886600,1
27769,181,3,0,0,0,886600,1
29672,385,140,0,0,0,886600,1
29615,522,137,0,0,0,886600,1
27772,56,163,0,0,0,886600,1
27774,582,371,0,0,0,886600,1
29611,54,202,0,0,0,886600,1
27776,54,632,0,0,0,886600,1
27777,522,448,0,0,0,886600,1
29605,718,105,0,0,0,886600,1
29601,714,514,0,0,0,886600,1
29628,721,137,0,0,0,886600,1
29629,138,508,0,0,0,886600,1
29631,97,673,0,0,0,886600,1
29632,404,137,0,0,0,886600,1
29670,265,1,0,0,0,886600,1
27724,261,562,0,0,0,886600,1
29664,475,133,0,0,0,886600,1
29662,719,29,0,0,0,886600,1
27735,652,84,0,0,0,886600,1
29658,204,383,0,0,0,886600,1
29657,269,638,0,0,0,886600,1
29656,446,398,0,0,0,886600,1
29652,332,682,0,0,0,886600,1
29651,393,43,0,0,0,886600,1
29649,80,571,0,0,0,886600,1
29648,605,560,0,0,0,886600,1
29647,719,517,0,0,0,886600,1
29646,714,114,0,0,0,886600,1
27744,97,25,0,0,0,886600,1
29638,257,311,0,0,0,886600,1
27757,124,50,0,0,0,886600,1
29600,175,353,0,0,0,886600,1
29598,160,471,0,0,0,886600,1
27792,492,517,0,0,0,886600,1
29561,448,294,0,0,0,886600,1
29558,25,294,0,0,0,886600,1
29557,646,503,0,0,0,886600,1
27836,257,588,0,0,0,886600,1
27837,264,683,0,0,0,886600,1
29554,503,638,0,0,0,886600,1
29553,723,97,0,0,0,886600,1
27839,224,684,0,0,0,886600,1
27842,640,163,0,0,0,886600,1
29549,492,427,0,0,0,886600,1
29548,97,138,0,0,0,886600,1
29547,646,661,0,0,0,886600,1
29546,571,618,0,0,0,886600,1
29544,494,497,0,0,0,886600,1
27849,613,593,0,0,0,886600,1
27850,614,261,0,0,0,886600,1
27858,528,525,0,0,0,886600,1
29539,246,20,0,0,0,886600,1
27834,525,164,0,0,0,886600,1
29564,43,409,0,0,0,886600,1
29595,307,701,0,0,0,886600,1
29565,663,202,0,0,0,886600,1
29592,342,562,0,0,0,886600,1
27796,385,12,0,0,0,886600,1
27797,280,342,0,0,0,886600,1
29587,714,655,0,0,0,886600,1
27801,446,11,0,0,0,886600,1
29584,264,427,0,0,0,886600,1
27812,207,171,0,0,0,886600,1
27814,684,398,0,0,0,886600,1
29578,714,609,0,0,0,886600,1
27817,708,528,0,0,0,886600,1
29573,689,618,0,0,0,886600,1
29572,448,26,0,0,0,886600,1
29570,90,655,0,0,0,886600,1
27827,717,588,0,0,0,886600,1
27828,170,97,0,0,0,886600,1
27830,398,193,0,0,0,886600,1
27831,427,493,0,0,0,886600,1
29671,171,319,0,0,0,886600,1
29674,25,493,0,0,0,886600,1
29536,503,155,0,0,0,886600,1
27630,133,56,0,0,0,886600,1
29776,503,414,0,0,0,886600,1
27614,689,178,0,0,0,886600,1
29772,674,493,0,0,0,886600,1
29770,508,34,0,0,0,886600,1
27624,84,624,0,0,0,886600,1
29766,138,114,0,0,0,886600,1
27629,264,475,0,0,0,886600,1
29763,332,507,0,0,0,886600,1
29761,558,613,0,0,0,886600,1
29675,668,632,0,0,0,886600,1
29759,175,471,0,0,0,886600,1
29758,683,482,0,0,0,886600,1
27634,528,708,0,0,0,886600,1
29756,439,140,0,0,0,886600,1
27635,261,25,0,0,0,886600,1
29754,494,463,0,0,0,886600,1
27637,699,6,0,0,0,886600,1
29752,507,246,0,0,0,886600,1
27612,5,242,0,0,0,886600,1
27608,552,103,0,0,0,886600,1
29783,613,348,0,0,0,886600,1
27602,609,448,0,0,0,886600,1
27578,14,364,0,0,0,886600,1
27581,684,250,0,0,0,886600,1
29806,196,383,0,0,0,886600,1
29805,160,4,0,0,0,886600,1
27583,264,646,0,0,0,886600,1
29803,138,34,0,0,0,886600,1
29800,718,155,0,0,0,886600,1
29798,558,178,0,0,0,886600,1
29797,571,123,0,0,0,886600,1
27589,163,479,0,0,0,886600,1
27592,332,517,0,0,0,886600,1
27593,207,250,0,0,0,886600,1
29791,334,12,0,0,0,886600,1
29789,613,674,0,0,0,886600,1
29787,699,463,0,0,0,886600,1
29786,195,576,0,0,0,886600,1
27600,528,632,0,0,0,886600,1
29750,133,137,0,0,0,886600,1
29749,29,682,0,0,0,886600,1
29746,708,23,0,0,0,886600,1
29705,294,26,0,0,0,886600,1
27684,605,640,0,0,0,886600,1
29702,23,586,0,0,0,886600,1
29701,175,123,0,0,0,886600,1
27686,246,482,0,0,0,886600,1
27687,269,117,0,0,0,886600,1
29694,332,34,0,0,0,886600,1
27692,720,107,0,0,0,886600,1
27694,171,163,0,0,0,886600,1
29690,714,335,0,0,0,886600,1
29688,145,409,0,0,0,886600,1
29686,68,342,0,0,0,886600,1
29685,95,448,0,0,0,886600,1
27700,164,409,0,0,0,886600,1
27701,379,175,0,0,0,886600,1
27702,158,133,0,0,0,886600,1
29677,371,394,0,0,0,886600,1
29676,719,170,0,0,0,886600,1
27683,394,294,0,0,0,886600,1
29706,138,130,0,0,0,886600,1
29742,155,265,0,0,0,886600,1
27680,458,427,0,0,0,886600,1
27647,353,721,0,0,0,886600,1
29739,508,26,0,0,0,886600,1
29736,701,26,0,0,0,886600,1
29735,85,348,0,0,0,886600,1
29734,95,269,0,0,0,886600,1
29731,560,145,0,0,0,886600,1
29730,683,196,0,0,0,886600,1
29729,492,54,0,0,0,886600,1
27654,517,178,0,0,0,886600,1
27657,517,193,0,0,0,886600,1
29725,13,646,0,0,0,886600,1
27665,463,528,0,0,0,886600,1
29717,482,14,0,0,0,886600,1
29716,605,613,0,0,0,886600,1
27670,313,137,0,0,0,886600,1
27671,364,723,0,0,0,886600,1
12098,364,307,0,0,0,886600,1
27860,257,404,0,0,0,886600,1
27865,10,720,0,0,0,886600,1
29248,307,525,0,0,0,886600,1
29331,246,145,0,0,0,886600,1
29343,257,655,0,0,0,886600,1
28051,164,4,0,0,0,886600,1
28052,193,269,0,0,0,886600,1
29338,23,479,0,0,0,886600,1
29337,175,414,0,0,0,886600,1
29334,439,207,0,0,0,886600,1
29333,448,543,0,0,0,886600,1
28065,383,544,0,0,0,886600,1
28070,274,137,0,0,0,886600,1
29380,171,720,0,0,0,886600,1
28079,242,646,0,0,0,886600,1
29322,181,48,0,0,0,886600,1
29318,126,475,0,0,0,886600,1
28087,699,683,0,0,0,886600,1
28088,718,543,0,0,0,886600,1
29315,246,517,0,0,0,886600,1
29314,126,638,0,0,0,886600,1
28092,141,501,0,0,0,886600,1
29346,97,124,0,0,0,886600,1
29348,257,264,0,0,0,886600,1
29349,54,140,0,0,0,886600,1
29352,522,458,0,0,0,886600,1
28020,646,295,0,0,0,886600,1
28023,19,511,0,0,0,886600,1
29374,25,103,0,0,0,886600,1
29373,439,507,0,0,0,886600,1
29372,133,12,0,0,0,886600,1
29371,140,155,0,0,0,886600,1
28025,160,507,0,0,0,886600,1
29365,246,632,0,0,0,886600,1
28034,385,5,0,0,0,886600,1
29361,140,12,0,0,0,886600,1
28037,414,138,0,0,0,886600,1
28038,409,605,0,0,0,886600,1
29358,137,224,0,0,0,886600,1
29357,385,624,0,0,0,886600,1
29356,257,224,0,0,0,886600,1
29354,714,230,0,0,0,886600,1
29353,19,156,0,0,0,886600,1
29311,508,77,0,0,0,886600,1
29310,34,576,0,0,0,886600,1
28094,507,569,0,0,0,886600,1
29284,699,404,0,0,0,886600,1
28125,582,19,0,0,0,886600,1
28127,576,582,0,0,0,886600,1
29274,684,618,0,0,0,886600,1
29273,123,43,0,0,0,886600,1
29272,22,30,0,0,0,886600,1
29270,257,503,0,0,0,886600,1
29269,95,163,0,0,0,886600,1
29268,640,433,0,0,0,886600,1
28133,342,394,0,0,0,886600,1
28137,332,364,0,0,0,886600,1
28138,458,3,0,0,0,886600,1
29258,383,409,0,0,0,886600,1
28145,342,302,0,0,0,886600,1
28149,668,587,0,0,0,886600,1
29255,164,160,0,0,0,886600,1
29254,514,525,0,0,0,886600,1
29252,310,571,0,0,0,886600,1
29279,236,138,0,0,0,886600,1
29285,626,558,0,0,0,886600,1
29307,507,261,0,0,0,886600,1
29288,618,446,0,0,0,886600,1
28097,195,2,0,0,0,886600,1
29305,475,668,0,0,0,886600,1
28098,543,446,0,0,0,886600,1
29303,609,618,0,0,0,886600,1
28101,379,160,0,0,0,886600,1
28103,618,23,0,0,0,886600,1
29300,246,1,0,0,0,886600,1
28104,261,14,0,0,0,886600,1
29298,342,479,0,0,0,886600,1
29297,178,508,0,0,0,886600,1
28106,140,508,0,0,0,886600,1
29295,618,246,0,0,0,886600,1
29294,95,19,0,0,0,886600,1
28108,482,97,0,0,0,886600,1
28109,170,614,0,0,0,886600,1
28113,6,90,0,0,0,886600,1
29289,446,167,0,0,0,886600,1
29379,717,313,0,0,0,886600,1
29381,494,364,0,0,0,886600,1
27866,121,661,0,0,0,886600,1
29485,242,137,0,0,0,886600,1
29497,393,202,0,0,0,886600,1
27902,174,571,0,0,0,886600,1
29495,640,576,0,0,0,886600,1
27906,137,502,0,0,0,886600,1
29491,443,719,0,0,0,886600,1
29490,446,107,0,0,0,886600,1
29489,16,103,0,0,0,886600,1
27907,613,404,0,0,0,886600,1
27915,463,19,0,0,0,886600,1
29383,587,331,0,0,0,886600,1
29483,22,175,0,0,0,886600,1
27916,668,164,0,0,0,886600,1
27925,714,497,0,0,0,886600,1
29476,446,236,0,0,0,886600,1
27929,397,701,0,0,0,886600,1
29471,1,409,0,0,0,886600,1
27934,458,535,0,0,0,886600,1
29467,661,532,0,0,0,886600,1
29498,552,163,0,0,0,886600,1
29500,626,123,0,0,0,886600,1
29501,2,673,0,0,0,886600,1
27898,522,160,0,0,0,886600,1
27869,385,22,0,0,0,886600,1
29532,32,90,0,0,0,886600,1
27870,257,9,0,0,0,886600,1
29530,174,439,0,0,0,886600,1
27871,117,701,0,0,0,886600,1
27872,689,175,0,0,0,886600,1
27873,404,319,0,0,0,886600,1
27879,721,140,0,0,0,886600,1
27882,624,121,0,0,0,886600,1
29519,699,156,0,0,0,886600,1
27883,34,19,0,0,0,886600,1
29516,587,68,0,0,0,886600,1
29514,439,12,0,0,0,886600,1
27888,34,684,0,0,0,886600,1
27893,257,529,0,0,0,886600,1
27896,525,64,0,0,0,886600,1
27897,13,54,0,0,0,886600,1
29465,141,638,0,0,0,886600,1
27936,668,673,0,0,0,886600,1
29463,354,175,0,0,0,886600,1
29421,348,494,0,0,0,886600,1
27982,31,332,0,0,0,886600,1
29414,126,334,0,0,0,886600,1
27983,12,13,0,0,0,886600,1
27984,618,404,0,0,0,886600,1
29411,163,332,0,0,0,886600,1
29409,494,723,0,0,0,886600,1
27987,131,90,0,0,0,886600,1
29403,167,294,0,0,0,886600,1
27994,290,126,0,0,0,886600,1
29401,15,23,0,0,0,886600,1
29400,4,138,0,0,0,886600,1
29399,525,571,0,0,0,886600,1
27995,269,614,0,0,0,886600,1
28003,614,492,0,0,0,886600,1
29390,95,720,0,0,0,886600,1
28010,264,34,0,0,0,886600,1
28016,171,269,0,0,0,886600,1
29420,23,155,0,0,0,886600,1
29423,646,605,0,0,0,886600,1
29458,295,719,0,0,0,886600,1
29424,717,121,0,0,0,886600,1
29454,492,543,0,0,0,886600,1
29451,155,448,0,0,0,886600,1
29450,492,569,0,0,0,886600,1
29444,497,392,0,0,0,886600,1
29443,718,522,0,0,0,886600,1
29442,138,20,0,0,0,886600,1
29441,720,219,0,0,0,886600,1
29439,133,714,0,0,0,886600,1
29438,571,588,0,0,0,886600,1
29437,379,446,0,0,0,886600,1
27963,290,535,0,0,0,886600,1
27966,23,15,0,0,0,886600,1
29430,137,393,0,0,0,886600,1
29428,20,246,0,0,0,886600,1
27971,552,13,0,0,0,886600,1
27973,624,674,0,0,0,886600,1
29425,20,43,0,0,0,886600,1
30863,626,105,0,0,0,886600,1
30864,508,80,0,0,0,886600,1
30865,20,493,0,0,0,886600,1
32222,364,668,0,0,0,886600,1
32234,494,640,0,0,0,886600,1
32232,689,613,0,0,0,886600,1
32231,29,250,0,0,0,886600,1
32230,202,497,0,0,0,886600,1
24863,638,684,0,0,0,886600,1
32228,652,517,0,0,0,886600,1
32225,280,181,0,0,0,886600,1
24867,84,332,0,0,0,886600,1
32221,517,684,0,0,0,886600,1
24903,332,95,0,0,0,886600,1
32218,250,684,0,0,0,886600,1
24888,242,195,0,0,0,886600,1
32214,568,16,0,0,0,886600,1
24891,404,683,0,0,0,886600,1
32212,593,140,0,0,0,886600,1
32211,501,569,0,0,0,886600,1
24899,334,261,0,0,0,886600,1
32206,717,560,0,0,0,886600,1
24855,714,310,0,0,0,886600,1
24848,668,242,0,0,0,886600,1
32240,674,576,0,0,0,886600,1
32242,295,319,0,0,0,886600,1
24803,302,193,0,0,0,886600,1
32269,145,721,0,0,0,886600,1
32268,137,236,0,0,0,886600,1
32266,663,409,0,0,0,886600,1
32265,195,170,0,0,0,886600,1
32264,174,140,0,0,0,886600,1
24814,22,475,0,0,0,886600,1
24816,571,105,0,0,0,886600,1
32257,663,19,0,0,0,886600,1
32255,569,131,0,0,0,886600,1
24819,525,552,0,0,0,886600,1
32251,97,392,0,0,0,886600,1
24830,383,493,0,0,0,886600,1
32247,137,311,0,0,0,886600,1
32246,663,492,0,0,0,886600,1
24837,114,613,0,0,0,886600,1
32244,48,124,0,0,0,886600,1
32204,683,721,0,0,0,886600,1
32202,652,250,0,0,0,886600,1
31879,103,328,0,0,0,886600,1
32160,682,668,0,0,0,886600,1
24953,137,380,0,0,0,886600,1
24954,409,646,0,0,0,886600,1
32166,717,269,0,0,0,886600,1
32165,23,95,0,0,0,886600,1
24955,482,328,0,0,0,886600,1
32163,54,562,0,0,0,886600,1
32162,721,683,0,0,0,886600,1
24956,170,123,0,0,0,886600,1
32157,655,294,0,0,0,886600,1
24905,261,560,0,0,0,886600,1
32156,482,1,0,0,0,886600,1
32154,20,673,0,0,0,886600,1
28716,27,699,0,0,0,886600,1
32150,250,626,0,0,0,886600,1
32149,674,568,0,0,0,886600,1
24984,661,97,0,0,0,886600,1
32145,482,571,0,0,0,886600,1
32144,219,342,0,0,0,886600,1
32169,507,392,0,0,0,886600,1
24948,31,593,0,0,0,886600,1
32171,701,84,0,0,0,886600,1
32172,133,43,0,0,0,886600,1
32200,525,683,0,0,0,886600,1
32198,560,586,0,0,0,886600,1
32197,562,568,0,0,0,886600,1
32195,719,130,0,0,0,886600,1
32194,661,404,0,0,0,886600,1
32193,126,529,0,0,0,886600,1
32191,446,560,0,0,0,886600,1
32190,699,661,0,0,0,886600,1
32189,684,13,0,0,0,886600,1
24920,605,543,0,0,0,886600,1
32185,719,503,0,0,0,886600,1
32182,723,471,0,0,0,886600,1
32180,624,614,0,0,0,886600,1
24932,290,48,0,0,0,886600,1
32176,458,294,0,0,0,886600,1
24937,479,525,0,0,0,886600,1
32173,138,383,0,0,0,886600,1
32273,163,463,0,0,0,886600,1
32277,446,155,0,0,0,886600,1
32278,54,22,0,0,0,886600,1
32356,22,43,0,0,0,886600,1
32365,114,43,0,0,0,886600,1
32364,701,427,0,0,0,886600,1
32363,138,525,0,0,0,886600,1
32362,613,20,0,0,0,886600,1
24695,107,103,0,0,0,886600,1
24697,473,319,0,0,0,886600,1
24699,605,126,0,0,0,886600,1
32357,294,385,0,0,0,886600,1
32355,20,717,0,0,0,886600,1
32279,701,246,0,0,0,886600,1
32354,503,439,0,0,0,886600,1
32353,544,261,0,0,0,886600,1
32352,721,494,0,0,0,886600,1
32351,717,114,0,0,0,886600,1
24702,605,683,0,0,0,886600,1
32349,160,121,0,0,0,886600,1
32348,571,353,0,0,0,886600,1
24708,646,130,0,0,0,886600,1
32366,307,668,0,0,0,886600,1
32367,701,638,0,0,0,886600,1
32369,141,593,0,0,0,886600,1
32371,587,479,0,0,0,886600,1
32390,181,701,0,0,0,886600,1
32389,640,717,0,0,0,886600,1
32388,64,446,0,0,0,886600,1
32387,25,721,0,0,0,886600,1
32386,202,280,0,0,0,886600,1
24681,195,50,0,0,0,886600,1
32384,517,246,0,0,0,886600,1
32382,353,626,0,0,0,886600,1
32381,494,170,0,0,0,886600,1
32380,683,4,0,0,0,886600,1
32379,12,446,0,0,0,886600,1
32378,290,605,0,0,0,886600,1
24688,689,155,0,0,0,886600,1
16083,4,501,0,0,0,886600,1
32375,683,613,0,0,0,886600,1
32374,103,501,0,0,0,886600,1
32373,371,170,0,0,0,886600,1
32343,175,56,0,0,0,886600,1
32342,439,673,0,0,0,886600,1
32337,332,295,0,0,0,886600,1
32307,103,43,0,0,0,886600,1
32303,364,174,0,0,0,886600,1
32302,668,124,0,0,0,886600,1
32300,15,458,0,0,0,886600,1
32299,174,427,0,0,0,886600,1
32298,471,90,0,0,0,886600,1
32297,137,473,0,0,0,886600,1
32296,364,156,0,0,0,886600,1
24776,174,529,0,0,0,886600,1
24786,202,498,0,0,0,886600,1
32290,568,586,0,0,0,886600,1
32289,97,646,0,0,0,886600,1
32287,719,25,0,0,0,886600,1
32286,202,175,0,0,0,886600,1
24790,525,202,0,0,0,886600,1
32283,498,446,0,0,0,886600,1
32282,5,246,0,0,0,886600,1
32280,14,392,0,0,0,886600,1
32306,593,174,0,0,0,886600,1
32308,624,117,0,0,0,886600,1
32333,544,12,0,0,0,886600,1
24767,334,511,0,0,0,886600,1
24740,23,543,0,0,0,886600,1
32331,717,84,0,0,0,886600,1
32330,126,236,0,0,0,886600,1
32326,257,473,0,0,0,886600,1
24756,261,307,0,0,0,886600,1
32322,720,586,0,0,0,886600,1
24762,708,446,0,0,0,886600,1
32319,257,514,0,0,0,886600,1
32318,90,638,0,0,0,886600,1
32317,668,294,0,0,0,886600,1
32316,511,181,0,0,0,886600,1
32315,178,155,0,0,0,886600,1
32314,409,640,0,0,0,886600,1
24765,328,174,0,0,0,886600,1
32312,56,701,0,0,0,886600,1
32311,170,77,0,0,0,886600,1
32310,605,138,0,0,0,886600,1
15788,4,475,0,0,0,886600,1
32139,114,133,0,0,0,886600,1
32138,13,392,0,0,0,886600,1
31968,475,261,0,0,0,886600,1
31978,29,4,0,0,0,886600,1
31977,720,170,0,0,0,886600,1
31976,257,605,0,0,0,886600,1
31975,264,332,0,0,0,886600,1
31974,29,246,0,0,0,886600,1
31973,11,684,0,0,0,886600,1
25224,699,427,0,0,0,886600,1
31969,137,171,0,0,0,886600,1
31967,448,528,0,0,0,886600,1
32007,178,394,0,0,0,886600,1
31965,586,138,0,0,0,886600,1
31964,97,409,0,0,0,886600,1
31963,588,458,0,0,0,886600,1
31962,353,458,0,0,0,886600,1
31960,479,719,0,0,0,886600,1
31959,274,721,0,0,0,886600,1
31958,171,137,0,0,0,886600,1
25239,501,482,0,0,0,886600,1
25215,409,313,0,0,0,886600,1
31981,514,319,0,0,0,886600,1
31982,243,371,0,0,0,886600,1
31983,719,121,0,0,0,886600,1
25198,265,269,0,0,0,886600,1
25202,54,117,0,0,0,886600,1
32000,84,721,0,0,0,886600,1
31999,334,23,0,0,0,886600,1
31998,525,246,0,0,0,886600,1
31996,30,85,0,0,0,886600,1
31995,560,26,0,0,0,886600,1
31994,20,392,0,0,0,886600,1
31993,138,246,0,0,0,886600,1
31992,242,652,0,0,0,886600,1
25207,193,77,0,0,0,886600,1
31990,684,117,0,0,0,886600,1
31989,503,404,0,0,0,886600,1
25208,558,668,0,0,0,886600,1
31987,141,261,0,0,0,886600,1
31986,140,446,0,0,0,886600,1
25209,443,193,0,0,0,886600,1
25240,392,586,0,0,0,886600,1
31953,719,207,0,0,0,886600,1
25241,638,673,0,0,0,886600,1
31915,503,525,0,0,0,886600,1
31913,569,20,0,0,0,886600,1
31912,224,720,0,0,0,886600,1
31911,175,84,0,0,0,886600,1
31908,170,479,0,0,0,886600,1
31907,137,80,0,0,0,886600,1
25301,307,383,0,0,0,886600,1
31897,714,95,0,0,0,886600,1
31896,717,475,0,0,0,886600,1
31895,193,246,0,0,0,886600,1
31894,525,528,0,0,0,886600,1
31893,668,261,0,0,0,886600,1
31892,274,319,0,0,0,886600,1
31891,529,319,0,0,0,886600,1
31890,720,501,0,0,0,886600,1
31886,19,646,0,0,0,886600,1
31884,202,560,0,0,0,886600,1
31883,138,560,0,0,0,886600,1
31914,714,479,0,0,0,886600,1
25289,160,295,0,0,0,886600,1
25242,501,193,0,0,0,886600,1
31917,613,126,0,0,0,886600,1
25245,624,497,0,0,0,886600,1
25247,397,160,0,0,0,886600,1
31947,624,140,0,0,0,886600,1
31946,439,175,0,0,0,886600,1
31944,508,1,0,0,0,886600,1
31942,723,204,0,0,0,886600,1
31940,717,511,0,0,0,886600,1
25254,586,174,0,0,0,886600,1
31937,392,562,0,0,0,886600,1
25257,30,4,0,0,0,886600,1
31935,20,138,0,0,0,886600,1
31930,525,90,0,0,0,886600,1
31927,90,26,0,0,0,886600,1
25280,170,6,0,0,0,886600,1
31922,265,508,0,0,0,886600,1
31921,294,501,0,0,0,886600,1
31918,427,181,0,0,0,886600,1
32005,501,371,0,0,0,886600,1
25187,54,397,0,0,0,886600,1
32137,655,569,0,0,0,886600,1
32097,30,261,0,0,0,886600,1
32109,508,723,0,0,0,886600,1
32108,503,479,0,0,0,886600,1
32106,332,493,0,0,0,886600,1
32105,23,528,0,0,0,886600,1
25054,718,314,0,0,0,886600,1
32101,701,674,0,0,0,886600,1
32100,613,196,0,0,0,886600,1
32098,507,571,0,0,0,886600,1
32095,175,605,0,0,0,886600,1
25183,632,569,0,0,0,886600,1
32093,446,507,0,0,0,886600,1
25070,332,307,0,0,0,886600,1
25072,9,202,0,0,0,886600,1
32086,133,103,0,0,0,886600,1
32084,525,587,0,0,0,886600,1
32083,638,613,0,0,0,886600,1
15640,236,446,0,0,0,886600,1
32080,202,4,0,0,0,886600,1
25035,269,123,0,0,0,886600,1
32111,568,335,0,0,0,886600,1
32112,699,502,0,0,0,886600,1
32113,661,569,0,0,0,886600,1
25013,525,141,0,0,0,886600,1
25015,605,1,0,0,0,886600,1
32133,409,683,0,0,0,886600,1
32131,568,661,0,0,0,886600,1
25028,494,141,0,0,0,886600,1
32127,90,502,0,0,0,886600,1
32126,257,586,0,0,0,886600,1
32125,497,613,0,0,0,886600,1
32124,525,20,0,0,0,886600,1
32123,508,33,0,0,0,886600,1
32121,269,174,0,0,0,886600,1
32120,156,652,0,0,0,886600,1
32119,492,295,0,0,0,886600,1
32117,661,448,0,0,0,886600,1
25031,475,646,0,0,0,886600,1
32115,493,446,0,0,0,886600,1
32114,398,124,0,0,0,886600,1
25080,596,525,0,0,0,886600,1
32078,236,717,0,0,0,886600,1
32077,202,501,0,0,0,886600,1
32045,655,246,0,0,0,886600,1
32042,661,242,0,0,0,886600,1
25143,163,605,0,0,0,886600,1
32039,15,133,0,0,0,886600,1
32037,379,202,0,0,0,886600,1
32036,280,720,0,0,0,886600,1
32034,64,140,0,0,0,886600,1
25155,371,331,0,0,0,886600,1
32029,543,137,0,0,0,886600,1
32028,514,90,0,0,0,886600,1
32027,568,114,0,0,0,886600,1
32024,701,264,0,0,0,886600,1
32022,614,19,0,0,0,886600,1
32019,174,207,0,0,0,886600,1
25173,605,482,0,0,0,886600,1
32014,290,54,0,0,0,886600,1
32013,652,114,0,0,0,886600,1
32011,246,30,0,0,0,886600,1
25134,723,314,0,0,0,886600,1
25131,280,525,0,0,0,886600,1
32075,265,124,0,0,0,886600,1
25124,397,661,0,0,0,886600,1
25097,646,348,0,0,0,886600,1
25103,668,30,0,0,0,886600,1
32071,137,219,0,0,0,886600,1
32070,22,701,0,0,0,886600,1
32069,638,133,0,0,0,886600,1
32067,673,138,0,0,0,886600,1
32066,178,511,0,0,0,886600,1
32064,160,560,0,0,0,886600,1
32062,170,427,0,0,0,886600,1
32061,250,720,0,0,0,886600,1
25117,257,80,0,0,0,886600,1
32056,20,718,0,0,0,886600,1
32054,699,85,0,0,0,886600,1
32053,141,507,0,0,0,886600,1
32052,175,181,0,0,0,886600,1
32051,257,646,0,0,0,886600,1
32050,525,5,0,0,0,886600,1
32392,383,175,0,0,0,886600,1
32393,121,332,0,0,0,886600,1
32394,328,342,0,0,0,886600,1
32698,714,164,0,0,0,886600,1
32710,409,207,0,0,0,886600,1
32709,202,717,0,0,0,886600,1
32708,683,181,0,0,0,886600,1
32707,25,319,0,0,0,886600,1
32705,684,543,0,0,0,886600,1
24274,638,19,0,0,0,886600,1
32700,207,673,0,0,0,886600,1
32699,242,19,0,0,0,886600,1
24292,482,397,0,0,0,886600,1
24264,699,97,0,0,0,886600,1
24295,290,379,0,0,0,886600,1
32691,202,503,0,0,0,886600,1
24311,661,394,0,0,0,886600,1
24317,294,9,0,0,0,886600,1
24322,498,652,0,0,0,886600,1
24323,274,613,0,0,0,886600,1
16581,4,723,0,0,0,886600,1
32682,503,689,0,0,0,886600,1
32711,433,582,0,0,0,886600,1
32712,342,68,0,0,0,886600,1
32713,264,448,0,0,0,886600,1
32714,571,535,0,0,0,886600,1
32732,167,605,0,0,0,886600,1
32731,85,145,0,0,0,886600,1
32729,714,503,0,0,0,886600,1
32728,463,261,0,0,0,886600,1
32727,613,174,0,0,0,886600,1
32726,569,582,0,0,0,886600,1
32725,558,342,0,0,0,886600,1
32724,64,502,0,0,0,886600,1
32723,95,458,0,0,0,886600,1
32722,164,175,0,0,0,886600,1
32721,571,682,0,0,0,886600,1
32720,137,646,0,0,0,886600,1
32719,458,54,0,0,0,886600,1
32718,720,609,0,0,0,886600,1
32717,528,133,0,0,0,886600,1
32716,133,13,0,0,0,886600,1
32715,409,544,0,0,0,886600,1
32681,130,576,0,0,0,886600,1
32680,364,446,0,0,0,886600,1
32679,571,562,0,0,0,886600,1
32653,97,137,0,0,0,886600,1
24345,196,414,0,0,0,886600,1
32650,508,393,0,0,0,886600,1
32649,393,568,0,0,0,886600,1
32648,502,624,0,0,0,886600,1
32647,507,175,0,0,0,886600,1
32646,137,264,0,0,0,886600,1
32645,103,181,0,0,0,886600,1
32644,503,632,0,0,0,886600,1
32641,367,371,0,0,0,886600,1
32640,684,385,0,0,0,886600,1
32639,482,674,0,0,0,886600,1
32638,673,207,0,0,0,886600,1
24356,684,3,0,0,0,886600,1
32636,613,714,0,0,0,886600,1
32635,544,448,0,0,0,886600,1
32634,141,427,0,0,0,886600,1
32633,383,569,0,0,0,886600,1
32652,448,544,0,0,0,886600,1
32655,587,246,0,0,0,886600,1
32678,181,640,0,0,0,886600,1
32657,397,290,0,0,0,886600,1
24332,195,84,0,0,0,886600,1
32675,605,137,0,0,0,886600,1
32674,532,576,0,0,0,886600,1
32673,618,133,0,0,0,886600,1
32672,640,12,0,0,0,886600,1
32671,723,158,0,0,0,886600,1
32670,103,290,0,0,0,886600,1
32669,160,404,0,0,0,886600,1
32668,613,683,0,0,0,886600,1
32667,243,576,0,0,0,886600,1
32666,137,501,0,0,0,886600,1
32665,511,319,0,0,0,886600,1
32664,126,141,0,0,0,886600,1
32663,448,394,0,0,0,886600,1
32661,719,178,0,0,0,886600,1
32659,246,163,0,0,0,886600,1
32658,204,626,0,0,0,886600,1
32735,433,380,0,0,0,886600,1
32737,560,331,0,0,0,886600,1
32631,517,12,0,0,0,886600,1
32812,90,145,0,0,0,886600,1
32822,156,342,0,0,0,886600,1
32821,196,494,0,0,0,886600,1
32820,257,511,0,0,0,886600,1
32819,48,668,0,0,0,886600,1
32818,121,265,0,0,0,886600,1
32816,103,175,0,0,0,886600,1
32815,196,160,0,0,0,886600,1
32813,718,307,0,0,0,886600,1
32811,290,571,0,0,0,886600,1
32738,347,332,0,0,0,886600,1
32809,342,3,0,0,0,886600,1
32807,137,714,0,0,0,886600,1
32806,3,433,0,0,0,886600,1
32804,409,20,0,0,0,886600,1
32801,560,708,0,0,0,886600,1
32798,508,331,0,0,0,886600,1
32797,202,246,0,0,0,886600,1
32796,207,140,0,0,0,886600,1
32824,31,494,0,0,0,886600,1
32826,171,525,0,0,0,886600,1
32827,294,140,0,0,0,886600,1
32828,310,717,0,0,0,886600,1
32847,646,20,0,0,0,886600,1
32846,394,492,0,0,0,886600,1
24164,280,409,0,0,0,886600,1
32843,12,624,0,0,0,886600,1
32842,257,295,0,0,0,886600,1
32841,723,394,0,0,0,886600,1
32840,458,4,0,0,0,886600,1
32838,458,195,0,0,0,886600,1
32837,624,446,0,0,0,886600,1
32836,25,684,0,0,0,886600,1
32835,264,207,0,0,0,886600,1
32834,54,167,0,0,0,886600,1
32833,525,207,0,0,0,886600,1
32832,714,482,0,0,0,886600,1
32831,331,703,0,0,0,886600,1
32830,90,196,0,0,0,886600,1
32829,721,701,0,0,0,886600,1
32790,433,379,0,0,0,886600,1
32788,605,618,0,0,0,886600,1
24249,202,84,0,0,0,886600,1
32758,160,137,0,0,0,886600,1
32756,64,264,0,0,0,886600,1
32755,307,90,0,0,0,886600,1
32754,32,626,0,0,0,886600,1
32753,371,140,0,0,0,886600,1
32752,181,236,0,0,0,886600,1
32751,138,517,0,0,0,886600,1
32750,95,668,0,0,0,886600,1
32749,181,30,0,0,0,886600,1
32748,723,130,0,0,0,886600,1
32746,145,494,0,0,0,886600,1
32745,133,392,0,0,0,886600,1
32744,126,155,0,0,0,886600,1
32743,508,661,0,0,0,886600,1
32742,23,171,0,0,0,886600,1
32741,503,511,0,0,0,886600,1
32740,721,332,0,0,0,886600,1
32739,334,19,0,0,0,886600,1
32757,269,5,0,0,0,886600,1
32759,331,717,0,0,0,886600,1
24250,163,723,0,0,0,886600,1
32760,310,699,0,0,0,886600,1
24253,398,20,0,0,0,886600,1
32776,319,473,0,0,0,886600,1
32775,721,552,0,0,0,886600,1
32774,26,433,0,0,0,886600,1
32773,652,140,0,0,0,886600,1
32772,448,404,0,0,0,886600,1
32771,433,158,0,0,0,886600,1
32770,19,414,0,0,0,886600,1
32769,2,12,0,0,0,886600,1
32768,90,398,0,0,0,886600,1
32767,560,95,0,0,0,886600,1
32766,103,683,0,0,0,886600,1
32765,246,156,0,0,0,886600,1
32764,652,328,0,0,0,886600,1
32763,126,77,0,0,0,886600,1
32762,668,494,0,0,0,886600,1
32761,720,614,0,0,0,886600,1
32632,31,568,0,0,0,886600,1
32630,137,514,0,0,0,886600,1
24674,699,367,0,0,0,886600,1
32482,560,503,0,0,0,886600,1
32490,586,342,0,0,0,886600,1
32489,497,261,0,0,0,886600,1
32488,482,29,0,0,0,886600,1
32487,4,181,0,0,0,886600,1
32486,708,54,0,0,0,886600,1
32485,626,502,0,0,0,886600,1
32484,175,502,0,0,0,886600,1
32483,383,371,0,0,0,886600,1
32481,155,682,0,0,0,886600,1
32516,1,568,0,0,0,886600,1
32480,202,433,0,0,0,886600,1
32479,514,124,0,0,0,886600,1
32478,714,721,0,0,0,886600,1
32477,587,13,0,0,0,886600,1
32476,626,56,0,0,0,886600,1
24521,269,398,0,0,0,886600,1
32472,708,4,0,0,0,886600,1
32471,347,202,0,0,0,886600,1
32491,342,34,0,0,0,886600,1
32492,137,689,0,0,0,886600,1
32493,257,609,0,0,0,886600,1
24513,193,181,0,0,0,886600,1
32512,23,576,0,0,0,886600,1
24502,699,397,0,0,0,886600,1
32510,703,393,0,0,0,886600,1
32509,64,514,0,0,0,886600,1
24508,632,714,0,0,0,886600,1
32507,638,202,0,0,0,886600,1
32506,560,54,0,0,0,886600,1
32505,290,160,0,0,0,886600,1
32504,171,493,0,0,0,886600,1
32503,5,668,0,0,0,886600,1
32502,409,668,0,0,0,886600,1
32501,31,383,0,0,0,886600,1
32500,398,668,0,0,0,886600,1
32498,508,64,0,0,0,886600,1
32497,507,448,0,0,0,886600,1
32496,193,414,0,0,0,886600,1
32495,502,719,0,0,0,886600,1
32469,97,319,0,0,0,886600,1
24528,673,392,0,0,0,886600,1
32466,34,699,0,0,0,886600,1
24630,721,307,0,0,0,886600,1
24638,31,85,0,0,0,886600,1
32421,347,137,0,0,0,886600,1
24643,609,661,0,0,0,886600,1
24645,294,48,0,0,0,886600,1
24646,264,348,0,0,0,886600,1
32414,137,307,0,0,0,886600,1
32409,207,493,0,0,0,886600,1
32407,683,140,0,0,0,886600,1
32404,207,29,0,0,0,886600,1
32403,29,319,0,0,0,886600,1
32402,54,174,0,0,0,886600,1
24661,394,167,0,0,0,886600,1
32400,90,269,0,0,0,886600,1
24663,543,624,0,0,0,886600,1
32398,571,22,0,0,0,886600,1
24671,95,383,0,0,0,886600,1
32396,701,334,0,0,0,886600,1
24631,138,723,0,0,0,886600,1
32427,138,174,0,0,0,886600,1
24529,138,302,0,0,0,886600,1
24625,25,4,0,0,0,886600,1
24542,398,12,0,0,0,886600,1
32460,195,458,0,0,0,886600,1
32457,661,328,0,0,0,886600,1
32453,571,569,0,0,0,886600,1
24561,178,158,0,0,0,886600,1
32446,85,131,0,0,0,886600,1
24582,163,562,0,0,0,886600,1
32443,723,170,0,0,0,886600,1
24593,392,638,0,0,0,886600,1
24604,261,683,0,0,0,886600,1
32437,133,294,0,0,0,886600,1
24607,473,433,0,0,0,886600,1
32435,5,160,0,0,0,886600,1
24612,269,535,0,0,0,886600,1
24619,568,158,0,0,0,886600,1
32431,141,29,0,0,0,886600,1
24623,33,12,0,0,0,886600,1
32513,714,507,0,0,0,886600,1
32517,264,587,0,0,0,886600,1
32629,718,335,0,0,0,886600,1
32597,508,397,0,0,0,886600,1
32605,596,202,0,0,0,886600,1
32604,23,140,0,0,0,886600,1
32603,494,174,0,0,0,886600,1
32602,409,97,0,0,0,886600,1
32601,560,84,0,0,0,886600,1
32600,26,124,0,0,0,886600,1
32599,576,501,0,0,0,886600,1
32598,492,463,0,0,0,886600,1
32596,175,3,0,0,0,886600,1
32518,31,576,0,0,0,886600,1
32595,448,482,0,0,0,886600,1
32594,409,552,0,0,0,886600,1
32593,497,181,0,0,0,886600,1
32592,661,393,0,0,0,886600,1
32591,181,156,0,0,0,886600,1
32590,392,164,0,0,0,886600,1
32589,19,138,0,0,0,886600,1
32588,64,482,0,0,0,886600,1
32606,624,264,0,0,0,886600,1
32607,718,532,0,0,0,886600,1
32608,394,290,0,0,0,886600,1
32609,560,50,0,0,0,886600,1
24361,683,114,0,0,0,886600,1
32627,448,19,0,0,0,886600,1
32626,137,528,0,0,0,886600,1
24365,569,243,0,0,0,886600,1
32624,4,433,0,0,0,886600,1
32623,492,34,0,0,0,886600,1
32622,569,689,0,0,0,886600,1
24367,439,661,0,0,0,886600,1
32620,12,342,0,0,0,886600,1
32618,145,525,0,0,0,886600,1
32617,137,2,0,0,0,886600,1
32616,609,446,0,0,0,886600,1
24372,587,380,0,0,0,886600,1
24374,482,246,0,0,0,886600,1
32612,107,571,0,0,0,886600,1
32611,141,56,0,0,0,886600,1
32610,723,171,0,0,0,886600,1
32585,605,124,0,0,0,886600,1
32584,544,371,0,0,0,886600,1
32583,544,13,0,0,0,886600,1
24400,332,511,0,0,0,886600,1
32556,54,261,0,0,0,886600,1
24415,699,614,0,0,0,886600,1
24417,714,582,0,0,0,886600,1
24418,54,4,0,0,0,886600,1
32549,1,433,0,0,0,886600,1
32547,4,193,0,0,0,886600,1
32545,517,371,0,0,0,886600,1
32543,682,371,0,0,0,886600,1
24461,596,174,0,0,0,886600,1
24464,492,280,0,0,0,886600,1
24475,25,29,0,0,0,886600,1
16328,492,379,0,0,0,886600,1
24485,264,638,0,0,0,886600,1
32524,494,646,0,0,0,886600,1
24489,246,398,0,0,0,886600,1
32520,560,156,0,0,0,886600,1
24497,5,511,0,0,0,886600,1
24408,133,404,0,0,0,886600,1
24393,723,224,0,0,0,886600,1
32582,543,163,0,0,0,886600,1
32562,332,12,0,0,0,886600,1
32581,498,202,0,0,0,886600,1
32580,661,458,0,0,0,886600,1
32579,587,163,0,0,0,886600,1
32578,624,501,0,0,0,886600,1
32577,64,12,0,0,0,886600,1
32576,655,409,0,0,0,886600,1
32575,126,586,0,0,0,886600,1
32574,661,85,0,0,0,886600,1
32573,193,265,0,0,0,886600,1
32572,193,494,0,0,0,886600,1
32571,508,145,0,0,0,886600,1
32570,124,207,0,0,0,886600,1
32569,202,274,0,0,0,886600,1
32568,181,498,0,0,0,886600,1
32567,508,243,0,0,0,886600,1
24382,246,204,0,0,0,886600,1
24386,167,9,0,0,0,886600,1
31880,661,614,0,0,0,886600,1
31878,409,674,0,0,0,886600,1
30866,568,354,0,0,0,886600,1
31210,532,319,0,0,0,886600,1
31223,257,274,0,0,0,886600,1
31221,661,640,0,0,0,886600,1
31220,123,371,0,0,0,886600,1
31219,175,517,0,0,0,886600,1
31218,290,494,0,0,0,886600,1
31215,593,525,0,0,0,886600,1
31213,22,193,0,0,0,886600,1
31211,290,167,0,0,0,886600,1
31207,683,246,0,0,0,886600,1
26057,683,398,0,0,0,886600,1
26046,156,673,0,0,0,886600,1
31205,587,335,0,0,0,886600,1
26047,4,613,0,0,0,886600,1
26049,720,11,0,0,0,886600,1
26050,33,668,0,0,0,886600,1
31201,699,723,0,0,0,886600,1
26051,103,543,0,0,0,886600,1
26052,25,409,0,0,0,886600,1
31224,494,133,0,0,0,886600,1
31225,174,103,0,0,0,886600,1
31226,12,294,0,0,0,886600,1
31228,383,193,0,0,0,886600,1
31247,30,332,0,0,0,886600,1
31246,138,145,0,0,0,886600,1
31245,137,145,0,0,0,886600,1
31244,19,701,0,0,0,886600,1
31243,294,508,0,0,0,886600,1
31242,501,319,0,0,0,886600,1
31241,576,498,0,0,0,886600,1
31240,699,164,0,0,0,886600,1
26022,558,319,0,0,0,886600,1
26025,494,439,0,0,0,886600,1
31237,103,673,0,0,0,886600,1
31236,137,354,0,0,0,886600,1
31235,354,701,0,0,0,886600,1
31233,242,174,0,0,0,886600,1
31232,721,587,0,0,0,886600,1
31231,618,458,0,0,0,886600,1
31229,723,497,0,0,0,886600,1
31197,708,714,0,0,0,886600,1
31195,458,609,0,0,0,886600,1
31877,719,155,0,0,0,886600,1
26115,502,246,0,0,0,886600,1
26110,503,502,0,0,0,886600,1
31160,379,721,0,0,0,886600,1
31159,571,674,0,0,0,886600,1
31158,544,684,0,0,0,886600,1
31157,458,689,0,0,0,886600,1
31156,640,160,0,0,0,886600,1
31155,23,640,0,0,0,886600,1
31154,269,140,0,0,0,886600,1
26116,307,174,0,0,0,886600,1
31194,170,3,0,0,0,886600,1
31151,195,13,0,0,0,886600,1
31148,160,364,0,0,0,886600,1
31146,295,525,0,0,0,886600,1
31144,475,178,0,0,0,886600,1
26122,195,479,0,0,0,886600,1
26126,2,683,0,0,0,886600,1
31138,494,689,0,0,0,886600,1
31136,682,613,0,0,0,886600,1
26107,517,560,0,0,0,886600,1
31166,699,204,0,0,0,886600,1
31168,290,84,0,0,0,886600,1
31170,701,294,0,0,0,886600,1
26059,141,404,0,0,0,886600,1
26066,22,682,0,0,0,886600,1
26071,482,562,0,0,0,886600,1
31188,409,261,0,0,0,886600,1
31186,105,626,0,0,0,886600,1
31184,138,652,0,0,0,886600,1
26075,160,463,0,0,0,886600,1
31182,586,458,0,0,0,886600,1
31181,107,624,0,0,0,886600,1
26076,525,463,0,0,0,886600,1
26079,475,156,0,0,0,886600,1
26083,29,155,0,0,0,886600,1
31177,31,668,0,0,0,886600,1
26084,371,123,0,0,0,886600,1
31174,723,640,0,0,0,886600,1
26091,394,525,0,0,0,886600,1
26098,383,543,0,0,0,886600,1
31249,558,202,0,0,0,886600,1
31250,383,90,0,0,0,886600,1
31251,155,332,0,0,0,886600,1
25928,181,311,0,0,0,886600,1
31342,624,175,0,0,0,886600,1
31340,493,714,0,0,0,886600,1
31339,178,334,0,0,0,886600,1
31338,202,3,0,0,0,886600,1
25922,117,652,0,0,0,886600,1
31332,371,596,0,0,0,886600,1
31331,721,290,0,0,0,886600,1
31329,90,587,0,0,0,886600,1
25930,699,170,0,0,0,886600,1
26018,493,593,0,0,0,886600,1
25931,609,613,0,0,0,886600,1
31324,494,264,0,0,0,886600,1
25935,10,668,0,0,0,886600,1
25936,54,29,0,0,0,886600,1
31319,181,174,0,0,0,886600,1
31318,593,103,0,0,0,886600,1
31317,494,246,0,0,0,886600,1
31315,568,123,0,0,0,886600,1
31343,684,103,0,0,0,886600,1
31347,655,701,0,0,0,886600,1
25897,170,242,0,0,0,886600,1
31349,543,160,0,0,0,886600,1
31374,1,23,0,0,0,886600,1
31373,613,29,0,0,0,886600,1
31372,121,613,0,0,0,886600,1
31369,137,156,0,0,0,886600,1
31367,723,508,0,0,0,886600,1
31366,439,511,0,0,0,886600,1
31365,723,353,0,0,0,886600,1
31364,593,137,0,0,0,886600,1
31363,264,121,0,0,0,886600,1
31359,571,508,0,0,0,886600,1
25886,507,30,0,0,0,886600,1
31356,97,593,0,0,0,886600,1
25889,618,507,0,0,0,886600,1
31354,714,97,0,0,0,886600,1
31353,170,48,0,0,0,886600,1
31351,175,64,0,0,0,886600,1
25894,95,613,0,0,0,886600,1
31314,347,90,0,0,0,886600,1
25944,138,265,0,0,0,886600,1
31312,385,29,0,0,0,886600,1
31283,718,10,0,0,0,886600,1
31281,54,2,0,0,0,886600,1
31279,571,14,0,0,0,886600,1
31278,514,448,0,0,0,886600,1
31277,261,174,0,0,0,886600,1
31275,427,178,0,0,0,886600,1
31272,448,560,0,0,0,886600,1
31271,117,30,0,0,0,886600,1
25984,683,121,0,0,0,886600,1
25994,11,446,0,0,0,886600,1
25997,103,85,0,0,0,886600,1
26006,571,380,0,0,0,886600,1
26011,446,114,0,0,0,886600,1
26013,9,576,0,0,0,886600,1
31257,294,439,0,0,0,886600,1
31256,723,632,0,0,0,886600,1
31255,458,5,0,0,0,886600,1
31254,528,138,0,0,0,886600,1
25977,668,723,0,0,0,886600,1
31284,433,632,0,0,0,886600,1
31310,202,1,0,0,0,886600,1
31285,20,4,0,0,0,886600,1
25949,4,167,0,0,0,886600,1
31307,137,121,0,0,0,886600,1
31306,652,34,0,0,0,886600,1
31305,652,15,0,0,0,886600,1
31304,30,568,0,0,0,886600,1
31303,50,525,0,0,0,886600,1
31302,494,2,0,0,0,886600,1
25955,4,525,0,0,0,886600,1
31299,124,54,0,0,0,886600,1
31298,497,202,0,0,0,886600,1
31295,246,503,0,0,0,886600,1
31293,13,525,0,0,0,886600,1
31292,714,560,0,0,0,886600,1
25965,295,90,0,0,0,886600,1
31290,383,507,0,0,0,886600,1
25969,673,525,0,0,0,886600,1
25971,624,439,0,0,0,886600,1
26133,137,26,0,0,0,886600,1
26134,544,174,0,0,0,886600,1
26135,269,502,0,0,0,886600,1
30944,347,290,0,0,0,886600,1
26356,141,242,0,0,0,886600,1
26358,383,54,0,0,0,886600,1
30952,560,558,0,0,0,886600,1
26365,123,721,0,0,0,886600,1
26367,332,508,0,0,0,886600,1
26372,141,348,0,0,0,886600,1
26374,334,503,0,0,0,886600,1
30946,398,181,0,0,0,886600,1
30943,246,689,0,0,0,886600,1
26323,699,535,0,0,0,886600,1
30942,443,294,0,0,0,886600,1
30940,723,443,0,0,0,886600,1
26379,140,543,0,0,0,886600,1
30938,433,224,0,0,0,886600,1
30937,494,638,0,0,0,886600,1
30936,721,528,0,0,0,886600,1
30935,5,714,0,0,0,886600,1
30934,181,501,0,0,0,886600,1
30956,508,195,0,0,0,886600,1
30957,397,721,0,0,0,886600,1
30958,43,593,0,0,0,886600,1
30959,257,219,0,0,0,886600,1
30984,624,397,0,0,0,886600,1
26333,48,138,0,0,0,886600,1
30981,392,97,0,0,0,886600,1
30979,121,543,0,0,0,886600,1
30978,195,121,0,0,0,886600,1
30977,246,708,0,0,0,886600,1
26335,701,311,0,0,0,886600,1
30973,605,160,0,0,0,886600,1
30970,19,163,0,0,0,886600,1
26348,502,493,0,0,0,886600,1
30968,668,618,0,0,0,886600,1
30967,140,2,0,0,0,886600,1
30965,535,719,0,0,0,886600,1
26352,723,334,0,0,0,886600,1
30962,529,103,0,0,0,886600,1
30961,170,33,0,0,0,886600,1
26353,30,202,0,0,0,886600,1
30933,307,103,0,0,0,886600,1
26382,22,4,0,0,0,886600,1
30930,274,448,0,0,0,886600,1
30898,494,32,0,0,0,886600,1
30896,103,609,0,0,0,886600,1
30895,609,103,0,0,0,886600,1
30893,167,596,0,0,0,886600,1
26427,588,137,0,0,0,886600,1
30891,155,290,0,0,0,886600,1
30890,689,525,0,0,0,886600,1
30889,163,613,0,0,0,886600,1
30887,497,409,0,0,0,886600,1
26434,458,674,0,0,0,886600,1
30882,569,68,0,0,0,886600,1
26436,14,448,0,0,0,886600,1
26437,398,294,0,0,0,886600,1
30879,543,133,0,0,0,886600,1
30878,137,397,0,0,0,886600,1
30875,294,638,0,0,0,886600,1
30873,137,242,0,0,0,886600,1
30872,103,528,0,0,0,886600,1
30897,587,204,0,0,0,886600,1
30899,121,640,0,0,0,886600,1
30929,117,64,0,0,0,886600,1
30900,202,614,0,0,0,886600,1
30928,587,265,0,0,0,886600,1
30927,156,383,0,0,0,886600,1
30926,624,54,0,0,0,886600,1
26383,624,587,0,0,0,886600,1
13610,638,624,0,0,0,886600,1
26395,364,587,0,0,0,886600,1
26397,385,683,0,0,0,886600,1
30918,525,714,0,0,0,886600,1
26401,683,170,0,0,0,886600,1
30914,163,174,0,0,0,886600,1
30911,170,367,0,0,0,886600,1
30910,494,295,0,0,0,886600,1
26412,529,493,0,0,0,886600,1
30907,181,638,0,0,0,886600,1
26417,242,439,0,0,0,886600,1
26423,257,334,0,0,0,886600,1
30901,307,193,0,0,0,886600,1
30985,170,379,0,0,0,886600,1
30990,624,107,0,0,0,886600,1
31132,141,130,0,0,0,886600,1
31080,126,123,0,0,0,886600,1
31093,178,137,0,0,0,886600,1
31092,652,2,0,0,0,886600,1
31091,280,319,0,0,0,886600,1
31090,494,414,0,0,0,886600,1
31089,503,640,0,0,0,886600,1
31088,723,463,0,0,0,886600,1
26184,544,54,0,0,0,886600,1
26196,294,311,0,0,0,886600,1
26197,257,380,0,0,0,886600,1
26322,717,394,0,0,0,886600,1
26198,638,193,0,0,0,886600,1
31077,689,332,0,0,0,886600,1
31076,97,43,0,0,0,886600,1
26217,257,117,0,0,0,886600,1
26220,5,661,0,0,0,886600,1
26227,684,614,0,0,0,886600,1
26233,560,335,0,0,0,886600,1
31061,392,663,0,0,0,886600,1
31095,714,632,0,0,0,886600,1
31096,219,319,0,0,0,886600,1
31097,4,448,0,0,0,886600,1
31099,683,30,0,0,0,886600,1
31131,638,137,0,0,0,886600,1
26136,552,646,0,0,0,886600,1
31129,482,514,0,0,0,886600,1
26142,593,683,0,0,0,886600,1
26144,29,393,0,0,0,886600,1
31123,137,230,0,0,0,886600,1
26145,689,124,0,0,0,886600,1
26149,290,394,0,0,0,886600,1
26157,427,164,0,0,0,886600,1
26158,587,33,0,0,0,886600,1
31107,493,409,0,0,0,886600,1
26172,683,655,0,0,0,886600,1
26173,605,587,0,0,0,886600,1
26176,502,1,0,0,0,886600,1
31102,479,494,0,0,0,886600,1
31101,181,624,0,0,0,886600,1
31100,2,178,0,0,0,886600,1
26237,163,30,0,0,0,886600,1
31059,242,155,0,0,0,886600,1
31058,137,335,0,0,0,886600,1
31021,714,145,0,0,0,886600,1
31019,164,673,0,0,0,886600,1
31018,618,605,0,0,0,886600,1
31017,137,614,0,0,0,886600,1
31016,569,295,0,0,0,886600,1
26297,708,242,0,0,0,886600,1
26298,294,310,0,0,0,886600,1
26299,95,502,0,0,0,886600,1
31010,264,493,0,0,0,886600,1
31006,587,50,0,0,0,886600,1
31005,269,163,0,0,0,886600,1
31004,137,131,0,0,0,886600,1
31003,54,543,0,0,0,886600,1
31000,503,682,0,0,0,886600,1
26316,290,170,0,0,0,886600,1
30996,95,124,0,0,0,886600,1
30993,701,502,0,0,0,886600,1
26321,12,23,0,0,0,886600,1
31020,439,701,0,0,0,886600,1
31024,331,576,0,0,0,886600,1
31057,652,353,0,0,0,886600,1
26285,618,265,0,0,0,886600,1
31056,587,280,0,0,0,886600,1
26241,508,295,0,0,0,886600,1
26245,353,576,0,0,0,886600,1
31050,721,196,0,0,0,886600,1
26246,193,448,0,0,0,886600,1
31048,195,674,0,0,0,886600,1
26249,717,5,0,0,0,886600,1
31044,23,463,0,0,0,886600,1
31043,170,163,0,0,0,886600,1
31042,265,175,0,0,0,886600,1
26250,609,171,0,0,0,886600,1
26262,332,14,0,0,0,886600,1
31034,439,448,0,0,0,886600,1
31033,684,609,0,0,0,886600,1
26272,280,446,0,0,0,886600,1
31029,392,640,0,0,0,886600,1
31026,392,54,0,0,0,886600,1
31375,264,170,0,0,0,886600,1
31377,264,503,0,0,0,886600,1
31378,103,507,0,0,0,886600,1
31693,193,501,0,0,0,886600,1
25509,655,2,0,0,0,886600,1
25517,379,207,0,0,0,886600,1
25526,163,261,0,0,0,886600,1
31702,140,494,0,0,0,886600,1
31701,193,404,0,0,0,886600,1
25532,246,54,0,0,0,886600,1
25538,353,85,0,0,0,886600,1
25543,195,508,0,0,0,886600,1
25548,342,33,0,0,0,886600,1
25450,638,383,0,0,0,886600,1
25556,511,571,0,0,0,886600,1
31690,701,543,0,0,0,886600,1
25558,133,20,0,0,0,886600,1
31687,571,174,0,0,0,886600,1
25561,261,140,0,0,0,886600,1
31685,261,171,0,0,0,886600,1
25562,1,22,0,0,0,886600,1
31682,117,20,0,0,0,886600,1
25498,708,117,0,0,0,886600,1
31715,1,525,0,0,0,886600,1
31716,167,19,0,0,0,886600,1
31717,181,50,0,0,0,886600,1
31745,5,265,0,0,0,886600,1
31744,652,6,0,0,0,886600,1
31743,170,331,0,0,0,886600,1
25462,204,525,0,0,0,886600,1
25463,311,124,0,0,0,886600,1
25472,618,528,0,0,0,886600,1
31735,494,655,0,0,0,886600,1
25478,529,1,0,0,0,886600,1
25480,689,414,0,0,0,886600,1
25483,163,507,0,0,0,886600,1
31729,174,290,0,0,0,886600,1
31727,493,20,0,0,0,886600,1
31724,714,294,0,0,0,886600,1
31722,367,668,0,0,0,886600,1
31721,723,64,0,0,0,886600,1
31720,174,605,0,0,0,886600,1
31718,224,699,0,0,0,886600,1
31681,261,507,0,0,0,886600,1
31680,683,576,0,0,0,886600,1
31678,202,543,0,0,0,886600,1
31643,117,319,0,0,0,886600,1
31640,507,525,0,0,0,886600,1
31639,29,714,0,0,0,886600,1
31638,714,348,0,0,0,886600,1
25610,720,522,0,0,0,886600,1
25611,43,246,0,0,0,886600,1
31635,30,458,0,0,0,886600,1
25618,503,164,0,0,0,886600,1
31630,494,392,0,0,0,886600,1
25624,479,569,0,0,0,886600,1
31628,552,668,0,0,0,886600,1
31627,511,85,0,0,0,886600,1
31625,171,4,0,0,0,886600,1
31624,661,170,0,0,0,886600,1
31622,507,202,0,0,0,886600,1
14981,265,246,0,0,0,886600,1
31617,34,160,0,0,0,886600,1
31616,614,668,0,0,0,886600,1
25607,721,503,0,0,0,886600,1
31644,652,313,0,0,0,886600,1
31674,310,342,0,0,0,886600,1
31645,126,121,0,0,0,886600,1
25580,294,1,0,0,0,886600,1
25582,269,164,0,0,0,886600,1
31668,290,624,0,0,0,886600,1
31667,117,193,0,0,0,886600,1
31666,133,140,0,0,0,886600,1
25585,23,141,0,0,0,886600,1
31663,517,23,0,0,0,886600,1
25588,394,90,0,0,0,886600,1
25592,605,544,0,0,0,886600,1
25595,141,364,0,0,0,886600,1
25600,717,105,0,0,0,886600,1
31652,683,508,0,0,0,886600,1
31651,571,26,0,0,0,886600,1
25601,640,137,0,0,0,886600,1
31648,723,1,0,0,0,886600,1
25605,264,12,0,0,0,886600,1
25606,624,394,0,0,0,886600,1
31746,56,43,0,0,0,886600,1
25447,269,130,0,0,0,886600,1
25652,501,290,0,0,0,886600,1
31830,613,502,0,0,0,886600,1
31843,721,138,0,0,0,886600,1
25366,307,392,0,0,0,886600,1
31841,717,13,0,0,0,886600,1
31840,646,508,0,0,0,886600,1
31839,257,261,0,0,0,886600,1
25369,446,397,0,0,0,886600,1
31835,587,379,0,0,0,886600,1
25380,207,593,0,0,0,886600,1
31829,701,482,0,0,0,886600,1
31753,383,126,0,0,0,886600,1
31828,652,11,0,0,0,886600,1
25384,294,295,0,0,0,886600,1
31825,717,170,0,0,0,886600,1
31824,290,719,0,0,0,886600,1
31822,342,348,0,0,0,886600,1
31820,501,202,0,0,0,886600,1
31818,13,246,0,0,0,886600,1
25389,170,313,0,0,0,886600,1
31844,503,50,0,0,0,886600,1
25360,443,448,0,0,0,886600,1
31848,723,50,0,0,0,886600,1
25352,264,163,0,0,0,886600,1
31876,334,433,0,0,0,886600,1
31873,121,507,0,0,0,886600,1
31872,668,12,0,0,0,886600,1
31869,170,652,0,0,0,886600,1
25337,264,140,0,0,0,886600,1
31867,90,64,0,0,0,886600,1
31866,25,138,0,0,0,886600,1
31865,714,689,0,0,0,886600,1
25340,242,689,0,0,0,886600,1
31862,1,137,0,0,0,886600,1
31861,448,178,0,0,0,886600,1
25341,532,525,0,0,0,886600,1
31859,195,720,0,0,0,886600,1
31857,294,10,0,0,0,886600,1
31856,257,663,0,0,0,886600,1
31855,385,640,0,0,0,886600,1
31852,138,295,0,0,0,886600,1
31815,652,393,0,0,0,886600,1
31814,446,328,0,0,0,886600,1
31812,508,348,0,0,0,886600,1
31780,23,307,0,0,0,886600,1
31775,448,501,0,0,0,886600,1
31774,195,661,0,0,0,886600,1
31773,525,193,0,0,0,886600,1
25428,54,532,0,0,0,886600,1
31771,19,684,0,0,0,886600,1
31770,463,133,0,0,0,886600,1
31768,535,701,0,0,0,886600,1
31767,543,646,0,0,0,886600,1
31766,84,720,0,0,0,886600,1
25433,379,178,0,0,0,886600,1
31764,202,114,0,0,0,886600,1
31763,181,29,0,0,0,886600,1
25434,446,353,0,0,0,886600,1
25438,638,103,0,0,0,886600,1
31760,19,514,0,0,0,886600,1
31756,335,668,0,0,0,886600,1
31755,652,663,0,0,0,886600,1
31778,13,433,0,0,0,886600,1
31781,720,593,0,0,0,886600,1
31809,393,446,0,0,0,886600,1
31782,668,701,0,0,0,886600,1
31808,587,640,0,0,0,886600,1
31807,124,562,0,0,0,886600,1
31806,404,20,0,0,0,886600,1
31804,433,68,0,0,0,886600,1
31803,522,720,0,0,0,886600,1
31802,33,492,0,0,0,886600,1
31801,29,683,0,0,0,886600,1
31800,501,720,0,0,0,886600,1
31799,525,392,0,0,0,886600,1
31797,246,269,0,0,0,886600,1
31796,54,502,0,0,0,886600,1
31795,156,458,0,0,0,886600,1
31792,562,43,0,0,0,886600,1
31788,56,332,0,0,0,886600,1
31787,20,458,0,0,0,886600,1
31786,593,673,0,0,0,886600,1
31785,22,294,0,0,0,886600,1
31615,517,54,0,0,0,886600,1
31613,342,123,0,0,0,886600,1
31380,552,383,0,0,0,886600,1
31452,661,571,0,0,0,886600,1
31462,392,137,0,0,0,886600,1
31460,140,587,0,0,0,886600,1
25808,525,2,0,0,0,886600,1
31458,22,458,0,0,0,886600,1
31457,458,156,0,0,0,886600,1
31456,4,569,0,0,0,886600,1
31454,334,569,0,0,0,886600,1
25811,683,26,0,0,0,886600,1
31451,673,494,0,0,0,886600,1
25786,19,114,0,0,0,886600,1
31449,392,261,0,0,0,886600,1
31448,613,414,0,0,0,886600,1
25817,682,193,0,0,0,886600,1
31445,195,614,0,0,0,886600,1
31444,48,160,0,0,0,886600,1
25821,404,507,0,0,0,886600,1
31440,409,12,0,0,0,886600,1
31438,714,171,0,0,0,886600,1
31463,433,334,0,0,0,886600,1
31464,593,721,0,0,0,886600,1
25806,207,414,0,0,0,886600,1
31466,475,525,0,0,0,886600,1
31490,133,673,0,0,0,886600,1
31487,133,613,0,0,0,886600,1
31486,544,23,0,0,0,886600,1
31485,1,133,0,0,0,886600,1
31484,22,137,0,0,0,886600,1
31482,517,383,0,0,0,886600,1
25795,605,508,0,0,0,886600,1
31477,493,682,0,0,0,886600,1
25802,668,2,0,0,0,886600,1
31474,683,511,0,0,0,886600,1
31473,178,673,0,0,0,886600,1
31472,458,552,0,0,0,886600,1
31471,133,181,0,0,0,886600,1
31470,140,174,0,0,0,886600,1
31469,446,170,0,0,0,886600,1
31468,618,482,0,0,0,886600,1
31467,552,202,0,0,0,886600,1
31437,723,618,0,0,0,886600,1
31435,160,30,0,0,0,886600,1
31434,494,4,0,0,0,886600,1
31405,290,114,0,0,0,886600,1
31401,11,458,0,0,0,886600,1
14580,640,683,0,0,0,886600,1
31399,23,560,0,0,0,886600,1
25863,501,721,0,0,0,886600,1
31397,558,699,0,0,0,886600,1
31396,3,525,0,0,0,886600,1
31395,295,673,0,0,0,886600,1
31394,479,19,0,0,0,886600,1
31393,668,652,0,0,0,886600,1
31390,19,503,0,0,0,886600,1
31389,207,482,0,0,0,886600,1
31388,133,193,0,0,0,886600,1
31386,140,507,0,0,0,886600,1
25870,163,475,0,0,0,886600,1
31383,342,114,0,0,0,886600,1
31382,5,503,0,0,0,886600,1
31381,475,492,0,0,0,886600,1
31402,714,543,0,0,0,886600,1
25852,618,140,0,0,0,886600,1
31433,593,342,0,0,0,886600,1
31408,493,569,0,0,0,886600,1
31432,295,433,0,0,0,886600,1
31431,103,655,0,0,0,886600,1
25831,494,50,0,0,0,886600,1
31429,586,618,0,0,0,886600,1
25833,95,12,0,0,0,886600,1
31427,264,133,0,0,0,886600,1
31426,558,684,0,0,0,886600,1
31424,394,701,0,0,0,886600,1
25842,2,193,0,0,0,886600,1
31419,121,29,0,0,0,886600,1
31418,257,34,0,0,0,886600,1
31415,525,163,0,0,0,886600,1
31414,11,332,0,0,0,886600,1
31412,718,723,0,0,0,886600,1
31411,494,265,0,0,0,886600,1
31410,714,174,0,0,0,886600,1
31409,571,2,0,0,0,886600,1
31491,508,640,0,0,0,886600,1
31493,699,26,0,0,0,886600,1
31612,202,661,0,0,0,886600,1
31572,290,246,0,0,0,886600,1
31584,718,463,0,0,0,886600,1
31583,463,458,0,0,0,886600,1
25685,265,261,0,0,0,886600,1
31580,439,593,0,0,0,886600,1
31578,171,261,0,0,0,886600,1
31576,507,23,0,0,0,886600,1
25696,409,655,0,0,0,886600,1
31573,497,571,0,0,0,886600,1
31571,29,383,0,0,0,886600,1
31494,721,171,0,0,0,886600,1
31570,124,683,0,0,0,886600,1
25697,661,479,0,0,0,886600,1
25698,701,290,0,0,0,886600,1
31567,130,492,0,0,0,886600,1
31565,64,156,0,0,0,886600,1
31564,242,1,0,0,0,886600,1
25705,494,586,0,0,0,886600,1
31562,257,265,0,0,0,886600,1
25684,492,646,0,0,0,886600,1
31586,683,12,0,0,0,886600,1
25678,56,492,0,0,0,886600,1
31589,4,624,0,0,0,886600,1
31611,508,379,0,0,0,886600,1
25662,723,307,0,0,0,886600,1
25665,719,193,0,0,0,886600,1
31607,494,328,0,0,0,886600,1
31606,571,335,0,0,0,886600,1
31605,433,335,0,0,0,886600,1
25669,246,15,0,0,0,886600,1
31602,448,392,0,0,0,886600,1
31601,290,140,0,0,0,886600,1
31599,439,613,0,0,0,886600,1
31598,448,181,0,0,0,886600,1
31597,613,22,0,0,0,886600,1
31596,31,525,0,0,0,886600,1
31594,446,243,0,0,0,886600,1
31593,383,12,0,0,0,886600,1
25677,392,170,0,0,0,886600,1
31590,138,30,0,0,0,886600,1
31561,85,514,0,0,0,886600,1
31559,502,319,0,0,0,886600,1
25713,202,502,0,0,0,886600,1
25734,4,29,0,0,0,886600,1
31531,290,22,0,0,0,886600,1
31526,23,723,0,0,0,886600,1
25741,409,528,0,0,0,886600,1
14754,571,471,0,0,0,886600,1
31519,174,446,0,0,0,886600,1
31518,655,371,0,0,0,886600,1
31517,560,354,0,0,0,886600,1
31512,97,624,0,0,0,886600,1
31511,12,668,0,0,0,886600,1
25762,529,137,0,0,0,886600,1
25763,433,123,0,0,0,886600,1
31503,367,720,0,0,0,886600,1
31502,668,133,0,0,0,886600,1
31500,178,596,0,0,0,886600,1
25777,224,433,0,0,0,886600,1
31498,494,618,0,0,0,886600,1
31497,674,721,0,0,0,886600,1
31532,43,493,0,0,0,886600,1
31534,624,448,0,0,0,886600,1
25718,2,124,0,0,0,886600,1
31535,613,207,0,0,0,886600,1
25721,443,319,0,0,0,886600,1
31554,503,543,0,0,0,886600,1
31553,347,717,0,0,0,886600,1
31552,195,202,0,0,0,886600,1
25724,394,133,0,0,0,886600,1
25725,97,246,0,0,0,886600,1
31548,290,334,0,0,0,886600,1
31547,703,334,0,0,0,886600,1
31546,23,588,0,0,0,886600,1
31545,156,719,0,0,0,886600,1
31544,103,117,0,0,0,886600,1
31543,257,714,0,0,0,886600,1
31541,242,29,0,0,0,886600,1
25730,655,613,0,0,0,886600,1
31538,683,23,0,0,0,886600,1
31537,167,613,0,0,0,886600,1
31536,141,525,0,0,0,886600,1
35584,19,328,0,0,0,886600,1